bill_id,roll_call_id,date,chamber,description,yea,nay,nv,absent,total
1641626,1231106,2023-01-03,Senate,"Senate: Adopted",67,0,0,0,67
1641627,1231107,2023-01-03,Senate,"Senate: Adopted",61,6,0,0,67
1642022,1236161,2023-01-25,Senate,"Senate: Motion did not prevail to strike from General Orders and re-refer to Finance",29,34,0,0,63
1642041,1236948,2023-01-26,Senate,"Senate: Third reading Passed",57,8,0,0,65
1642041,1242145,2023-02-02,House,"House: Passage",126,1,0,0,127
1642072,1238320,2023-01-30,Senate,"Senate: Motion did not prevail to withdraw and be placed on General Orders",32,34,0,0,66
1642117,1238627,2023-01-30,Senate,"Senate: Third reading Passed",67,0,0,0,67
1642169,1272845,2023-03-09,Senate,"Senate: Motion did not prevail to withdraw and be placed on General Orders",33,34,0,0,67
1642190,1278014,2023-03-16,Senate,"Senate: Withdrawn",47,19,0,0,66
1642196,1238838,2023-01-30,Senate,"Senate: Laid on table",36,30,0,0,66
1642196,1238839,2023-01-30,Senate,"Senate: Taken from table",42,21,0,0,63
1642196,1238840,2023-01-30,Senate,"Senate: Third reading Passed",33,34,0,0,67
1642196,1244827,2023-02-06,House,"House: Niska - Amendment - S0033A1",61,70,0,0,131
1642196,1244828,2023-02-06,House,"House: 70 - Amendment to Nash Amendment - Nays",61,70,0,0,131
1642196,1244829,2023-02-06,House,"House: 70 - Amendment to Nash Amendment - Nays",60,70,0,0,130
1642196,1244830,2023-02-06,House,"House: 70 - Amendment to Nash Amendment - Nays",60,70,0,0,130
1642196,1244831,2023-02-06,House,"House: Nash - Amendment S0033A5 - S0033A5",60,70,0,0,130
1642196,1244832,2023-02-06,House,"House: Passage",73,55,0,0,128
1642211,1303000,2023-04-17,Senate,"Senate: Third reading Passed",39,27,0,0,66
1642211,1309345,2023-04-24,House,"House: Schultz - Amendment - H0010A1",60,69,0,0,129
1642211,1309346,2023-04-24,House,"House: Schultz - Amendment - H0010A2",60,69,0,0,129
1642211,1309347,2023-04-24,House,"House: Swedzinski - Amendment - H0010A4",59,70,0,0,129
1642211,1309348,2023-04-24,House,"House: Schultz - Amendment - S0010A5",59,69,0,0,128
1642211,1309349,2023-04-24,House,"House: Passage",83,46,0,0,129
1642770,1231161,2023-01-09,House,"House: H.F. NO. 31",132,0,0,0,132
1642772,1256784,2023-02-20,House,"House: Niska - Amendment - H0016A16",59,70,0,0,129
1642772,1256785,2023-02-20,House,"House: 59 - Amendment to Franson Amendment - Nays",70,59,0,0,129
1642772,1256786,2023-02-20,House,"House: Passage",81,47,0,0,128
1642772,1308182,2023-04-21,Senate,"Senate: Third reading Passed",36,27,0,0,63
1642777,1257161,2023-02-20,House,"House: Passage",128,0,0,0,128
1642777,1282296,2023-03-22,Senate,"Senate: Third reading Passed",64,0,0,0,64
1642804,1250161,2023-02-13,House,"House: H.F. NO. 2",70,60,0,0,130
1642804,1317359,2023-05-02,House,"House: Baker - Amendment - H0002DE2",64,68,0,0,132
1642804,1317360,2023-05-02,House,"House: O'Neill - Amendment - H0002A77",63,69,0,0,132
1642804,1317361,2023-05-02,House,"House: West - Amendment - H0002A74",63,69,0,0,132
1642804,1317362,2023-05-02,House,"House: Baker - Amendment - H0002A63",64,68,0,0,132
1642804,1317363,2023-05-02,House,"House: Neu Brindley - Amendment - H0002A55",64,67,0,0,131
1642804,1317364,2023-05-02,House,"House: Neu Brindley - Amendment - H0002A65",64,68,0,0,132
1642804,1317365,2023-05-02,House,"House: CALL OF THE HOUSE",132,0,0,0,132
1642804,1317366,2023-05-02,House,"House: Daudt - Amendment - H0002A54",65,67,0,0,132
1642804,1317367,2023-05-02,House,"House: Scott motion Re-Referral",63,69,0,0,132
1642804,1317369,2023-05-02,House,"House: McDonald motion Re-Referral",63,69,0,0,132
1642804,1317370,2023-05-02,House,"House: O'Driscoll motion Re-Referral",63,69,0,0,132
1642804,1317371,2023-05-02,House,"House: Nash motion Re-Referral",63,69,0,0,132
1642804,1317372,2023-05-02,House,"House: Neu Brindley motion Re-Referral",62,69,0,0,131
1642804,1317373,2023-05-02,House,"House: O'Neill motionRe-Referral",62,69,0,0,131
1642804,1317374,2023-05-02,House,"House: Passage, as amended",68,64,0,0,132
1642804,1320750,2023-05-08,Senate,"Senate: Motion did not prevail to re-refer to Commerce and Consumer Protection",33,34,0,0,67
1642804,1320751,2023-05-08,Senate,"Senate: Motion did not prevail to re-refer to Education Finance",33,34,0,0,67
1642804,1320752,2023-05-08,Senate,"Senate: Motion did not prevail to re-refer to Higher Education",33,34,0,0,67
1642804,1320753,2023-05-08,Senate,"Senate: Motion did not prevail to re-refer to Higher Education",33,34,0,0,67
1642804,1320754,2023-05-08,Senate,"Senate: Motion did not prevail to re-refer to State and Local Government and Veterans",33,34,0,0,67
1642804,1320755,2023-05-08,Senate,"Senate: Third reading Passed",34,33,0,0,67
1642804,1327471,2023-05-17,House,"House: H.F. NO. 2",62,68,0,0,130
1642804,1327472,2023-05-17,House,"House: H.F. NO. 2",68,62,0,0,130
1642804,1329141,2023-05-18,Senate,"Senate: Motion to reject CC report, did not prevail",32,34,0,0,66
1642804,1329142,2023-05-18,Senate,"Senate: Motion to reject CC report, did not prevail",32,34,0,0,66
1642804,1329143,2023-05-18,Senate,"Senate: Third reading",34,32,0,0,66
1642809,1254537,2023-02-16,House,"House: 70 - Amendment to Olson, L. Amendment - Nays",57,70,0,0,127
1642809,1254538,2023-02-16,House,"House: Robbins - Amendment - H0019A33",57,70,0,0,127
1642809,1254539,2023-02-16,House,"House: Robbins - Amendment - H0019A43",57,69,0,0,126
1642809,1254540,2023-02-16,House,"House: Daudt - Amendment - H0019A26",58,69,0,0,127
1642809,1254541,2023-02-16,House,"House: Nash - Amendment - H0019A27",57,70,0,0,127
1642809,1254542,2023-02-16,House,"House: Scott - Amendment - H0019A38",57,70,0,0,127
1642809,1254543,2023-02-16,House,"House: Baker - Amendment - H0019A28",56,70,0,0,126
1642809,1254544,2023-02-16,House,"House: Baker - Amendment - H0019A32",56,70,0,0,126
1642809,1254545,2023-02-16,House,"House: Baker - Amendment - H0019A35",56,70,0,0,126
1642809,1254546,2023-02-16,House,"House: Baker - Amendment - H0019A41",56,70,0,0,126
1642809,1254547,2023-02-16,House,"House: Passage",69,54,0,0,123
1642815,1234583,2023-01-23,House,"House: Passage",134,0,0,0,134
1642815,1238314,2023-01-30,Senate,"Senate: Third reading Passed",65,0,0,0,65
1642815,1242181,2023-02-02,House,"House: H.F. NO. 26",128,0,0,0,128
1642844,1231575,2023-01-11,House,"House: Passage",111,19,0,0,130
1642844,1236946,2023-01-26,Senate,"Senate: Third reading Passed",45,19,0,0,64
1642913,1309358,2023-04-24,House,"House: Passage, as amended",69,60,0,0,129
1642918,1254622,2023-02-16,House,"House: Passage",125,0,0,0,125
1642926,1254344,2023-02-16,House,"House: Shall the decision of Speaker pro tempore Wolgamott stand as the judgment of the House?",70,57,0,0,127
1642926,1254345,2023-02-16,House,"House: Passage",127,0,0,0,127
1642926,1299856,2023-04-12,Senate,"Senate: Third reading Passed",65,0,0,0,65
1642926,1303241,2023-04-17,House,"House: H.F. NO. 42",128,0,0,0,128
1642941,1268019,2023-03-02,House,"House: Backer - Amendment - H0006A5",61,69,0,0,130
1642941,1268020,2023-03-02,House,"House: Niska - Amendment - H0006A7",60,70,0,0,130
1642941,1268021,2023-03-02,House,"House: Passage",72,58,0,0,130
1642958,1231181,2023-01-04,Senate,"Senate: Adopted",34,31,0,0,65
1642958,1231182,2023-01-04,Senate,"Senate: Motions did not prevail to re-refer to Rules and Administration",31,34,0,0,65
1642968,1236957,2023-01-26,House,"House: Appeal the ruling of the Speaker",70,59,0,0,129
1642968,1236958,2023-01-26,House,"House: Appeal of the Speaker",70,59,0,0,129
1642968,1236959,2023-01-26,House,"House: Passage, as amended",70,60,0,0,130
1642968,1256522,2023-02-20,Senate,"Senate: Special Order: Rule 45 amendment stricken",36,28,0,0,64
1642968,1256523,2023-02-20,Senate,"Senate: Third reading Passed",35,30,0,0,65
1642978,1257025,2023-02-20,House,"House: Passage",113,15,0,0,128
1642978,1268003,2023-03-02,Senate,"Senate: Taken from table",40,23,0,0,63
1642978,1268004,2023-03-02,Senate,"Senate: Third reading Passed as amended",40,25,0,0,65
1642978,1272968,2023-03-09,House,"House: H.F. NO. 30",109,19,0,0,128
1642984,1247623,2023-02-09,House,"House: 70 - Amendment to Knudsen Amendment - Nays",59,70,0,0,129
1642984,1247624,2023-02-09,House,"House: 69 - Amendment to Knudsen Amendment - Nays",60,69,0,0,129
1642984,1247625,2023-02-09,House,"House: Knudsen - Amendment - H0005A15",59,70,0,0,129
1642984,1247626,2023-02-09,House,"House: H.F. NO. 5",70,59,0,0,129
1642984,1247627,2023-02-09,House,"House: Passage",70,58,0,0,128
1642984,1275941,2023-03-14,Senate,"Senate: Motion did not prevail to lay on table",28,35,0,0,63
1642984,1275942,2023-03-14,Senate,"Senate: Third reading Passed",38,26,0,0,64
1642984,1278025,2023-03-16,House,"House: H.F. NO. 5",56,69,0,0,125
1642984,1278026,2023-03-16,House,"House: H.F. NO. 5",71,54,0,0,125
1642990,1233734,2023-01-19,House,"House: Nash - Amendment H0001A14 - H0001A14",65,69,0,0,134
1642990,1233735,2023-01-19,House,"House: Scott - Amendment H0001A21 - H0001A21",65,69,0,0,134
1642990,1233736,2023-01-19,House,"House: 65 - Amendment to Niska Amendment - Nays",69,65,0,0,134
1642990,1233737,2023-01-19,House,"House: Appeal the Ruling of the Speaker",70,64,0,0,134
1642990,1233738,2023-01-19,House,"House: 65 - Amendment to Kiel Amendment - Nays",69,65,0,0,134
1642990,1233739,2023-01-19,House,"House: CALL OF THE HOUSE",134,0,0,0,134
1642990,1233740,2023-01-19,House,"House: Neu Brindley - Amendment H0001A22-2 - H0001A22-2",67,67,0,0,134
1642990,1233741,2023-01-19,House,"House: CALL OF THE HOUSE",134,0,0,0,134
1642990,1233742,2023-01-19,House,"House: Passage",69,65,0,0,134
1642990,1236965,2023-01-26,Senate,"Senate: Motion did not prevail to strike from General Orders and re-refer to Finance",31,34,0,0,65
1642990,1237488,2023-01-27,Senate,"Senate: Motion did not prevail to strike from General Orders and re-refer to Finance",33,34,0,0,67
1642990,1237503,2023-01-27,Senate,"Senate: Third reading Passed",34,0,0,0,34
1642995,1247634,2023-02-09,House,"House: H.F. NO. 3",70,59,0,0,129
1642995,1301382,2023-04-13,House,"House: Greenman - Amendment - H0003A30",70,59,0,0,129
1642995,1301383,2023-04-13,House,"House: Neu Brindley - Amendment - H0003A27",59,70,0,0,129
1642995,1301384,2023-04-13,House,"House: Niska - Amendment - H0003A33",59,69,0,0,128
1642995,1301385,2023-04-13,House,"House: Niska - Amendment - H0003A34",58,66,0,0,124
1642995,1301386,2023-04-13,House,"House: Davis - Amendment - H0003A28",57,68,0,0,125
1642995,1301387,2023-04-13,House,"House: Passage, as amended",70,57,0,0,127
1642995,1312280,2023-04-26,Senate,"Senate: Third reading Passed",34,33,0,0,67
1642995,1381288,2023-04-26,Senate,"Senate: Third reading Passed",34,33,0,0,67
1643002,1242184,2023-02-02,House,"House: 61 - Amendment to Novotny Amendment - Nays",69,61,0,0,130
1643002,1242185,2023-02-02,House,"House: 61 - Amendment to Torkelson Amendment - Nays",69,61,0,0,130
1643002,1242186,2023-02-02,House,"House: Appeal the ruling of the Speaker",70,60,0,0,130
1643002,1242187,2023-02-02,House,"House: 61 - Amendment to Engen Amendment - Nays",69,61,0,0,130
1643002,1242188,2023-02-02,House,"House: 61 - Amendment to Engen Amendment - Nays",69,61,0,0,130
1643002,1242189,2023-02-02,House,"House: Shall the decision of Speaker stand as the judgment of the House?",69,61,0,0,130
1643002,1242190,2023-02-02,House,"House: Passage",71,59,0,0,130
1643002,1258053,2023-02-21,Senate,"Senate: Laid on table",42,22,0,0,64
1643002,1258514,2023-02-21,Senate,"Senate: Laid on table",34,25,0,0,59
1643002,1258515,2023-02-21,Senate,"Senate: Taken from table",42,22,0,0,64
1643002,1258516,2023-02-21,Senate,"Senate: Third reading Passed",35,30,0,0,65
1643002,1267998,2023-03-02,House,"House: H.F. NO. 28",72,58,0,0,130
1643010,1236927,2023-01-26,House,"House: 74 - Amendment to Long Amendment - Nays",57,74,0,0,131
1643010,1236928,2023-01-26,House,"House: Swedzinski - Amendment - H0007DE2",62,70,0,0,132
1643010,1236929,2023-01-26,House,"House: Swedzinski - Amendment - H0007A29",62,70,0,0,132
1643010,1236930,2023-01-26,House,"House: Swedzinski - Amendment - H0007A36",62,69,0,0,131
1643010,1236931,2023-01-26,House,"House: Swedzinski - Amendment - H0007A13",62,69,0,0,131
1643010,1236932,2023-01-26,House,"House: Swedzinski - Amendment - H0007A16",62,69,0,0,131
1643010,1236933,2023-01-26,House,"House: Swedzinski - Amendment - H0007A19",62,69,0,0,131
1643010,1236934,2023-01-26,House,"House: Nash - Amendment - H0007A39",63,68,0,0,131
1643010,1236935,2023-01-26,House,"House: CALL OF THE HOUSE",131,0,0,0,131
1643010,1236936,2023-01-26,House,"House: Igo - Amendment - H0007A31",63,68,0,0,131
1643010,1236937,2023-01-26,House,"House: Igo - Amendment - A23-0013",62,69,0,0,131
1643010,1236938,2023-01-26,House,"House: Niska - Amendment - H0007A38",62,69,0,0,131
1643010,1236939,2023-01-26,House,"House: Schultz - Amendment - A23-0012",62,69,0,0,131
1643010,1236940,2023-01-26,House,"House: Scott - Amendment - H0007A27",62,69,0,0,131
1643010,1236941,2023-01-26,House,"House: Franson - Amendment - H0007A34",62,69,0,0,131
1643010,1236942,2023-01-26,House,"House: Franson - Amendment - H0007A32",62,68,0,0,130
1643010,1236943,2023-01-26,House,"House: Franson - Amendment - H0007A35",63,68,0,0,131
1643010,1236944,2023-01-26,House,"House: Appeal of the Speaker",69,62,0,0,131
1643010,1236945,2023-01-26,House,"House: Passage, as amended",70,60,0,0,130
1643010,1242278,2023-02-02,Senate,"Senate: Taken from table",43,19,0,0,62
1643010,1242279,2023-02-02,Senate,"Senate: Third reading Passed",34,33,0,0,67
1643010,1351106,2023-02-02,Senate,"Senate: Taken from table",29,35,0,0,64
1643010,1351107,2023-02-02,Senate,"Senate: Third reading Passed",34,33,0,0,67
1643046,1307426,2023-04-21,House,"House: Passage, as amended",123,0,0,0,123
1643046,1321676,2023-05-09,Senate,"Senate: Third reading Passed",64,2,0,0,66
1643046,1323311,2023-05-10,House,"House: H.F. NO. 24",129,0,0,0,129
1643063,1256892,2023-02-20,House,"House: Novotny - Amendment - H0055A7",59,70,0,0,129
1643063,1256893,2023-02-20,House,"House: Demuth - Amendment - H0055A8",59,70,0,0,129
1643063,1256894,2023-02-20,House,"House: Passage",110,19,0,0,129
1643070,1250016,2023-02-13,House,"House: Daniels motion Re-Referral",59,70,0,0,129
1643070,1250017,2023-02-13,House,"House: Passage",69,59,0,0,128
1643103,1242195,2023-02-02,House,"House: Passage",128,0,0,0,128
1643103,1256514,2023-02-20,Senate,"Senate: Third reading Passed",64,0,0,0,64
1643125,1238344,2023-01-30,House,"House: Baker - Amendment H0004A38 - H0004A38",60,69,0,0,129
1643125,1238345,2023-01-30,House,"House: Fogelman - Amendment H0004A24 - H0004A24",59,70,0,0,129
1643125,1238346,2023-01-30,House,"House: Fogelman - Amendment H0004A24 - H0004A24",61,69,0,0,130
1643125,1238347,2023-01-30,House,"House: Petersburg - Amendment H0004A27 - H0004A27",61,69,0,0,130
1643125,1238348,2023-01-30,House,"House: Johnson - Amendment H0004A31 - H0004A31",61,68,0,0,129
1643125,1238349,2023-01-30,House,"House: 61 - Amendment to Novotny Amendment - Nays",68,61,0,0,129
1643125,1238350,2023-01-30,House,"House: 68 - Amendment to Novotny Amendment - Nays",61,68,0,0,129
1643125,1238351,2023-01-30,House,"House: Novotny - Amendment H0004A32 - H0004A32",61,68,0,0,129
1643125,1238352,2023-01-30,House,"House: Passage",69,60,0,0,129
1643125,1258796,2023-02-21,Senate,"Senate: Third reading Passed",34,31,0,0,65
1643125,1267944,2023-03-02,House,"House: H.F. NO.4",70,60,0,0,130
1643145,1237504,2023-01-04,Senate,"Senate: Adopted",34,30,0,0,64
1643204,1231147,2023-01-04,Senate,"Senate: Adopted",52,12,0,0,64
1643345,1231763,2023-01-12,Senate,"Senate: Third reading Passed",56,10,0,0,66
1643345,1234748,2023-01-23,House,"House: Passage",127,7,0,0,134
1643365,1327247,2023-05-17,Senate,"Senate: Third reading Passed",43,23,0,0,66
1643365,1329611,2023-05-20,House,"House: S.F. NO. 37",69,62,0,0,131
1643365,1444816,2024-05-17,House,"House: Demuth - Amendment - S0037A19",59,67,0,0,126
1643365,1444817,2024-05-17,House,"House: 66 - Amendment to Torkelson Amendment - Nays",60,66,0,0,126
1643365,1444818,2024-05-17,House,"House: Torkelson - Amendment - S0037A8",59,68,0,0,127
1643365,1444819,2024-05-17,House,"House: Robbins - Amendment - S0037A11",60,67,0,0,127
1643365,1444820,2024-05-17,House,"House: Demuth - Amendment - S0037DE5",59,69,0,0,128
1643365,1444821,2024-05-17,House,"House: 68 - Amendment to Gillman Amendment - Nays",61,68,0,0,129
1643365,1444822,2024-05-18,House,"House: Gillman - Amendment - S0037A13",61,67,0,0,128
1643365,1444844,2024-05-18,House,"House: S.F. NO. 37",125,0,0,0,125
1643365,1444845,2024-05-18,House,"House: Scott - Amendment - S0037A15",62,68,0,0,130
1643365,1444846,2024-05-18,House,"House: Neu Brindley - Amendment - S0037A28",62,68,0,0,130
1643365,1444847,2024-05-18,House,"House: Perryman - Amendment - S0037A25",63,68,0,0,131
1643365,1444848,2024-05-18,House,"House: Rarick - Amendment - S0037A12",62,68,0,0,130
1643365,1444849,2024-05-18,House,"House: Wolgamott - Amendment - S0037A23",63,67,0,0,130
1643365,1444850,2024-05-18,House,"House: S.F. NO. 37",68,62,0,0,130
1643441,1244291,2023-02-06,House,"House: Passage",131,0,0,0,131
1643478,1267964,2023-03-02,House,"House: Passage",103,27,0,0,130
1643478,1277322,2023-03-15,Senate,"Senate: Third reading Passed",55,0,0,0,55
1643497,1268037,2023-03-02,House,"House: Passage, as amended",130,0,0,0,130
1643522,1255049,2023-02-16,House,"House: Nash - Amendment - H0062A9",57,70,0,0,127
1643522,1255050,2023-02-16,House,"House: Passage",70,57,0,0,127
1643640,1256635,2023-02-20,House,"House: Passage",129,0,0,0,129
1643679,1309367,2023-04-24,House,"House: Robbins - Amendment - H0100A111",130,0,0,0,130
1643679,1309368,2023-04-24,House,"House: Mueller - Amendment - H0100A106",130,0,0,0,130
1643679,1309369,2023-04-24,House,"House: Gillman - Amendment - H0100A109",60,70,0,0,130
1643679,1309370,2023-04-24,House,"House: Nash - Amendment - H0100A113",57,71,0,0,128
1643679,1309371,2023-04-24,House,"House: West - Amendment - H0100A97",54,70,0,0,124
1643679,1309372,2023-04-24,House,"House: Baker - Amendment - H0100A99",57,70,0,0,127
1643679,1309373,2023-04-24,House,"House: Robbins - Amendment - H0100A101",61,69,0,0,130
1643679,1309374,2023-04-24,House,"House: Robbins - Amendment - H0100A105",61,69,0,0,130
1643679,1309375,2023-04-24,House,"House: Robbins - Amendment - H0100A114",60,69,0,0,129
1643679,1309376,2023-04-24,House,"House: Robbins - Amendment - H0100A100",59,69,0,0,128
1643679,1309377,2023-04-24,House,"House: Robbins - Amendment - H0100A102",60,68,0,0,128
1643679,1309378,2023-04-24,House,"House: Nash - Amendment - H0100A107",60,67,0,0,127
1643679,1309379,2023-04-24,House,"House: Novotny - Amendment - H0100A103",61,69,0,0,130
1643679,1309380,2023-04-25,House,"House: Nash motion Re-Referral",60,71,0,0,131
1643679,1310704,2023-04-25,House,"House: H.F. NO. 100",71,59,0,0,130
1643679,1315151,2023-04-28,Senate,"Senate: Bill passed",34,33,0,0,67
1643679,1315152,2023-04-28,Senate,"Senate: Motion did not prevail to lay on table",33,34,0,0,67
1643679,1315153,2023-04-28,Senate,"Senate: Motion did not prevail to re-refer to Finance",33,34,0,0,67
1643679,1329049,2023-05-18,House,"House: H.F. NO. 100",73,57,0,0,130
1643679,1329604,2023-05-19,Senate,"Senate: Motion to reject CC report, did not prevail",32,34,0,0,66
1643679,1329605,2023-05-19,Senate,"Senate: Motion to reject CC report, did not prevail",32,34,0,0,66
1643679,1329606,2023-05-19,Senate,"Senate: Third reading",34,32,0,0,66
1645909,1249997,2023-02-13,House,"House: Hudson - Amendment - H0150A6",60,70,0,0,130
1645909,1249998,2023-02-13,House,"House: Zeleznikar - Amendment - H0150A7",60,70,0,0,130
1645909,1249999,2023-02-13,House,"House: Passage",70,60,0,0,130
1645941,1263987,2023-02-27,House,"House: H.F. NO. 153",64,68,0,0,132
1645992,1324248,2023-05-11,House,"House: Passage",69,51,0,0,120
1645992,1327272,2023-05-17,Senate,"Senate: Third reading Passed",42,25,0,0,67
1645992,1329594,2023-05-19,House,"House: H.F. NO. 197",70,51,0,0,121
1646152,1283717,2023-03-23,House,"House: 61 - Amendment to Franson Amendment - Nays",69,61,0,0,130
1646152,1283718,2023-03-23,House,"House: Shall the decision of the Speaker stand as the judgment of the House?",69,61,0,0,130
1646152,1283719,2023-03-23,House,"House: Passage",68,62,0,0,130
1646152,1308206,2023-04-21,Senate,"Senate: Special Order: Rule 45 amendment stricken",34,29,0,0,63
1646152,1308207,2023-04-21,Senate,"Senate: Third reading Passed",34,30,0,0,64
1646186,1244277,2023-02-06,House,"House: Passage",131,0,0,0,131
1646186,1266389,2023-03-01,Senate,"Senate: Third reading Passed",62,0,0,0,62
1646186,1269979,2023-03-06,House,"House: H.F. NO. 121",133,0,0,0,133
1646288,1280319,2023-03-20,House,"House: Passage, as amended",127,3,0,0,130
1646315,1247639,2023-02-09,House,"House: Passage",70,59,0,0,129
1646315,1247640,2023-02-09,House,"House: Kresha motion - Lay on the Table",59,70,0,0,129
1646315,1247641,2023-02-09,House,"House: Bennett - Amendment - H0005A14",59,70,0,0,129
1648869,1247898,2023-02-09,House,"House: Passage",129,0,0,0,129
1648869,1263354,2023-02-27,Senate,"Senate: Third reading Passed",60,7,0,0,67
1654606,1278154,2023-03-16,House,"House: H.F. NO. 300",57,67,0,0,124
1654821,1247643,2023-02-09,House,"House: Passage",129,0,0,0,129
1654821,1282273,2023-03-22,Senate,"Senate: Third reading Passed",67,0,0,0,67
1654821,1286050,2023-03-27,House,"House: H.F. NO. 244",130,0,0,0,130
1654839,1307234,2023-04-20,House,"House: Zeleznikar - Amendment - H0238A9",58,70,0,0,128
1654839,1307235,2023-04-20,House,"House: Hudson - Amendment - H0238A10",59,70,0,0,129
1654839,1307236,2023-04-20,House,"House: Hudson - Amendment - H0238A12",60,70,0,0,130
1654839,1307237,2023-04-20,House,"House: 59 - Amendment to Daniels Amendment - Nays",71,59,0,0,130
1654839,1307238,2023-04-20,House,"House: Passage, as amended",70,60,0,0,130
1660931,1320726,2023-05-08,House,"House: O'Driscoll motion Re-Referral",61,70,0,0,131
1660931,1320727,2023-05-08,House,"House: Passage",70,61,0,0,131
1660931,1329618,2023-05-21,Senate,"Senate: Motion did not prevail to re-refer to Commerce and Consumer Protection",33,34,0,0,67
1660931,1329619,2023-05-21,Senate,"Senate: Third reading Passed",35,32,0,0,67
1660931,1329620,2023-05-21,House,"House: H.F. NO. 402",70,58,0,0,128
1660937,1268070,2023-03-02,House,"House: Neu Brindley - Amendment H0444A7 - H0444A7",60,70,0,0,130
1660937,1268071,2023-03-02,House,"House: Baker - Amendment - H0444A8",60,70,0,0,130
1660937,1268072,2023-03-02,House,"House: Passage, as amended",73,57,0,0,130
1661081,1301454,2023-04-13,House,"House: Anderson, P. H. - Amendment - H0463A1",59,70,0,0,129
1661081,1301455,2023-04-13,House,"House: Passage",129,0,0,0,129
1661081,1316103,2023-05-01,Senate,"Senate: Third reading Passed",66,0,0,0,66
1661203,1279626,2023-03-20,House,"House: Passage",68,62,0,0,130
1661203,1308249,2023-04-21,Senate,"Senate: Third reading Passed",34,29,0,0,63
1661203,1313238,2023-04-26,House,"House: H.F. NO. 366",70,58,0,0,128
1661358,1313716,2023-04-26,House,"House: Niska - Amendment - H0447A5",126,0,0,0,126
1661358,1313717,2023-04-26,House,"House: H.F. NO. 447",70,57,0,0,127
1661358,1330268,2023-05-22,Senate,"Senate: Third reading Passed",51,14,0,0,65
1661358,1330919,2023-05-22,House,"House: H.F. NO. 447",132,0,0,0,132
1661468,1286133,2023-03-27,House,"House: Passage",82,47,0,0,129
1665632,1273016,2023-03-09,Senate,"Senate: Withdrawn",35,29,0,0,64
1665750,1243128,2023-02-01,Senate,"Senate: Adopted",64,0,0,0,64
1668944,1436425,2024-04-29,House,"House: Engen - Amendment - H0601DE1",63,68,0,0,131
1668944,1436426,2024-04-29,House,"House: Hudson - Amendment - H0601DE2",63,68,0,0,131
1668944,1436427,2024-04-29,House,"House: Passage",68,63,0,0,131
1669537,1409798,2024-03-14,House,"House: H.F. NO. 548",60,66,0,0,126
1669779,1286084,2023-03-27,House,"House: Passage",130,0,0,0,130
1675610,1290390,2023-03-30,House,"House: H.F. NO. 733",58,70,0,0,128
1675675,1269677,2023-03-06,House,"House: Passage, as amended",91,43,0,0,134
1675675,1277992,2023-03-16,Senate,"Senate: Laid on table",51,15,0,0,66
1675675,1277993,2023-03-16,Senate,"Senate: Reconsidered",33,0,0,0,33
1675675,1277994,2023-03-16,Senate,"Senate: Reconsidered (Third Reading)",36,28,0,0,64
1675675,1277995,2023-03-16,Senate,"Senate: Reconsidered",33,0,0,0,33
1675675,1319214,2023-05-04,Senate,"Senate: Re-referred to Finance",59,0,0,0,59
1675675,1319215,2023-05-04,Senate,"Senate: Taken from table",57,0,0,0,57
1675675,1331212,2023-05-22,Senate,"Senate: Third reading Passed",56,11,0,0,67
1675675,1331213,2023-05-22,House,"House: H.F. NO. 669",97,35,0,0,132
1675675,1351535,2023-03-16,Senate,"Senate: Third reading Failed to pass",51,14,0,0,65
1675756,1269862,2023-03-06,House,"House: Urdahl - Amendment - A23-0050",126,8,0,0,134
1675756,1269863,2023-03-06,House,"House: Urdahl - Amendment - A23-0050",125,9,0,0,134
1675756,1269864,2023-03-06,House,"House: Passage, as amended",98,36,0,0,134
1675756,1319334,2023-05-04,Senate,"Senate: General Orders: Stricken and re-referred to Finance",59,0,0,0,59
1675756,1330715,2023-05-22,Senate,"Senate: Third reading Passed",35,14,0,0,49
1675756,1330716,2023-05-22,House,"House: H.F. NO. 670",78,43,0,0,121
1675849,1307474,2023-04-21,House,"House: Passage",121,0,0,0,121
1675849,1319196,2023-05-04,Senate,"Senate: Third reading Passed",55,5,0,0,60
1675857,1278011,2023-03-16,House,"House: Passage",70,54,0,0,124
1678527,1414295,2024-03-21,Senate,"Senate: Motion did not prevail to withdraw and be placed on General Orders",33,34,0,0,67
1678666,1442046,2024-05-09,Senate,"Senate: Third reading Passed",41,26,0,0,67
1678666,1443668,2024-05-15,House,"House: Passage, as amended",120,0,0,0,120
1678666,1444842,2024-05-18,House,"House: S.F. NO. 716",117,5,0,0,122
1678679,1263335,2023-02-27,Senate,"Senate: Third reading Passed",66,1,0,0,67
1678679,1263945,2023-02-27,Senate,"Senate: Third reading Passed",66,1,0,0,67
1678679,1272832,2023-03-09,House,"House: Passage",128,0,0,0,128
1681038,1316033,2023-05-01,House,"House: O'Driscoll - Amendment - H0782-5A",131,0,0,0,131
1681038,1316034,2023-05-01,House,"House: O'Driscoll - Amendment - H0782-4A",62,69,0,0,131
1681038,1316035,2023-05-01,House,"House: Passage, as amended",71,60,0,0,131
1681038,1324068,2023-05-11,Senate,"Senate: Third reading Passed",33,34,0,0,67
1681038,1324491,2023-05-12,House,"House: H.F. NO. 782",71,57,0,0,128
1681222,1268321,2023-03-02,House,"House: Passage",130,0,0,0,130
1681222,1321679,2023-05-09,Senate,"Senate: Third reading Passed",56,10,0,0,66
1683120,1305966,2023-04-19,House,"House: Passage, as amended",70,57,0,0,127
1685485,1278157,2023-03-16,House,"House: Passage",122,0,0,0,122
1685670,1301643,2023-04-13,House,"House: Passage",77,48,0,0,125
1691721,1273091,2023-03-09,House,"House: Neu Brindley - AMENDMENT - H1104A9",58,70,0,0,128
1691721,1273092,2023-03-09,House,"House: Neu Brindley - AMENDMENT - H1104A16",58,70,0,0,128
1691721,1273093,2023-03-09,House,"House: Robbins - AMENDMENT - H1104A12",58,70,0,0,128
1691721,1273094,2023-03-09,House,"House: Passage, as amended",70,58,0,0,128
1691790,1290473,2023-03-30,House,"House: Passage, as amended",126,0,0,0,126
1691921,1292056,2023-04-03,House,"House: Passage",124,0,0,0,124
1691931,1300354,2023-04-12,House,"House: Passage",127,0,0,0,127
1691931,1323257,2023-05-10,Senate,"Senate: Third reading Passed",42,21,0,0,63
1691931,1324166,2023-05-11,House,"House: H.F. NO. 1126",120,8,0,0,128
1692109,1276885,2023-03-15,House,"House: H.F. NO. 1269",69,56,0,0,125
1692330,1283743,2023-03-23,House,"House: Novotny - Amendment - H1200A3",63,69,0,0,132
1692330,1283744,2023-03-23,House,"House: Daudt - Amendment - H1200A5",63,69,0,0,132
1692330,1283745,2023-03-23,House,"House: Passage, as amended",70,61,0,0,131
1692547,1316065,2023-05-01,House,"House: Passage, as amended",89,41,0,0,130
1692547,1324080,2023-05-11,Senate,"Senate: Third reading Passed",40,22,0,0,62
1692547,1325158,2023-05-15,House,"House: H.F. NO. 1234",78,54,0,0,132
1693012,1256741,2023-02-20,House,"House: H.F. NO. 1224",70,59,0,0,129
1694832,1290807,2023-03-30,Senate,"Senate: Special Order: Amended",52,12,0,0,64
1694832,1290808,2023-03-30,Senate,"Senate: Third reading Passed",44,20,0,0,64
1694967,1309328,2023-04-24,Senate,"Senate: Third reading Passed",36,31,0,0,67
1695132,1324522,2023-05-12,Senate,"Senate: Third reading Passed",47,19,0,0,66
1696019,1290396,2023-03-30,House,"House: Passage, as amended",126,0,0,0,126
1696019,1298563,2023-04-11,Senate,"Senate: Referred to Finance",42,11,0,0,53
1696019,1298564,2023-04-11,Senate,"Senate: Taken from table",53,0,0,0,53
1696019,1301456,2023-04-13,Senate,"Senate: Third reading Passed",62,0,0,0,62
1696019,1301457,2023-04-13,House,"House: H.F. NO. 1278",127,0,0,0,127
1696092,1290399,2023-03-30,House,"House: Passage",127,0,0,0,127
1696092,1323190,2023-05-10,Senate,"Senate: Third reading Passed",64,1,0,0,65
1696092,1324486,2023-05-12,House,"House: H.F. NO. 1370",58,70,0,0,128
1696092,1324487,2023-05-12,House,"House: H.F. NO. 1370",70,58,0,0,128
1696092,1324488,2023-05-12,House,"House: H.F. NO. 1370",71,57,0,0,128
1696092,1326369,2023-05-16,House,"House: H.F. NO. 1370",131,0,0,0,131
1696092,1327330,2023-05-17,Senate,"Senate: Third reading",66,1,0,0,67
1696148,1286205,2023-03-27,House,"House: Passage",79,51,0,0,130
1696371,1286501,2023-03-27,House,"House: Passage",130,0,0,0,130
1698402,1312342,2023-04-26,Senate,"Senate: Third reading Passed",34,33,0,0,67
1698402,1355558,2023-04-26,Senate,"Senate: Third reading Passed",32,34,0,0,66
1698402,1355559,2023-04-26,Senate,"Senate: Third reading Passed",32,34,0,0,66
1698609,1310713,2023-04-25,Senate,"Senate: Third reading Passed",36,30,0,0,66
1698609,1316022,2023-05-01,House,"House: Myers - Amendment - S1384A13",61,69,0,0,130
1698609,1316023,2023-05-01,House,"House: Kresha - Amendment - S1384A11",61,68,0,0,129
1698609,1316024,2023-05-01,House,"House: Schultz - Amendment - S1384A6",61,69,0,0,130
1698609,1316025,2023-05-01,House,"House: Kresha - Amendment - S1384A7",61,69,0,0,130
1698609,1316026,2023-05-01,House,"House: Kresha - Amendment - S1384A8",61,69,0,0,130
1698609,1316027,2023-05-01,House,"House: Schultz - Amendment - S1384A5",61,69,0,0,130
1698609,1316028,2023-05-01,House,"House: McDonald - Amendment - S1384A9",61,69,0,0,130
1698609,1316029,2023-05-01,House,"House: Passage, as amended",69,61,0,0,130
1698609,1330265,2023-05-22,Senate,"Senate: Senate adopted CC report and repassed bill",39,26,0,0,65
1698609,1330266,2023-05-22,Senate,"Senate: Senate adopted CC report and repassed bill",39,26,0,0,65
1698609,1330873,2023-05-22,House,"House: S.F. NO. 1384",112,17,0,0,129
1698609,1381293,2023-05-22,Senate,"Senate: Third reading",40,25,0,0,65
1699436,1311206,2023-04-25,House,"House: Passage, as amended",115,10,0,0,125
1699436,1324777,2023-05-12,Senate,"Senate: Third reading Passed",61,4,0,0,65
1699436,1325603,2023-05-15,House,"House: H.F. NO. 1403",132,0,0,0,132
1699484,1292138,2023-04-03,House,"House: Passage",123,0,0,0,123
1699484,1324597,2023-05-12,Senate,"Senate: Third reading Passed",65,0,0,0,65
1699484,1325267,2023-05-15,House,"House: H.F. NO. 1486",132,0,0,0,132
1699527,1278052,2023-03-16,House,"House: Passage, as amended",73,50,0,0,123
1699527,1286077,2023-03-27,Senate,"Senate: Third reading Passed",29,33,0,0,62
1699527,1286674,2023-03-27,Senate,"Senate: Third reading Passed",29,34,0,0,63
1700760,1264243,2023-02-27,Senate,"Senate: Motion did not prevail to withdraw and be placed on General Orders",32,34,0,0,66
1701766,1286207,2023-03-27,House,"House: Passage",130,0,0,0,130
1702094,1307804,2023-04-21,House,"House: Passage, as amended",123,0,0,0,123
1702247,1292281,2023-04-03,House,"House: Passage",123,0,0,0,123
1702247,1299661,2023-04-12,Senate,"Senate: Third reading Passed",63,1,0,0,64
1705189,1283738,2023-03-23,House,"House: 62 - Amendment to Mekeland Amendment - Nays",69,62,0,0,131
1705189,1283739,2023-03-23,House,"House: Swedzinski - Amendment - H1656A7",61,69,0,0,130
1705189,1283740,2023-03-23,House,"House: Passage, as amended",83,47,0,0,130
1705189,1299027,2023-04-11,Senate,"Senate: Special Order: Rule 45 amendment stricken",37,21,0,0,58
1705189,1299028,2023-04-11,Senate,"Senate: Third reading Passed",29,34,0,0,63
1705367,1307225,2023-04-20,House,"House: Passage, as amended",87,39,0,0,126
1705367,1315149,2023-04-26,Senate,"Senate: Third reading Passed",61,0,0,0,61
1705367,1381292,2023-04-26,Senate,"Senate: Third reading Passed",61,4,0,0,65
1708157,1304530,2023-04-18,House,"House: Klevorn - Amendment - H1830A36",71,59,0,0,130
1708157,1304531,2023-04-18,House,"House: Harder - Amendment - H1830A13",61,70,0,0,131
1708157,1304532,2023-04-18,House,"House: Harder - Amendment - H1830A19",62,69,0,0,131
1708157,1304533,2023-04-18,House,"House: Zeleznikar - Amendment - H1830A23",61,70,0,0,131
1708157,1304534,2023-04-18,House,"House: West - Amendment - H1830A42",61,70,0,0,131
1708157,1304535,2023-04-18,House,"House: Franson - Amendment - H1830A24",61,70,0,0,131
1708157,1304536,2023-04-18,House,"House: Franson - Amendment - H1830A25",61,70,0,0,131
1708157,1304537,2023-04-18,House,"House: Altendorf - Amendment - H1830A29",61,70,0,0,131
1708157,1304538,2023-04-18,House,"House: Altendorf - Amendment - H1830A30",61,70,0,0,131
1708157,1304539,2023-04-18,House,"House: Niska - Amendment - H1830A34",61,69,0,0,130
1708157,1304540,2023-04-18,House,"House: Engen - Amendment - H1830A44",61,70,0,0,131
1708157,1304541,2023-04-18,House,"House: Quam - Amendment - H1830A32",60,71,0,0,131
1708157,1304542,2023-04-18,House,"House: Quam - Amendment - H1830A40",61,70,0,0,131
1708157,1304543,2023-04-18,House,"House: Nash - Amendment - H1830A12",61,69,0,0,130
1708157,1304544,2023-04-18,House,"House: 61 - Amendment to Nash Amendment - Nays",70,61,0,0,131
1708157,1304545,2023-04-18,House,"House: 61 - Amendment to Davis Amendment - Nays",70,61,0,0,131
1708157,1304546,2023-04-18,House,"House: Davis - First Portion Amendment - H1830A28",131,0,0,0,131
1708157,1304547,2023-04-18,House,"House: Davis - Second Portion Amendment - H1830A28",60,69,0,0,129
1708157,1304548,2023-04-18,House,"House: CALL OF THE HOUSE",130,0,0,0,130
1708157,1304549,2023-04-18,House,"House: Shall the decision of Speaker pro tempore Wolgamott stand as the judgment of the House?",70,53,0,0,123
1708157,1304550,2023-04-18,House,"House: 73 - Amendment to Joy Amendment - Nays",56,73,0,0,129
1708157,1304551,2023-04-18,House,"House: Joy - Amendment - H1830A14",59,70,0,0,129
1708157,1304552,2023-04-18,House,"House: Passage, as amended",70,59,0,0,129
1708157,1307298,2023-04-20,Senate,"Senate: Third reading Passed",34,33,0,0,67
1708157,1329600,2023-05-19,Senate,"Senate: Motion to reject CC report, did not prevail",31,33,0,0,64
1708157,1329601,2023-05-19,Senate,"Senate: Senate adopted CC report and repassed bill",34,31,0,0,65
1708157,1329602,2023-05-19,Senate,"Senate: Third reading",34,31,0,0,65
1708157,1329603,2023-05-19,House,"House: H.F. NO. 1830",69,62,0,0,131
1708161,1304958,2023-04-18,House,"House: Nadeau - Amendment - H1826A28",57,70,0,0,127
1708161,1304959,2023-04-18,House,"House: Koznick - Amendment - H1826A11",59,70,0,0,129
1708161,1304960,2023-04-18,House,"House: Novotny - Amendment - H1826A13",58,71,0,0,129
1708161,1304961,2023-04-18,House,"House: Franson - Amendment - H1826A17",59,69,0,0,128
1708161,1304962,2023-04-18,House,"House: Passage, as amended",71,58,0,0,129
1708161,1310697,2023-04-25,Senate,"Senate: Third reading Passed",35,31,0,0,66
1709405,1276961,2023-03-15,Senate,"Senate: Third reading Passed",55,0,0,0,55
1709405,1292217,2023-04-03,House,"House: Passage",121,2,0,0,123
1710704,1304668,2023-04-18,House,"House: Passage, as amended",131,0,0,0,131
1710704,1307423,2023-04-20,Senate,"Senate: Motion did not prevail to strike Rule 45",32,34,0,0,66
1710704,1307424,2023-04-20,Senate,"Senate: Third reading Passed",32,34,0,0,66
1710704,1320810,2023-05-08,House,"House: H.F. NO.1937",131,0,0,0,131
1710704,1321893,2023-05-09,Senate,"Senate: Third reading",61,5,0,0,66
1710874,1313953,2023-04-27,House,"House: Anderson, P. E. - Amendment - H1938A35",64,64,0,0,128
1710874,1313954,2023-04-27,House,"House: Robbins - Amendment - H1938A32",58,69,0,0,127
1710874,1313955,2023-04-27,House,"House: Koznick - Amendment - H1938A33",58,69,0,0,127
1710874,1313956,2023-04-27,House,"House: Witte - Amendment - H1938A55",57,68,0,0,125
1710874,1313957,2023-04-27,House,"House: Witte - Amendment - H1938A59",59,66,0,0,125
1710874,1313958,2023-04-27,House,"House: Koznick - Amendment - H1938A45",59,66,0,0,125
1710874,1313959,2023-04-27,House,"House: Robbins - Amendment - H1938A29",57,68,0,0,125
1710874,1313960,2023-04-27,House,"House: Hudson - Amendment - H1938A30",56,68,0,0,124
1710874,1313961,2023-04-27,House,"House: Olson, B. - Amendment - H1938A25",58,66,0,0,124
1710874,1313962,2023-04-27,House,"House: Passage, as amended",69,57,0,0,126
1710874,1317357,2023-05-02,Senate,"Senate: Third reading Passed",34,33,0,0,67
1710874,1329612,2023-05-20,House,"House: H.F. NO. 1938",63,68,0,0,131
1710874,1329613,2023-05-20,House,"House: H.F. NO. 1938",69,63,0,0,132
1710874,1329637,2023-05-21,Senate,"Senate: Motion to reject CC report, did not prevail",33,34,0,0,67
1710874,1329638,2023-05-21,Senate,"Senate: Senate adopted CC report and repassed bill",34,33,0,0,67
1710874,1329639,2023-05-21,Senate,"Senate: Third reading",34,33,0,0,67
1710880,1386739,2024-02-12,House,"House: H.F. NO. 1930",70,61,0,0,131
1711132,1324087,2023-05-11,House,"House: Torkelson - Amendment - H1900A10",60,68,0,0,128
1711132,1324088,2023-05-11,House,"House: Passage, as amended",87,41,0,0,128
1711132,1329615,2023-05-20,Senate,"Senate: Third reading Passed",36,29,0,0,65
1714058,1301381,2023-04-13,Senate,"Senate: Third reading Passed",58,7,0,0,65
1714058,1301723,2023-04-13,Senate,"Senate: Third reading Passed",58,7,0,0,65
1714058,1307179,2023-04-20,House,"House: Anderson, P. H. - Amendment - S1955A8",59,69,0,0,128
1714058,1307180,2023-04-20,House,"House: Burkel - Amendment - S1955A10",59,69,0,0,128
1714058,1307181,2023-04-20,House,"House: Jacob - Amendment - S1955A7",61,67,0,0,128
1714058,1307182,2023-04-20,House,"House: Burkel - Amendment - S1955A2",59,69,0,0,128
1714058,1307183,2023-04-20,House,"House: Anderson, P. H. - Amendment - S1955A5",59,69,0,0,128
1714058,1307184,2023-04-20,House,"House: Anderson, P. H. - Amendment - S1955A6",60,68,0,0,128
1714058,1307185,2023-04-20,House,"House: Anderson, P. H. - Amendment - S1955A3",55,69,0,0,124
1714058,1307186,2023-04-20,House,"House: Passage, as amended",70,58,0,0,128
1714058,1324061,2023-05-11,Senate,"Senate: Senate adopted CC report and repassed bill",49,17,0,0,66
1714058,1324062,2023-05-11,Senate,"Senate: Third reading",49,17,0,0,66
1714058,1324303,2023-05-11,House,"House: S.F. NO. 1955",85,44,0,0,129
1714122,1261893,2023-02-20,Senate,"Senate: Adopted",49,13,0,0,62
1715187,1307941,2023-04-21,House,"House: Passage",122,0,0,0,122
1715222,1426216,2024-04-11,House,"House: Passage, as amended",112,18,0,0,130
1715222,1436341,2024-04-29,Senate,"Senate: Third reading Passed",33,34,0,0,67
1715300,1300095,2023-04-12,House,"House: Robbins - Amendment - H2073A4",58,69,0,0,127
1715300,1300096,2023-04-12,House,"House: Nash - Amendment - H2073A6",58,69,0,0,127
1715300,1300097,2023-04-12,House,"House: McDonald - Amendment - H2073A7",58,69,0,0,127
1715300,1300099,2023-04-12,House,"House: Passage, as amended",69,58,0,0,127
1715300,1304789,2023-04-18,Senate,"Senate: Third reading Passed",36,31,0,0,67
1715300,1321833,2023-05-09,House,"House: H.F. NO. 2073",69,62,0,0,131
1715300,1323142,2023-05-10,Senate,"Senate: Senate adopted CC report and repassed bill",34,30,0,0,64
1715300,1323143,2023-05-10,Senate,"Senate: Third reading",34,30,0,0,64
1715433,1300199,2023-04-12,House,"House: Pfarr - Amendment - H1999A15",59,67,0,0,126
1715433,1300200,2023-04-12,House,"House: Backer - Amendment - H1999A14",59,69,0,0,128
1715433,1300201,2023-04-12,House,"House: Baker - Amendment - H1999A11",53,73,0,0,126
1715433,1300202,2023-04-12,House,"House: Heintzeman - Amendment - H1999A17",80,11,0,0,91
1715433,1300203,2023-04-12,House,"House: Heintzeman - Amendment - H1999A12",77,13,0,0,90
1715433,1300204,2023-04-12,House,"House: CALL OF THE HOUSE",128,0,0,0,128
1715433,1300205,2023-04-12,House,"House: Passage, as amended",69,59,0,0,128
1715433,1303173,2023-04-17,Senate,"Senate: Third reading Passed",34,31,0,0,65
1715433,1321704,2023-05-09,House,"House: H.F. NO. 1999",69,62,0,0,131
1715433,1321705,2023-05-09,House,"House: H.F. NO. 1999",101,31,0,0,132
1715433,1323131,2023-05-10,Senate,"Senate: Senate adopted CC report and repassed bill",39,24,0,0,63
1715433,1323132,2023-05-10,Senate,"Senate: Third reading",40,24,0,0,64
1716201,1271958,2023-03-08,House,"House: H.F. NO. 2093",70,61,0,0,131
1716201,1271959,2023-03-08,House,"House: H.F. NO. 2093",129,2,0,0,131
1716302,1303402,2023-04-17,House,"House: Passage",128,0,0,0,128
1720836,1313830,2023-04-27,Senate,"Senate: Third reading Passed",38,29,0,0,67
1721217,1301526,2023-04-13,House,"House: Passage",114,13,0,0,127
1721217,1323261,2023-05-10,Senate,"Senate: Third reading Passed",60,5,0,0,65
1721465,1290502,2023-03-30,House,"House: Passage, as amended",126,0,0,0,126
1722366,1307504,2023-04-20,House,"House: Hudson - Amendment - H2292A2",59,69,0,0,128
1722366,1307505,2023-04-20,House,"House: Kresha - Amendment - H2292DE4",58,69,0,0,127
1722366,1307506,2023-04-20,House,"House: Passage",71,57,0,0,128
1722366,1309451,2023-04-24,Senate,"Senate: Third reading Passed",43,24,0,0,67
1722366,1324485,2023-05-12,House,"House: H.F. NO. 2292",120,5,0,0,125
1722366,1324571,2023-05-13,House,"House: H.F. NO. 2292",70,0,0,0,70
1722366,1324572,2023-05-13,House,"House: H.F. NO. 2292",128,0,0,0,128
1722366,1325152,2023-05-15,House,"House: H.F. NO. 2292",71,61,0,0,132
1722366,1326245,2023-05-16,Senate,"Senate: Motion to reject CC report, did not prevail",32,35,0,0,67
1722366,1326246,2023-05-16,Senate,"Senate: Senate adopted CC report and repassed bill",38,29,0,0,67
1722366,1326247,2023-05-16,Senate,"Senate: Third reading",38,29,0,0,67
1722915,1313927,2023-04-27,Senate,"Senate: Third reading Passed",49,18,0,0,67
1722915,1444854,2024-05-18,House,"House: Passage",71,58,0,0,129
1722915,1444932,2024-05-19,Senate,"Senate: Motion did not prevail to lay on the table",24,36,0,0,60
1722915,1444933,2024-05-19,Senate,"Senate: Third reading Passed as amended",24,36,0,0,60
1723090,1286076,2023-03-27,Senate,"Senate: Third reading Passed",46,18,0,0,64
1723090,1286523,2023-03-27,Senate,"Senate: Third reading Passed",46,18,0,0,64
1723090,1290376,2023-03-30,House,"House: Passage",82,44,0,0,126
1723284,1303037,2023-04-17,House,"House: CALL OF THE HOUSE",128,0,0,0,128
1723284,1303038,2023-04-17,House,"House: Hansen, R. - Amendment - H2310A50",109,14,0,0,123
1723284,1303039,2023-04-17,House,"House: Fischer - Amendment - H2310A30",69,57,0,0,126
1723284,1303040,2023-04-17,House,"House: Heintzeman - Amendment - H2310A49",61,66,0,0,127
1723284,1303041,2023-04-17,House,"House: Quam - Amendment - H2310A45",59,69,0,0,128
1723284,1303042,2023-04-17,House,"House: 69 - Amendment to Quam Amendment - Nays",59,69,0,0,128
1723284,1303043,2023-04-17,House,"House: Quam - Amendment - A23-0124",59,69,0,0,128
1723284,1303044,2023-04-17,House,"House: Igo - Amendment - H2310A39",59,68,0,0,127
1723284,1303045,2023-04-17,House,"House: Swedzinski - Amendment - H2310A31",59,69,0,0,128
1723284,1303046,2023-04-17,House,"House: 69 - Amendment to Igo Amendment - Nays",59,69,0,0,128
1723284,1303047,2023-04-17,House,"House: Igo - Amendment - H2310A36",60,68,0,0,128
1723284,1303049,2023-04-17,House,"House: 59 - Amendment to Swedzinski Amendment - Nays",69,59,0,0,128
1723284,1303050,2023-04-17,House,"House: Scott - Amendment - H2310A23",59,69,0,0,128
1723284,1303051,2023-04-17,House,"House: Garofalo - Amendment - H2310A56",58,70,0,0,128
1723284,1303052,2023-04-17,House,"House: Passage, as amended",69,59,0,0,128
1723284,1307376,2023-04-20,Senate,"Senate: Third reading Passed",37,29,0,0,66
1723284,1327323,2023-05-17,House,"House: H.F. NO. 2310",129,0,0,0,129
1723284,1329050,2023-05-18,Senate,"Senate: Motion to reject CC report, did not prevail",33,33,0,0,66
1723284,1329051,2023-05-18,Senate,"Senate: Senate adopted CC report and repassed bill",35,32,0,0,67
1723284,1329052,2023-05-18,Senate,"Senate: Third reading",35,32,0,0,67
1723284,1329053,2023-05-18,House,"House: H.F. NO. 2310",121,6,0,0,127
1723284,1329054,2023-05-18,House,"House: H.F. NO. 2310",126,0,0,0,126
1723284,1329055,2023-05-18,House,"House: H.F. NO. 2310",60,68,0,0,128
1723284,1329056,2023-05-18,House,"House: H.F. NO. 2310",72,57,0,0,129
1723458,1305930,2023-04-19,House,"House: Nash - Amendment - H2335A37",32,90,0,0,122
1723458,1305931,2023-04-19,House,"House: Dotseth - Amendment - H2335A35",56,70,0,0,126
1723458,1305932,2023-04-19,House,"House: Myers - Amendment - H2335A21",57,69,0,0,126
1723458,1305933,2023-04-19,House,"House: Myers - Amendment - H2335A42",58,70,0,0,128
1723458,1305934,2023-04-19,House,"House: Nash - Amendment - H2335A34",58,70,0,0,128
1723458,1305935,2023-04-19,House,"House: Myers - Amendment - H2335A32",59,69,0,0,128
1723458,1305936,2023-04-19,House,"House: Johnson - Amendment - H2335A25",54,70,0,0,124
1723458,1305937,2023-04-19,House,"House: Passage, as amended",70,57,0,0,127
1723458,1310699,2023-04-25,Senate,"Senate: Third reading Passed",39,28,0,0,67
1723458,1320798,2023-05-08,House,"House: H.F. NO.2335",70,61,0,0,131
1723458,1320799,2023-05-08,House,"House: H.F. NO.2335",70,61,0,0,131
1723458,1321700,2023-05-09,Senate,"Senate: Motion to reject CC report, did not prevail",32,34,0,0,66
1723458,1321701,2023-05-09,Senate,"Senate: Senate adopted CC report and repassed bill",34,32,0,0,66
1723458,1321702,2023-05-09,Senate,"Senate: Third reading",34,32,0,0,66
1723564,1303414,2023-04-17,House,"House: Passage",128,0,0,0,128
1724662,1311407,2023-04-25,Senate,"Senate: Third reading Passed",48,18,0,0,66
1724662,1317394,2023-05-02,House,"House: Nash - Amendment - S2369A1",63,69,0,0,132
1724662,1317395,2023-05-02,House,"House: Passage",85,44,0,0,129
1725520,1307192,2023-04-20,House,"House: Kresha - Amendment - H2497DE5",59,70,0,0,129
1725520,1307193,2023-04-20,House,"House: West - Amendment - H2497A28",61,70,0,0,131
1725520,1307194,2023-04-20,House,"House: Mueller - Amendment - H2497A26",61,70,0,0,131
1725520,1307195,2023-04-20,House,"House: Bakeberg - Amendment - H2497A19",61,70,0,0,131
1725520,1307196,2023-04-20,House,"House: Bennett - Amendment - H2497A29",60,70,0,0,130
1725520,1307197,2023-04-20,House,"House: Bennett - First Portion Amendment - H2497A22",60,70,0,0,130
1725520,1307198,2023-04-20,House,"House: Bennett - Second Portion Amendment - H2497A22",59,70,0,0,129
1725520,1307199,2023-04-20,House,"House: Passage, as amended",70,60,0,0,130
1725520,1309446,2023-04-24,Senate,"Senate: Third reading Passed",35,32,0,0,67
1725520,1326208,2023-05-16,Senate,"Senate: Motion to reject CC report, did not prevail",33,34,0,0,67
1725520,1326209,2023-05-16,Senate,"Senate: Third reading",35,32,0,0,67
1725520,1326210,2023-05-16,House,"House: H.F. NO. 2497",70,62,0,0,132
1725520,1326610,2023-05-16,Senate,"Senate: Senate adopted CC report and repassed bill",35,32,0,0,67
1725648,1437439,2024-04-30,House,"House: 68 - Amendment to Pinto Amendment - Nays",61,68,0,0,129
1725648,1437440,2024-04-30,House,"House: Nelson, N. - Amendment - H2476A9",61,69,0,0,130
1725648,1437441,2024-04-30,House,"House: Zeleznikar - Amendment - H2476A14",61,69,0,0,130
1725648,1437442,2024-04-30,House,"House: Zeleznikar - Amendment - H2476A7",61,69,0,0,130
1725648,1437443,2024-04-30,House,"House: Shall the decision of the Speaker stand as the judgment of the House?",69,61,0,0,130
1725648,1437444,2024-04-30,House,"House: Long motion Lay on the Table",107,23,0,0,130
1725648,1437933,2024-05-01,House,"House: H.F. NO. 2476",61,69,0,0,130
1725648,1437935,2024-05-01,House,"House: H.F. NO. 2476",68,62,0,0,130
1725699,1328925,2023-05-17,House,"House: Garofalo - Amendment - H2369DE13",60,69,0,0,129
1725699,1328926,2023-05-17,House,"House: 0 - Amendment to Hassan Amendment - Nays",129,0,0,0,129
1725699,1328927,2023-05-17,House,"House: 1 - Amendment to Hassan Amendment - Nays",125,1,0,0,126
1725699,1328928,2023-05-17,House,"House: 2 - Amendment to Hassan Amendment - Nays",127,2,0,0,129
1725699,1328929,2023-05-17,House,"House: 0 - Amendment to Hassan Amendment - Nays",128,0,0,0,128
1725699,1328930,2023-05-17,House,"House: 0 - Amendment to Hassan Amendment - Nays",129,0,0,0,129
1725699,1328931,2023-05-17,House,"House: 0 - Amendment to Hassan Amendment - Nays",129,0,0,0,129
1725699,1328932,2023-05-17,House,"House: 0 - Amendment to Hassan Amendment - Nays",123,0,0,0,123
1725699,1328933,2023-05-17,House,"House: 0 - Amendment to Hassan Amendment - Nays",126,0,0,0,126
1725699,1329081,2023-05-18,House,"House: 0 - Amendment to Hassan Amendment - Nays",130,0,0,0,130
1725699,1329082,2023-05-18,House,"House: 69 - Amendment to Hassan Amendment - Nays",61,69,0,0,130
1725699,1329083,2023-05-18,House,"House: 70 - Amendment to Hassan Amendment - Nays",60,70,0,0,130
1725699,1329084,2023-05-18,House,"House: 69 - Amendment to Hassan Amendment - Nays",61,69,0,0,130
1725699,1329085,2023-05-18,House,"House: 69 - Amendment to Hassan Amendment - Nays",58,69,0,0,127
1725699,1329086,2023-05-18,House,"House: 69 - Amendment to Hassan Amendment - Nays",61,69,0,0,130
1725699,1329087,2023-05-18,House,"House: 69 - Amendment to Hassan Amendment - Nays",60,69,0,0,129
1725699,1329088,2023-05-18,House,"House: 68 - Amendment to Hassan Amendment - Nays",61,68,0,0,129
1725699,1329089,2023-05-18,House,"House: 69 - Amendment to Hassan Amendment - Nays",60,69,0,0,129
1725699,1329090,2023-05-18,House,"House: 69 - Amendment to Hassan Amendment - Nays",61,69,0,0,130
1725699,1329091,2023-05-18,House,"House: 68 - Amendment to Hassan Amendment - Nays",61,68,0,0,129
1725699,1329092,2023-05-18,House,"House: 69 - Amendment to Hassan Amendment - Nays",61,69,0,0,130
1725699,1329093,2023-05-18,House,"House: 69 - Amendment to Hassan Amendment - Nays",61,69,0,0,130
1725699,1329094,2023-05-18,House,"House: 70 - Amendment to Hassan Amendment - Nays",59,70,0,0,129
1725699,1329095,2023-05-18,House,"House: Shall the decision of the Speaker stand as the judgment of the House?",69,61,0,0,130
1725699,1329096,2023-05-18,House,"House: Shall the decision of the Speaker stand as the judgment of the House?",69,61,0,0,130
1725699,1329097,2023-05-18,House,"House: Shall the decision of the Speaker stand as the judgment of the House?",69,61,0,0,130
1725699,1329098,2023-05-18,House,"House: Shall the decision of the Speaker stand as the judgment of the House?",69,60,0,0,129
1725699,1329099,2023-05-18,House,"House: Hassan - Amendment, as amended - H2369DE12",91,34,0,0,125
1725699,1329100,2023-05-18,House,"House: PASSAGE, as amended",69,61,0,0,130
1725699,1329749,2023-05-21,Senate,"Senate: Third reading Passed",35,32,0,0,67
1728080,1438887,2024-05-02,House,"House: 19 - Amendment to Novotny Amendment - Nays",113,19,0,0,132
1728080,1438888,2024-05-02,House,"House: Novotny - Amendment, as amended - H2609DE2",65,67,0,0,132
1728080,1438889,2024-05-03,House,"House: H.F. NO. 2609",71,59,0,0,130
1728080,1442054,2024-05-09,Senate,"Senate: Third reading Passed",34,33,0,0,67
1728080,1444814,2024-05-17,House,"House: H.F. NO. 2609",61,68,0,0,129
1728080,1444815,2024-05-17,House,"House: H.F. NO. 2609",69,60,0,0,129
1729619,1302035,2023-04-14,Senate,"Senate: Third reading Passed",35,32,0,0,67
1729619,1314680,2023-04-27,House,"House: Perryman - Amendment - S2744A15",58,71,0,0,129
1729619,1314681,2023-04-27,House,"House: Pfarr - Amendment - S2744A12",59,69,0,0,128
1729619,1314682,2023-04-27,House,"House: O'Driscoll - Amendment - S2744A6",59,68,0,0,127
1729619,1314683,2023-04-27,House,"House: Neu Brindley - Amendment - S2744A16",59,68,0,0,127
1729619,1314684,2023-04-27,House,"House: Neu Brindley - Amendment - S2744A17",59,69,0,0,128
1729619,1314685,2023-04-27,House,"House: 59 - Amendment to Daudt Amendment - Nays",69,59,0,0,128
1729619,1314686,2023-04-27,House,"House: O'Driscoll - Amendment - S2744A3",57,69,0,0,126
1729619,1314687,2023-04-27,House,"House: Daudt - Amendment - S2744A13",58,68,0,0,126
1729619,1314688,2023-04-27,House,"House: Passage, as amended",70,58,0,0,128
1729619,1326194,2023-05-16,Senate,"Senate: Laid on table",46,14,0,0,60
1729619,1326195,2023-05-16,Senate,"Senate: Senate adopted CC report and repassed bill",46,14,0,0,60
1729619,1326196,2023-05-16,Senate,"Senate: Third reading Passed",35,32,0,0,67
1729619,1327388,2023-05-17,House,"House: S.F. NO. 2744",69,59,0,0,128
1731889,1390497,2024-02-19,House,"House: Joy - Amendment - H2757A4",59,71,0,0,130
1731889,1390498,2024-02-19,House,"House: Davids - Amendment - H2757A4",61,69,0,0,130
1731889,1390499,2024-02-19,House,"House: Swedzinski - Amendment - H2757A9",60,70,0,0,130
1731889,1390500,2024-02-19,House,"House: Passage",128,2,0,0,130
1731889,1393535,2024-02-22,Senate,"Senate: Third reading Passed",66,0,0,0,66
1731896,1278106,2023-03-16,House,"House: H.F. NO. 2790",55,69,0,0,124
1734945,1314220,2023-04-27,Senate,"Senate: Third reading Passed",43,24,0,0,67
1734945,1381338,2023-04-27,Senate,"Senate: Third reading Passed",43,24,0,0,67
1738308,1312235,2023-04-26,Senate,"Senate: Third reading Passed",51,16,0,0,67
1738308,1381287,2023-04-26,Senate,"Senate: Third reading Passed",51,16,0,0,67
1738308,1427959,2024-04-15,House,"House: Heintzeman - Amendment - S2904A5",62,69,0,0,131
1738308,1427960,2024-04-15,House,"House: Passage, as amended",72,58,0,0,130
1738308,1431374,2024-04-18,Senate,"Senate: Third reading Passed",40,24,0,0,64
1740489,1304701,2023-04-18,Senate,"Senate: Third reading Passed",63,4,0,0,67
1740489,1310984,2023-04-25,House,"House: 60 - Amendment to Backer Amendment - Nays",70,60,0,0,130
1740489,1310985,2023-04-25,House,"House: 59 - Amendment to Zeleznikar Amendment - Nays",70,59,0,0,129
1740489,1310986,2023-04-25,House,"House: 59 - Amendment to Neu Brindley Amendment - Nays",70,59,0,0,129
1740489,1310988,2023-04-25,House,"House: Shall the decision of the Speaker stand as the judgment of the House?",70,59,0,0,129
1740489,1310989,2023-04-25,House,"House: Neu Brindley - Amendment - S2934A6-1",59,70,0,0,129
1740489,1310990,2023-04-25,House,"House: Passage, as amended",70,60,0,0,130
1740489,1329595,2023-05-19,Senate,"Senate: Motion to reject CC report, did not prevail",33,34,0,0,67
1740489,1329596,2023-05-19,Senate,"Senate: Senate adopted CC report and repassed bill",35,32,0,0,67
1740489,1329597,2023-05-19,Senate,"Senate: Third reading",35,32,0,0,67
1740489,1329598,2023-05-19,House,"House: S.F. NO. 2934",71,61,0,0,132
1740589,1302042,2023-04-14,Senate,"Senate: Third reading Passed",34,33,0,0,67
1740589,1311665,2023-04-25,House,"House: 63 - Amendment to Curran Amendment - Nays",67,63,0,0,130
1740589,1311666,2023-04-25,House,"House: 67 - Amendment to Curran Amendment - Nays",63,67,0,0,130
1740589,1311667,2023-04-25,House,"House: Grossell - Amendment - S2909A3",63,67,0,0,130
1740589,1311669,2023-04-25,House,"House: Scott - Amendment - S2909A4",60,70,0,0,130
1740589,1311670,2023-04-25,House,"House: Backer - Amendment - S2909A25",60,70,0,0,130
1740589,1311672,2023-04-25,House,"House: Niska - Amendment - S2909A6",61,70,0,0,131
1740589,1311675,2023-04-25,House,"House: 61 - Amendment to Myers Amendment - Nays",68,61,0,0,129
1740589,1311677,2023-04-25,House,"House: Witte - Amendment - S2909A31",62,68,0,0,130
1740589,1311680,2023-04-25,House,"House: Novotny - Amendment - S2909A30",65,66,0,0,131
1740589,1311683,2023-04-25,House,"House: 61 - Amendment to Neu Brindley Amendment - Nays",70,61,0,0,131
1740589,1311685,2023-04-25,House,"House: 63 - Amendment to Niska Amendment - Nays",67,63,0,0,130
1740589,1311688,2023-04-25,House,"House: 62 - Amendment to Hudson Amendment - Nays",68,62,0,0,130
1740589,1311690,2023-04-25,House,"House: Hudson - Amendment - S2909A28",120,9,0,0,129
1740589,1311693,2023-04-25,House,"House: 62 - Amendment to O’Neill Amendment - Nays",68,62,0,0,130
1740589,1311694,2023-04-25,House,"House: Grossell - Amendment - S2909A24",60,68,0,0,128
1740589,1311696,2023-04-25,House,"House: Niska - Amendment - S2909A21",62,67,0,0,129
1740589,1311699,2023-04-25,House,"House: Johnson - Amendment - S2909A23",62,67,0,0,129
1740589,1311702,2023-04-25,House,"House: Hudson - Amendment - S2909A1",61,68,0,0,129
1740589,1311703,2023-04-25,House,"House: Shall the decision of the Speaker stand as the judgment of the House?",68,61,0,0,129
1740589,1312839,2023-04-26,House,"House: Nash - Amendment - S2909A9",61,70,0,0,131
1740589,1312840,2023-04-26,House,"House: Altendorf - Amendment - S2909A10",62,69,0,0,131
1740589,1312841,2023-04-26,House,"House: Demuth - Amendment - S2909A13",62,69,0,0,131
1740589,1312842,2023-04-26,House,"House: Engen - Amendment - S2909A27",61,70,0,0,131
1740589,1312843,2023-04-26,House,"House: S.F. NO. 2909",70,61,0,0,131
1740589,1312844,2023-04-26,House,"House: S.F. NO. 2909",70,61,0,0,131
1740589,1312845,2023-04-26,House,"House: S.F. NO. 2909",69,60,0,0,129
1740589,1324552,2023-05-12,Senate,"Senate: Motion to reject CC report, did not prevail",33,34,0,0,67
1740589,1324553,2023-05-12,Senate,"Senate: Senate adopted CC report and repassed bill",34,33,0,0,67
1740589,1324554,2023-05-12,Senate,"Senate: Third reading",34,33,0,0,67
1740589,1325228,2023-05-15,House,"House: S.F. NO. 2909",131,0,0,0,131
1740589,1325229,2023-05-15,House,"House: S.F. NO. 2909",60,68,0,0,128
1740589,1325230,2023-05-15,House,"House: S.F. NO. 2909",68,60,0,0,128
1740589,1325231,2023-05-16,House,"House: S.F. NO. 2909",69,63,0,0,132
1741719,1434997,2024-04-24,House,"House: Passage, as amended",129,0,0,0,129
1741766,1304712,2023-04-18,House,"House: 59 - Amendment to Fogelman Amendment - Nays",70,59,0,0,129
1741766,1304713,2023-04-18,House,"House: Fogelman - Amendment - H2887A51",62,67,0,0,129
1741766,1305999,2023-04-19,House,"House:  - Amendment to Petersburg Amendment - Backer",60,68,0,0,128
1741766,1306000,2023-04-19,House,"House: Petersburg - Amendment - H2887A59",60,68,0,0,128
1741766,1306001,2023-04-19,House,"House: Daudt - Amendment - H2887A57",60,68,0,0,128
1741766,1306002,2023-04-19,House,"House: Anderson, P. H - Amendment - H2887A69",60,69,0,0,129
1741766,1306003,2023-04-19,House,"House: Hudella - Amendment - H2887A54",62,67,0,0,129
1741766,1306004,2023-04-19,House,"House: Murphy - Amendment - H2887A70",61,68,0,0,129
1741766,1306005,2023-04-19,House,"House: Nadeau - Amendment - H2887A80",59,68,0,0,127
1741766,1306006,2023-04-19,House,"House: West - Amendment - H2887A47",60,69,0,0,129
1741766,1306007,2023-04-19,House,"House: West - Amendment - H2887A55",60,69,0,0,129
1741766,1306008,2023-04-19,House,"House: West - Amendment - H2887A65",60,69,0,0,129
1741766,1306009,2023-04-19,House,"House: H.F. NO. 2887",130,0,0,0,130
1741766,1306010,2023-04-19,House,"House: West - Amendment - H2887A89",64,66,0,0,130
1741766,1306011,2023-04-19,House,"House: Koznick - Amendment - H2887A75",61,69,0,0,130
1741766,1306012,2023-04-19,House,"House: Koznick - Amendment - H2887A74",62,68,0,0,130
1741766,1306013,2023-04-19,House,"House: Schultz - Amendment - H2887A94",60,70,0,0,130
1741766,1306014,2023-04-19,House,"House: Olson, B. - Amendment - H2887A39",61,68,0,0,129
1741766,1306015,2023-04-19,House,"House: H.F. NO. 2887",71,59,0,0,130
1741766,1313852,2023-04-27,Senate,"Senate: Third reading Passed",36,31,0,0,67
1741766,1329633,2023-05-21,Senate,"Senate: Senate adopted CC report and repassed bill",34,31,0,0,65
1741766,1329634,2023-05-21,Senate,"Senate: Third reading",34,32,0,0,66
1741766,1329635,2023-05-21,House,"House: H.F. NO. 2887",69,58,0,0,127
1741766,1329636,2023-05-21,House,"House: H.F. NO. 2887",69,61,0,0,130
1741766,1381278,2023-04-27,Senate,"Senate: Third reading Passed",36,31,0,0,67
1743150,1307757,2023-04-21,House,"House: Passage",122,0,0,0,122
1743150,1324563,2023-05-12,Senate,"Senate: Third reading Passed",64,1,0,0,65
1743150,1325143,2023-05-15,House,"House: H.F. NO. 2950",132,0,0,0,132
1743881,1306116,2023-04-19,Senate,"Senate: Third reading Passed",35,32,0,0,67
1743881,1313257,2023-04-26,House,"House: Quam - Amendment - S2995A10",56,69,0,0,125
1743881,1313258,2023-04-26,House,"House: Schomacker - Amendment - S2995A23",58,67,0,0,125
1743881,1313259,2023-04-26,House,"House: Schomacker - Amendment - S2995A13-1",55,68,0,0,123
1743881,1313260,2023-04-26,House,"House: Schomacker - Amendment - S2995A14",57,69,0,0,126
1743881,1313261,2023-04-26,House,"House: Schultz - Amendment - S2995A2-1",56,69,0,0,125
1743881,1313262,2023-04-26,House,"House: Scott - Amendment - S2995A7",57,68,0,0,125
1743881,1313263,2023-04-26,House,"House: Schomacker - Amendment - S2995A4-2",57,68,0,0,125
1743881,1313265,2023-04-26,House,"House: Davis - Amendment - S2995A24",58,68,0,0,126
1743881,1313266,2023-04-26,House,"House: Scott - Amendment - S2995A15",59,67,0,0,126
1743881,1313267,2023-04-26,House,"House: Scott - Amendment - S2995A16",58,67,0,0,125
1743881,1313269,2023-04-26,House,"House: Demuth - Amendment - S2995A17",59,67,0,0,126
1743881,1313270,2023-04-26,House,"House: CALL OF THE HOUSE",126,0,0,0,126
1743881,1313271,2023-04-26,House,"House: Franson - Amendment - S2995A22",57,69,0,0,126
1743881,1313272,2023-04-26,House,"House: Daudt motion Motion to Reconsider",117,6,0,0,123
1743881,1313273,2023-04-26,House,"House: Franson - Amendment - S2995A9",57,68,0,0,125
1743881,1313275,2023-04-26,House,"House: Perryman - Amendment - S2995A11-1",57,69,0,0,126
1743881,1313276,2023-04-26,House,"House: Passage, as amended",69,58,0,0,127
1743881,1330626,2023-05-22,Senate,"Senate: Motion to reject CC report, did not prevail",32,34,0,0,66
1743881,1330627,2023-05-22,Senate,"Senate: Senate adopted CC report and repassed bill",34,32,0,0,66
1743881,1330628,2023-05-22,Senate,"Senate: Third reading",34,32,0,0,66
1743881,1330629,2023-05-22,House,"House: S.F. NO. 2995",63,69,0,0,132
1743881,1330630,2023-05-22,House,"House: S.F. NO. 2995",69,64,0,0,133
1744117,1320693,2023-05-08,House,"House: Passage",131,0,0,0,131
1744117,1325619,2023-05-15,Senate,"Senate: Laid on table",34,31,0,0,65
1744117,1325620,2023-05-15,Senate,"Senate: Taken from table",33,34,0,0,67
1744117,1325621,2023-05-15,Senate,"Senate: Third reading Passed",67,0,0,0,67
1745029,1302032,2023-04-14,Senate,"Senate: Third reading Passed",35,31,0,0,66
1745029,1309602,2023-04-24,House,"House: 60 - Amendment to Koznick Amendment - Nays",69,60,0,0,129
1745029,1309603,2023-04-24,House,"House: Shall the decision of Speaker pro tempore Wolgamott stand as the judgment of the House?",68,61,0,0,129
1745029,1309604,2023-04-24,House,"House: Baker - First Portion Amendment - S3035A19",60,69,0,0,129
1745029,1309605,2023-04-24,House,"House: Baker - Second Portion Amendment - S3035A19",60,69,0,0,129
1745029,1309606,2023-04-24,House,"House: Mekeland - Amendment - S3035A26",60,69,0,0,129
1745029,1309607,2023-04-24,House,"House: Mekeland - Amendment - S3035A14",60,69,0,0,129
1745029,1309608,2023-04-24,House,"House: Niska - Amendment - S3035A1",61,69,0,0,130
1745029,1309609,2023-04-24,House,"House: Mekeland - Amendment - S3035A28",61,69,0,0,130
1745029,1309610,2023-04-24,House,"House: Mekeland - Amendment - S3035A27",60,69,0,0,129
1745029,1309611,2023-04-24,House,"House: Schultz - Amendment - S3035A10",60,69,0,0,129
1745029,1309612,2023-04-24,House,"House: Neu Brindley - Amendment - S3035A24",61,69,0,0,130
1745029,1309613,2023-04-24,House,"House: Neu Brindley - Amendment - S3035A23",61,69,0,0,130
1745029,1309614,2023-04-24,House,"House: Neu Brindley - Amendment - S3035A22",61,69,0,0,130
1745029,1309615,2023-04-24,House,"House: Shall the decision of the Speaker stand as the judgment of the House?",69,61,0,0,130
1745029,1309616,2023-04-24,House,"House: Passage, as amended",69,61,0,0,130
1745029,1325133,2023-05-15,Senate,"Senate: Motion to reject CC report, did not prevail",33,34,0,0,67
1745029,1325134,2023-05-15,Senate,"Senate: Point of order well taken",56,8,0,0,64
1745029,1325135,2023-05-15,Senate,"Senate: Point of order well taken",56,8,0,0,64
1745029,1326198,2023-05-16,Senate,"Senate: Motion to reject CC report, did not prevail",33,34,0,0,67
1745029,1326199,2023-05-16,Senate,"Senate: Senate adopted CC report and repassed bill",34,32,0,0,66
1745029,1326200,2023-05-16,Senate,"Senate: Third reading",34,32,0,0,66
1745029,1326201,2023-05-16,House,"House: S.F. NO. 3035",61,68,0,0,129
1745029,1326202,2023-05-16,House,"House: S.F. NO. 3035",68,61,0,0,129
1745029,1326203,2023-05-16,House,"House: S.F. NO. 3035",130,0,0,0,130
1745029,1326204,2023-05-16,House,"House: S.F. NO. 3035",70,61,0,0,131
1745441,1421317,2024-04-04,House,"House: Passage",110,21,0,0,131
1745441,1427651,2024-04-15,Senate,"Senate: Third reading Passed",62,5,0,0,67
1745441,1431275,2024-04-18,House,"House: H.F. NO. 3071",107,24,0,0,131
1746300,1307791,2023-04-21,House,"House: Passage",120,0,0,0,120
1746300,1324074,2023-05-11,Senate,"Senate: Third reading Passed",66,1,0,0,67
1746300,1324351,2023-05-11,Senate,"Senate: Third reading Passed",66,1,0,0,67
1746300,1324489,2023-05-12,House,"House: H.F. NO. 3100",128,0,0,0,128
1749618,1431372,2024-04-18,Senate,"Senate: Third reading Passed",45,22,0,0,67
1749618,1436680,2024-04-29,House,"House: Passage",78,52,0,0,130
1752969,1434590,2024-04-24,House,"House: Passage, as amended",129,0,0,0,129
1752969,1439357,2024-05-03,Senate,"Senate: Third reading Passed",62,0,0,0,62
1752969,1441680,2024-05-07,House,"House: H.F. NO. 3204",127,0,0,0,127
1756089,1308150,2023-04-18,Senate,"Senate: Adopted",59,0,0,0,59
1758094,1445376,2024-05-19,House,"House: H.F. NO. 3276",60,69,0,0,129
1758094,1445377,2024-05-19,House,"House: Davis - Amendment - H3276A10",129,0,0,0,129
1758094,1445378,2024-05-19,House,"House: H.F. NO. 3276",66,62,0,0,128
1759226,1324073,2023-05-11,House,"House: Passage",85,43,0,0,128
1759226,1327258,2023-05-17,Senate,"Senate: Third reading Passed",42,18,0,0,60
1759661,1329135,2023-05-18,Senate,"Senate: Third reading Passed",57,5,0,0,62
1759661,1330269,2023-05-22,Senate,"Senate: Third reading",49,13,0,0,62
1759661,1331674,2023-05-22,House,"House: Passage, as amended",132,0,0,0,132
1759661,1381374,2023-05-22,Senate,"Senate: Third reading",49,13,0,0,62
1761869,1434852,2024-04-24,House,"House: Passage, as amended",129,0,0,0,129
1761886,1407680,2024-03-11,House,"House: Passage",129,0,0,0,129
1767138,1340681,2023-05-21,Senate,"Senate: Adopted",64,0,0,0,64
1767233,1330902,2023-05-22,Senate,"Senate: Third reading Passed",67,0,0,0,67
1767233,1330903,2023-05-22,House,"House: H.F. NO. 3342",132,0,0,0,132
1843440,1421327,2024-04-04,House,"House: Fogelman - Amendment - H3436A32",61,70,0,0,131
1843440,1421328,2024-04-04,House,"House: Niska - Amendment - H3436A35",61,69,0,0,130
1843440,1421329,2024-04-04,House,"House: Petersburg - Amendment - H3436A37",61,69,0,0,130
1843440,1421330,2024-04-04,House,"House: Petersburg - Amendment - H3436A33",61,69,0,0,130
1843440,1421331,2024-04-04,House,"House: 67 - Amendment as amended - Nays",63,67,0,0,130
1843440,1421332,2024-04-04,House,"House: Neu Brindley - Amendment H3436A42 - H3436A42",61,69,0,0,130
1843440,1421333,2024-04-04,House,"House: Robbins - Amendment - H3436A44",61,70,0,0,131
1843440,1421334,2024-04-04,House,"House: Koznick - Amendment - H3436A31",58,71,0,0,129
1843440,1421335,2024-04-04,House,"House: ""Shall the decision of Speaker pro tempore Her stand as the judgment of the House?",70,61,0,0,131
1843440,1421336,2024-04-04,House,"House: Passage, as amended",97,34,0,0,131
1843440,1426260,2024-04-11,Senate,"Senate: Third reading Passed",65,0,0,0,65
1843440,1441550,2024-05-07,House,"House: H.F. NO. 3436",97,30,0,0,127
1843440,1442048,2024-05-09,Senate,"Senate: Third reading",67,0,0,0,67
1843472,1407683,2024-03-11,House,"House: Passage",89,40,0,0,129
1843478,1403707,2024-03-04,House,"House: Passage",115,17,0,0,132
1843478,1423291,2024-04-08,Senate,"Senate: Third reading Passed",65,2,0,0,67
1843497,1439931,2024-05-06,House,"House: Johnson - Amendment - H3431A48",60,69,0,0,129
1843497,1439932,2024-05-06,House,"House: Nash - Amendment - H3431A51",60,70,0,0,130
1843497,1439933,2024-05-06,House,"House: Nash - Amendment - H3431A52",60,70,0,0,130
1843497,1439934,2024-05-06,House,"House: Nash - Amendment - H3431A41",60,69,0,0,129
1843497,1439935,2024-05-06,House,"House: 69 - Amendment to Nash Amendment - Nays",60,69,0,0,129
1843497,1439936,2024-05-06,House,"House: Nash - Amendment - H3431A36",59,70,0,0,129
1843497,1439937,2024-05-06,House,"House: H.F. NO. 3431",69,60,0,0,129
1843497,1439938,2024-05-06,House,"House: H.F. NO. 3431",69,60,0,0,129
1843497,1439939,2024-05-06,House,"House: Demuth - Amendment - H3431A55",60,68,0,0,128
1843497,1439940,2024-05-07,House,"House: H.F. NO. 3431",69,60,0,0,129
1843536,1406037,2024-03-07,House,"House: Passage",90,39,0,0,129
1843544,1387245,2024-02-12,Senate,"Senate: Adopted",41,23,0,0,64
1843601,1387244,2024-02-12,Senate,"Senate: Adopted",56,9,0,0,65
1843640,1427943,2024-04-15,House,"House: Passage",76,55,0,0,131
1843689,1386830,2024-02-12,House,"House: H.F. NO. 3489",62,69,0,0,131
1843689,1386831,2024-02-14,House,"House: H.F. NO. 3489",60,70,0,0,130
1843689,1402682,2024-03-04,House,"House: Passage",124,8,0,0,132
1843689,1407660,2024-03-11,Senate,"Senate: Third reading Passed",57,9,0,0,66
1843689,1407661,2024-03-11,House,"House: H.F. NO. 3489",64,65,0,0,129
1843689,1409807,2024-03-14,Senate,"Senate: Third reading",61,3,0,0,64
1843689,1409808,2024-03-13,House,"House: H.F. NO. 3489",119,9,0,0,128
1843702,1436496,2024-04-29,House,"House: Scott - Amendment - H3567A6",61,68,0,0,129
1843702,1436497,2024-04-29,House,"House: Niska - Amendment - H3567A5",61,68,0,0,129
1843702,1436498,2024-04-29,House,"House: Niska - Amendment - H3567A7",62,67,0,0,129
1843702,1436499,2024-04-29,House,"House: Passage",68,61,0,0,129
1843706,1421345,2024-04-04,House,"House: Passage",130,0,0,0,130
1843706,1431442,2024-04-18,Senate,"Senate: Third reading Passed",65,2,0,0,67
1843706,1437972,2024-05-01,House,"House: H.F. NO. 3454",131,0,0,0,131
1843721,1406328,2024-03-07,House,"House: Passage",94,35,0,0,129
1843721,1421404,2024-04-04,Senate,"Senate: Third reading Passed",41,25,0,0,66
1843724,1426167,2024-04-11,House,"House: Passage, as amended",70,61,0,0,131
1843724,1437837,2024-05-01,Senate,"Senate: Third reading Passed",41,24,0,0,65
1843724,1442738,2024-05-13,House,"House: H.F. NO. 3438",63,70,0,0,133
1843724,1442739,2024-05-13,House,"House: H.F. NO. 3438",73,60,0,0,133
1843724,1442740,2024-05-13,House,"House: H.F. NO. 3438",76,57,0,0,133
1843724,1443623,2024-05-15,Senate,"Senate: Third reading",36,31,0,0,67
1843744,1400468,2024-02-29,Senate,"Senate: Third reading Passed",65,0,0,0,65
1843744,1406351,2024-03-07,House,"House: Passage",129,0,0,0,129
1843793,1426278,2024-04-11,House,"House: Passage",128,2,0,0,130
1843793,1436722,2024-04-29,Senate,"Senate: Third reading Passed",64,0,0,0,64
1843807,1422285,2024-04-08,Senate,"Senate: Third reading Passed",37,29,0,0,66
1843807,1431229,2024-04-18,House,"House: Nash motion Re-Referral",62,69,0,0,131
1843807,1431230,2024-04-18,House,"House: Shall the decision of Speaker pro tempore Her stand as the judgment of the House?",69,62,0,0,131
1843807,1431231,2024-04-18,House,"House: Dotseth - Amendment - H3591A14",62,69,0,0,131
1843807,1431232,2024-04-18,House,"House: Dotseth - Amendment - H3591A15",61,69,0,0,130
1843807,1431233,2024-04-18,House,"House: Nash - Amendment - H3591A16",61,69,0,0,130
1843807,1431234,2024-04-18,House,"House: Myers - Amendment - H3591A23",61,69,0,0,130
1843807,1431235,2024-04-18,House,"House: Petersburg - Amendment - H3591A20",61,68,0,0,129
1843807,1431236,2024-04-18,House,"House: Koznick - Amendment - H3591A22",61,68,0,0,129
1843807,1431237,2024-04-18,House,"House: 61 - Amendment to Franson Amendment - Nays",68,61,0,0,129
1843807,1431238,2024-04-18,House,"House: Passage, as amended",68,61,0,0,129
1843807,1444823,2024-05-17,Senate,"Senate: Motion to reject CC report, did not prevail",31,35,0,0,66
1843807,1444824,2024-05-17,Senate,"Senate: Third reading",35,31,0,0,66
1843807,1444843,2024-05-18,House,"House: S.F. NO. 3492",69,60,0,0,129
1843829,1407598,2024-03-11,House,"House: Passage",129,0,0,0,129
1843881,1438372,2024-05-01,House,"House: Passage",103,26,0,0,129
1843881,1442041,2024-05-09,Senate,"Senate: Third reading Passed",37,30,0,0,67
1845522,1405981,2024-03-07,House,"House: Passage",85,44,0,0,129
1845522,1409791,2024-03-14,Senate,"Senate: Third reading Passed",40,25,0,0,65
1845579,1415501,2024-03-25,House,"House: Passage",123,0,0,0,123
1845579,1426315,2024-04-11,Senate,"Senate: Third reading Passed",65,0,0,0,65
1845630,1422274,2024-04-08,House,"House: Passage, as amended",98,32,0,0,130
1845630,1427567,2024-04-15,Senate,"Senate: Third reading Passed",57,9,0,0,66
1845651,1422485,2024-04-08,House,"House: Neu Brindley - Amendment - H3614A10",63,68,0,0,131
1845651,1422486,2024-04-08,House,"House: Passage, as amended",130,0,0,0,130
1845797,1438976,2024-05-03,House,"House: H.F. NO. 3757",127,0,0,0,127
1845833,1415213,2024-03-18,House,"House: Passage",106,23,0,0,129
1845833,1422654,2024-04-08,Senate,"Senate: Third reading Passed",55,12,0,0,67
1845833,1427395,2024-04-09,House,"House: H.F. NO. 3613",105,24,0,0,129
1846567,1390751,2024-02-19,House,"House: H.F. NO. 3769",61,69,0,0,130
1846567,1415690,2024-03-18,House,"House: Passage",130,0,0,0,130
1846567,1419857,2024-04-02,Senate,"Senate: Third reading Passed",64,0,0,0,64
1847059,1419872,2024-04-02,Senate,"Senate: Third reading Passed",35,31,0,0,66
1847059,1426320,2024-04-11,House,"House: Bennett - Amendment - S3567A24",62,69,0,0,131
1847059,1426321,2024-04-11,House,"House: Knudsen - Amendment - S3567A12",62,69,0,0,131
1847059,1426322,2024-04-11,House,"House: Knudsen - Amendment - S3567A19",61,70,0,0,131
1847059,1426323,2024-04-11,House,"House: Mueller - Amendment - S3567A15",61,69,0,0,130
1847059,1426324,2024-04-11,House,"House: Mueller - Amendment - S3567A20",61,69,0,0,130
1847059,1426325,2024-04-11,House,"House: Mueller - Amendment - S3567A23",60,70,0,0,130
1847059,1426326,2024-04-11,House,"House: Kresha - Amendment - S3567A10",61,69,0,0,130
1847059,1426327,2024-04-11,House,"House: Bakeberg - Amendment - S3567A3",62,68,0,0,130
1847059,1426328,2024-04-11,House,"House: Passage, as amended",69,61,0,0,130
1847059,1442742,2024-05-13,Senate,"Senate: Third reading",35,31,0,0,66
1847059,1443655,2024-05-15,House,"House: S.F. NO. 3567",59,69,0,0,128
1847059,1443656,2024-05-15,House,"House: S.F. NO. 3567",68,59,0,0,127
1847104,1436622,2024-04-29,Senate,"Senate: Third reading Passed",64,0,0,0,64
1847200,1426442,2024-04-11,Senate,"Senate: Third reading Passed",51,14,0,0,65
1847628,1407667,2024-03-11,House,"House: Passage",120,8,0,0,128
1847628,1436347,2024-04-29,Senate,"Senate: Third reading Passed",59,4,0,0,63
1847665,1434731,2024-04-24,House,"House: Passage",128,1,0,0,129
1847665,1437499,2024-04-30,Senate,"Senate: Third reading Passed",53,12,0,0,65
1847750,1441768,2024-05-07,House,"House: H.F. NO. 3872",71,56,0,0,127
1849048,1419953,2024-04-02,Senate,"Senate: Third reading Passed",34,30,0,0,64
1849048,1426116,2024-04-11,House,"House: Mekeland - Amendment - S3852A3",61,69,0,0,130
1849048,1426117,2024-04-11,House,"House: Schultz - Amendment - S3852A5",62,68,0,0,130
1849048,1426118,2024-04-11,House,"House: 61 - Amendment to Zeleznikar Amendment - Nays",69,61,0,0,130
1849048,1426119,2024-04-11,House,"House: 62 - Amendment to Neu Brindley Amendment - Nays",69,62,0,0,131
1849048,1426120,2024-04-11,House,"House: Shall the decision of Speaker pro tempore Moller stand as the judgment of the House?",67,64,0,0,131
1849048,1426121,2024-04-11,House,"House: Passage, as amended",70,61,0,0,131
1849048,1442741,2024-05-13,Senate,"Senate: Third reading",34,33,0,0,67
1849048,1443660,2024-05-15,House,"House: S.F. NO. 3852",59,68,0,0,127
1849048,1443661,2024-05-15,House,"House: S.F. NO. 3852",68,59,0,0,127
1849186,1438112,2024-05-01,Senate,"Senate: Third reading Passed",65,0,0,0,65
1849186,1438113,2024-05-01,House,"House: S.F. NO. 3881",129,0,0,0,129
1849927,1415156,2024-03-25,House,"House: Passage",123,0,0,0,123
1849927,1431370,2024-04-18,Senate,"Senate: Third reading Passed",67,0,0,0,67
1849927,1431558,2024-04-18,Senate,"Senate: Third reading Passed",67,0,0,0,67
1849944,1438543,2024-05-01,House,"House: Jacob - Amendment - H3911A18",62,68,0,0,130
1849944,1438544,2024-05-01,House,"House: Passage, as amended",68,63,0,0,131
1849944,1440802,2024-05-07,Senate,"Senate: Third reading Passed",40,27,0,0,67
1849944,1444839,2024-05-17,Senate,"Senate: Third reading",37,30,0,0,67
1849944,1444840,2024-05-17,House,"House: H.F. NO. 3911",56,68,0,0,124
1849944,1444841,2024-05-17,House,"House: H.F. NO. 3911",70,56,0,0,126
1850080,1405983,2024-03-07,House,"House: Passage",83,46,0,0,129
1850080,1409805,2024-03-14,Senate,"Senate: Third reading Passed",37,28,0,0,65
1850179,1415174,2024-03-25,House,"House: H.F. NO. 3926",67,56,0,0,123
1850204,1421348,2024-04-04,House,"House: Robbins - Amendment - H4024A7",62,70,0,0,132
1850204,1421349,2024-04-04,House,"House: Schultz - Amendment - H4024A6",63,69,0,0,132
1850204,1421350,2024-04-04,House,"House: Passage, as amended",100,32,0,0,132
1850204,1427566,2024-04-15,Senate,"Senate: Third reading Passed",41,26,0,0,67
1850204,1444834,2024-05-17,House,"House: H.F. NO. 4024",72,57,0,0,129
1850204,1445006,2024-05-19,Senate,"Senate: Senate adopted CC report and repassed bill",40,26,0,0,66
1850204,1445007,2024-05-19,Senate,"Senate: Third reading",40,26,0,0,66
1851979,1421347,2024-04-04,Senate,"Senate: Third reading Passed",33,34,0,0,67
1851979,1427854,2024-04-15,House,"House: Neu Brindley - Amendment - S4097A1",60,70,0,0,130
1851979,1427855,2024-04-15,House,"House: Neu Brindley - Amendment - S4097A2",61,70,0,0,131
1851979,1427856,2024-04-15,House,"House: 69 - Amendment to Neu Brindley Amendment - Nays",62,69,0,0,131
1851979,1427857,2024-04-15,House,"House: Neu Brindley - Amendment - S4097A14",62,68,0,0,130
1851979,1427858,2024-04-15,House,"House: Passage, as amended",70,61,0,0,131
1851979,1443695,2024-05-15,Senate,"Senate: Motion to reject CC report, did not prevail",32,34,0,0,66
1851979,1443696,2024-05-15,Senate,"Senate: Senate adopted CC report and repassed bill",34,32,0,0,66
1851979,1443697,2024-05-15,Senate,"Senate: Third reading",34,32,0,0,66
1851979,1444831,2024-05-17,House,"House: S.F. NO. 4097",70,58,0,0,128
1851979,1444832,2024-05-17,House,"House: S.F. NO. 4097",70,58,0,0,128
1852162,1423134,2024-04-08,Senate,"Senate: Third reading Passed",38,29,0,0,67
1852684,1415427,2024-03-25,House,"House: Passage",123,0,0,0,123
1852684,1440292,2024-05-07,Senate,"Senate: Third reading Passed",66,0,0,0,66
1852684,1441608,2024-05-07,House,"House: H.F. NO. 4109",127,0,0,0,127
1852684,1441609,2024-05-07,House,"House: H.F. NO. 4109",127,0,0,0,127
1852784,1437253,2024-04-30,House,"House: Passage, as amended",118,13,0,0,131
1852784,1439345,2024-05-03,Senate,"Senate: Third reading Passed",39,24,0,0,63
1852784,1442280,2024-05-09,House,"House: H.F. NO. 4124",115,13,0,0,128
1852784,1442744,2024-05-13,Senate,"Senate: Third reading",43,24,0,0,67
1853023,1421313,2024-04-04,House,"House: Hudson - Amendment - H4176A5",60,70,0,0,130
1853023,1421314,2024-04-04,House,"House: Hudson - Amendment - H4176A6",62,69,0,0,131
1853023,1421315,2024-04-04,House,"House: Passage",69,61,0,0,130
1853949,1421424,2024-04-04,Senate,"Senate: Third reading Passed",58,9,0,0,67
1853949,1445401,2024-05-19,House,"House: Passage, as amended",70,0,0,0,70
1854456,1426125,2024-04-11,House,"House: Passage",74,56,0,0,130
1854456,1437788,2024-05-01,Senate,"Senate: Third reading Passed",36,29,0,0,65
1854493,1438836,2024-05-02,House,"House: Myers - Amendment - H4300DE4",63,66,0,0,129
1854493,1438837,2024-05-02,House,"House: Franson - Amendment - H4300A10",64,67,0,0,131
1854493,1438838,2024-05-02,House,"House: Franson - Amendment - H4300A11",64,68,0,0,132
1854493,1438839,2024-05-02,House,"House: Novotny - Amendment - H4300A8",64,68,0,0,132
1854493,1438840,2024-05-02,House,"House: H.F. NO. 4300",68,64,0,0,132
1854528,1436547,2024-04-29,House,"House: Shall the decision of the Speaker stand as the judgment of the House?",68,61,0,0,129
1854528,1436548,2024-04-29,House,"House: Shall the decision of the Speaker stand as the judgment of the House?",66,63,0,0,129
1854528,1436549,2024-04-29,House,"House: Passage, as amended",92,37,0,0,129
1854528,1440565,2024-05-07,Senate,"Senate: Third reading Passed",66,0,0,0,66
1854528,1445437,2024-05-19,House,"House: H.F. NO. 4247",130,0,0,0,130
1856347,1421408,2024-04-04,Senate,"Senate: Third reading Passed",58,9,0,0,67
1856347,1427721,2024-04-15,House,"House: Neu Brindley - Amendment - S4399A3",61,70,0,0,131
1856347,1427722,2024-04-15,House,"House: 61 - Amendment to Franson Amendment - Nays",69,61,0,0,130
1856347,1427723,2024-04-15,House,"House: Passage, as amended",69,62,0,0,131
1856347,1442745,2024-05-13,Senate,"Senate: Third reading",60,7,0,0,67
1856347,1443670,2024-05-15,House,"House: S.F. NO. 4399",126,0,0,0,126
1856424,1439968,2024-05-03,House,"House: 28 - Amendment to Torkelson Amendment - Nays",96,28,0,0,124
1856424,1439969,2024-05-03,House,"House: Altendorf - Amendment - H4411A14",50,73,0,0,123
1856424,1439970,2024-05-03,House,"House: H.F. NO. 4411",68,59,0,0,127
1856424,1439971,2024-05-03,House,"House: H.F. NO. 4411",83,44,0,0,127
1856476,1435502,2024-04-25,Senate,"Senate: Motion did not prevail to add author",29,34,0,0,63
1856498,1421505,2024-04-04,House,"House: Passage, as amended",131,0,0,0,131
1857168,1409781,2024-03-14,House,"House: Passage",126,0,0,0,126
1857168,1422698,2024-04-08,Senate,"Senate: Third reading Passed",66,1,0,0,67
1857292,1415695,2024-03-25,House,"House: Passage, as amended",123,0,0,0,123
1858774,1426196,2024-04-11,Senate,"Senate: Third reading Passed",44,19,0,0,63
1858774,1434560,2024-04-24,House,"House: Passage, as amended",82,44,0,0,126
1858774,1442737,2024-05-13,Senate,"Senate: Third reading",49,18,0,0,67
1858774,1443654,2024-05-15,House,"House: S.F. NO. 4579",125,0,0,0,125
1859134,1409873,2024-03-14,House,"House: Passage",125,0,0,0,125
1859134,1414107,2024-03-21,Senate,"Senate: Third reading Passed",51,16,0,0,67
1860410,1439364,2024-05-03,Senate,"Senate: Third reading Passed",34,31,0,0,65
1860410,1442281,2024-05-09,House,"House: Schomacker - Amendment - S4699A23",59,67,0,0,126
1860410,1442282,2024-05-09,House,"House: Perryman - Amendment - S4699A15",60,67,0,0,127
1860410,1442283,2024-05-09,House,"House: Niska - Amendment - S4699A8",58,68,0,0,126
1860410,1442284,2024-05-09,House,"House: Nadeau - Amendment - S4699A24",58,68,0,0,126
1860410,1442285,2024-05-09,House,"House: Novotny - Amendment - S4699A2",61,66,0,0,127
1860410,1442286,2024-05-09,House,"House: Backer - Amendment - S4699A7",60,67,0,0,127
1860410,1442287,2024-05-09,House,"House: Passage, as amended",68,59,0,0,127
1860644,1431292,2024-04-18,Senate,"Senate: Third reading Passed",35,32,0,0,67
1860678,1414321,2024-03-21,Senate,"Senate: Motion did not prevail to withdraw and be placed on General Orders",33,34,0,0,67
1860678,1463104,2024-03-21,Senate,"Senate: Motion did not prevail to withdraw and be placed on General Orders",33,34,0,0,67
1861147,1431322,2024-04-18,House,"House: 54 - Amendment to West Amendment - Nays",68,54,0,0,122
1861147,1431323,2024-04-18,House,"House: Scott - Amendment - H4757A25",63,67,0,0,130
1861147,1431324,2024-04-18,House,"House: Passage, as amended",69,62,0,0,131
1861147,1439348,2024-05-03,Senate,"Senate: Third reading Passed",31,35,0,0,66
1861147,1444855,2024-05-18,Senate,"Senate: Laid on table",55,1,0,0,56
1861147,1444856,2024-05-18,Senate,"Senate: Point of order not well taken",31,34,0,0,65
1861147,1444857,2024-05-18,Senate,"Senate: Motion to reject CC report, did not prevail",34,31,0,0,65
1861147,1444858,2024-05-18,House,"House: H.F. NO. 4757",60,69,0,0,129
1861147,1444859,2024-05-18,House,"House: H.F. NO. 4757",68,60,0,0,128
1861147,1444902,2024-05-19,Senate,"Senate: Third reading Passed",34,32,0,0,66
1861147,1449328,2024-05-18,Senate,"Senate: Senate adopted CC report",29,36,0,0,65
1861165,1441601,2024-05-07,House,"House: Huot - Amendment - H4738A12-1",126,0,0,0,126
1861165,1441602,2024-05-07,House,"House: Backer - Amendment - H4738A11",59,68,0,0,127
1861165,1441603,2024-05-07,House,"House: Is it the judgment of the House that the Neu Brindley point of order is well taken?",125,0,0,0,125
1861165,1441604,2024-05-07,House,"House: Backer - Amendment - H4738A13",60,68,0,0,128
1861165,1441605,2024-05-07,House,"House: Backer - Amendment - H4738A19",59,69,0,0,128
1861165,1441606,2024-05-07,House,"House: Passage, as amended",70,58,0,0,128
1861165,1444851,2024-05-18,Senate,"Senate: Rule 45: amendment stricken",66,0,0,0,66
1861165,1444852,2024-05-18,Senate,"Senate: Third reading Passed",66,0,0,0,66
1861165,1445425,2024-05-19,House,"House: H.F. NO. 4738",119,11,0,0,130
1861303,1420333,2024-04-02,House,"House: H.F. NO. 4613",65,55,0,0,120
1861311,1434637,2024-04-24,House,"House: Passage",129,0,0,0,129
1861311,1437434,2024-04-30,Senate,"Senate: Third reading Passed",60,2,0,0,62
1861371,1445387,2024-05-19,House,"House: Shall the decision of the Speaker stand as the judgment of the House?",70,60,0,0,130
1861371,1445388,2024-05-19,House,"House: Shall the decision of the Speaker stand as the judgment of the House?",70,59,0,0,129
1861371,1445389,2024-05-19,House,"House: Engen - Amendment - H4746A25",61,70,0,0,131
1861371,1445390,2024-05-19,House,"House: Neu Brindley - Amendment - H4746A27",131,0,0,0,131
1861371,1445391,2024-05-19,House,"House: Kresha - Amendment - H4746A28",131,0,0,0,131
1861371,1445392,2024-05-19,House,"House: Niska - Amendment - RA24-012",131,0,0,0,131
1861371,1445393,2024-05-19,House,"House: Kresha - Amendment - RA24-013",127,0,0,0,127
1861371,1445394,2024-05-19,House,"House: Scott - Amendment - H4746A42",130,0,0,0,130
1861371,1445395,2024-05-19,House,"House: Neu Brindley - Amendment - RA24-018",72,57,0,0,129
1861371,1445396,2024-05-19,House,"House: Franson - Amendment - H4746A44",124,0,0,0,124
1861371,1445397,2024-05-19,House,"House: Neu Brindley - Amendment - RA24-019",60,69,0,0,129
1861371,1445398,2024-05-19,House,"House: Franson - Amendment - H4746A47",130,0,0,0,130
1861371,1445399,2024-05-19,House,"House: Neu Brindley - Amendment - RA24-020",126,0,0,0,126
1861371,1445400,2024-05-19,House,"House: H.F. NO. 4746",71,59,0,0,130
1861380,1426577,2024-04-11,House,"House: Passage",128,0,0,0,128
1862611,1422373,2024-04-08,House,"House: 63 - Amendment to Amendment - Nays",68,63,0,0,131
1862611,1422374,2024-04-08,House,"House: 63 - Amendment to Amendment - Nays",68,63,0,0,131
1862611,1422375,2024-04-08,House,"House: Davis - Amendment - H4772A26",63,68,0,0,131
1862611,1422376,2024-04-08,House,"House: Altendorf - Amendment - H4772A37",63,68,0,0,131
1862611,1422377,2024-04-08,House,"House: Quam - Amendment - H4772A29",63,68,0,0,131
1862611,1422378,2024-04-08,House,"House: Torkelson - Amendment - H4772A38",64,67,0,0,131
1862611,1422379,2024-04-08,House,"House: Niska - Amendment - H4772A25",63,68,0,0,131
1862611,1422380,2024-04-08,House,"House: Niska - Amendment - H4772A33",63,68,0,0,131
1862611,1422381,2024-04-08,House,"House: Passage, as amended",69,62,0,0,131
1862611,1431261,2024-04-18,Senate,"Senate: Third reading Passed",35,32,0,0,67
1862611,1442748,2024-05-13,House,"House: H.F. NO. 4772",63,69,0,0,132
1862611,1442749,2024-05-13,House,"House: H.F. NO. 4772",70,63,0,0,133
1862611,1443731,2024-05-15,Senate,"Senate: Motion to reject CC report, did not prevail",33,34,0,0,67
1862611,1443732,2024-05-15,Senate,"Senate: Third reading",34,33,0,0,67
1862728,1409855,2024-03-14,House,"House: H.F. NO. 4837",60,67,0,0,127
1862767,1442337,2024-05-09,House,"House: H.F. NO. 4803",61,66,0,0,127
1863194,1440019,2024-05-06,Senate,"Senate: Third reading Passed",36,30,0,0,66
1863194,1442311,2024-05-09,House,"House: Franson - Amendment - S4942A41",59,68,0,0,127
1863194,1442312,2024-05-09,House,"House: Anderson, P. H. - Amendment - S4942A42",60,67,0,0,127
1863194,1442313,2024-05-09,House,"House: Swedzinski - Amendment - S4942A49",60,67,0,0,127
1863194,1442314,2024-05-09,House,"House: Swedzinski - Amendment - S4942A3",58,68,0,0,126
1863194,1442315,2024-05-09,House,"House: Rarick - Amendment - S4942A4",58,69,0,0,127
1863194,1442316,2024-05-09,House,"House: Igo - Amendment - S4942A8",61,65,0,0,126
1863194,1442317,2024-05-09,House,"House: Igo - Amendment - S4942A5",61,66,0,0,127
1863194,1442318,2024-05-09,House,"House: Lislegard and Swedzinski - Amendment - S4942A6",83,38,0,0,121
1863194,1442319,2024-05-09,House,"House: O'Driscoll - Amendment - S4942A24",125,0,0,0,125
1863194,1442320,2024-05-09,House,"House: Schomacker - Amendment - S4942A16",125,0,0,0,125
1863194,1442321,2024-05-09,House,"House: O'Driscoll - Amendment - S4942A17",126,0,0,0,126
1863194,1442322,2024-05-09,House,"House: O'Driscoll - Amendment - S4942A21",124,2,0,0,126
1863194,1442323,2024-05-09,House,"House: Neu Brindley - Amendment - S4942A31",125,0,0,0,125
1863194,1442324,2024-05-09,House,"House: Neu Brindley - Amendment - S4942A34",124,0,0,0,124
1863194,1442325,2024-05-09,House,"House: Schomacker - Amendment - S4942A36",60,65,0,0,125
1863194,1442326,2024-05-09,House,"House: Neu Brindley - Amendment - S4942A38",126,0,0,0,126
1863194,1442327,2024-05-09,House,"House: Neu Brindley - Amendment - S4942A28",59,66,0,0,125
1863194,1442328,2024-05-09,House,"House: Nadeau - Amendment - S4942A15",60,66,0,0,126
1863194,1442329,2024-05-09,House,"House: Neu Brindley - Amendment - S4942A20",60,64,0,0,124
1863194,1442330,2024-05-09,House,"House: Neu Brindley - Amendment - S4942A13",59,66,0,0,125
1863194,1442331,2024-05-09,House,"House: Schomacker - Amendment - S4942A39",59,66,0,0,125
1863194,1442332,2024-05-09,House,"House: Schomacker - Amendment - S4942A32",61,64,0,0,125
1863194,1442333,2024-05-09,House,"House: Nadeau - Amendment - S4942A43",59,66,0,0,125
1863194,1442334,2024-05-09,House,"House: Neu Brindley - Amendment - S4942A11",61,65,0,0,126
1863194,1442335,2024-05-09,House,"House: Passage, as amended",68,59,0,0,127
1863194,1444911,2024-05-19,Senate,"Senate: Motion to reject CC report, did not prevail",33,34,0,0,67
1863194,1444912,2024-05-19,Senate,"Senate: Senate adopted CC report and repassed bill",33,34,0,0,67
1863194,1444913,2024-05-19,Senate,"Senate: Third reading",36,31,0,0,67
1863194,1445412,2024-05-19,House,"House: S.F. NO. 4942",60,70,0,0,130
1863194,1445413,2024-05-19,House,"House: S.F. NO. 4942",70,11,0,0,81
1863194,1460192,2024-05-19,Senate,"Senate: Motion to reject CC report, did not prevail",33,34,0,0,67
1864817,1421312,2024-04-04,House,"House: H.F. NO. 5006",62,69,0,0,131
1864996,1442437,2024-05-09,House,"House: Passage",98,25,0,0,123
1864996,1443807,2024-05-15,Senate,"Senate: Laid on table",46,20,0,0,66
1864996,1443808,2024-05-15,Senate,"Senate: Motion did not prevail to re-refer to State and Local Government and Veterans",31,36,0,0,67
1865017,1426454,2024-04-11,House,"House: Passage",76,54,0,0,130
1865655,1437936,2024-05-01,House,"House: Schultz - Amendment - H5040-8A",58,69,0,0,127
1865655,1437937,2024-05-01,House,"House: Passage, as amended",130,0,0,0,130
1865655,1440033,2024-05-06,Senate,"Senate: Third reading Passed",59,8,0,0,67
1865655,1441738,2024-05-07,House,"House: H.F. NO. 5040",125,0,0,0,125
1869266,1438070,2024-05-01,House,"House: Fogelman - Amendment - H5242A58",62,69,0,0,131
1869266,1438071,2024-05-01,House,"House: Petersburg - Amendment - H5242A47",62,69,0,0,131
1869266,1438072,2024-05-01,House,"House: West - Amendment - H5242A89",61,70,0,0,131
1869266,1438073,2024-05-01,House,"House: West - Amendment - H5242A35",63,68,0,0,131
1869266,1438074,2024-05-01,House,"House: Petersburg - Amendment - H5242A44",63,68,0,0,131
1869266,1438075,2024-05-01,House,"House: Petersburg - Amendment - H5242A76",63,68,0,0,131
1869266,1438076,2024-05-01,House,"House: 62 - Amendment to Niska Amendment - Nays",69,62,0,0,131
1869266,1438077,2024-05-01,House,"House: 62 - Amendment to Murphy Amendment - Nays",69,62,0,0,131
1869266,1438078,2024-05-01,House,"House: Murphy - Amendment, as amended - H5242A40",130,0,0,0,130
1869266,1438079,2024-05-01,House,"House: 60 - Amendment to Hudella Amendment - Nays",69,60,0,0,129
1869266,1438080,2024-05-01,House,"House: Hudella - Amendment, as amended - H5242A41",128,1,0,0,129
1869266,1438081,2024-05-01,House,"House: Robbins - Amendment - H5242A43",64,67,0,0,131
1869266,1438082,2024-05-01,House,"House: West - Amendment - H5242A38",64,67,0,0,131
1869266,1438083,2024-05-01,House,"House: Olson, B. - Amendment - H5242A39",65,66,0,0,131
1869266,1438084,2024-05-01,House,"House: Fogelman - Amendment - H5242A51",64,66,0,0,130
1869266,1438085,2024-05-01,House,"House: H.F. NO. 5242",68,61,0,0,129
1869266,1438086,2024-05-01,House,"House: 66 - Amendment to Nelson, M. Amendment - Nays",62,66,0,0,128
1869266,1438087,2024-05-01,House,"House: Mekeland - Amendment - H5242A55",61,68,0,0,129
1869266,1438088,2024-05-01,House,"House: Schultz - Amendment - H5242A53",61,69,0,0,130
1869266,1438089,2024-05-01,House,"House: Nash - Amendment - H5242A69",60,69,0,0,129
1869266,1438090,2024-05-01,House,"House: H.F. NO. 5242",69,60,0,0,129
1869266,1440177,2024-05-06,Senate,"Senate: Third reading Passed",36,31,0,0,67
1869266,1444853,2024-05-18,House,"House: H.F. NO. 5242",72,59,0,0,131
1869266,1444927,2024-05-19,Senate,"Senate: Laid on table",34,2,0,0,36
1869266,1445435,2024-05-19,House,"House: H.F. NO. 5242",60,70,0,0,130
1869266,1445436,2024-05-19,House,"House: H.F. NO. 5242",70,59,0,0,129
1869277,1441636,2024-05-07,House,"House: Novotny - Amendment - H5216A10",60,68,0,0,128
1869277,1441637,2024-05-07,House,"House: H.F. NO. 5216",59,69,0,0,128
1869277,1441638,2024-05-07,House,"House: H.F. NO. 5216",71,57,0,0,128
1869277,1443613,2024-05-15,Senate,"Senate: Third reading Passed",50,17,0,0,67
1869277,1444861,2024-05-18,House,"House: H.F. NO. 5216",58,70,0,0,128
1869277,1444862,2024-05-18,House,"House: H.F. NO. 5216",107,19,0,0,126
1869277,1445003,2024-05-19,Senate,"Senate: Motion to reject CC report, did not prevail",34,33,0,0,67
1869277,1445004,2024-05-19,Senate,"Senate: Senate adopted CC report and repassed bill",34,33,0,0,67
1869277,1445005,2024-05-19,Senate,"Senate: Third reading",34,33,0,0,67
1869390,1442474,2024-05-09,House,"House: Passage, as amended",127,0,0,0,127
1869390,1444833,2024-05-17,Senate,"Senate: Third reading Passed",66,0,0,0,66
1869492,1440247,2024-05-07,Senate,"Senate: Third reading Passed",55,10,0,0,65
1869492,1440248,2024-05-03,House,"House: Jacob - Amendment - H5247A20",62,66,0,0,128
1869492,1440249,2024-05-03,House,"House: Davids - Amendment - H5247A35",62,66,0,0,128
1869492,1440250,2024-05-03,House,"House: Koznick - Amendment - H5247A21",61,66,0,0,127
1869492,1440251,2024-05-03,House,"House: Anderson, P. E. - Amendment - H5247A33",60,67,0,0,127
1869492,1440252,2024-05-03,House,"House: Anderson, P. E. - Amendment - H5247A29",60,67,0,0,127
1869492,1440253,2024-05-03,House,"House: Davids - Amendment - H5247A34",60,66,0,0,126
1869492,1440254,2024-05-03,House,"House: Igo - Amendment - H5247A18",60,67,0,0,127
1869492,1440255,2024-05-03,House,"House: 62 - Amendment to Novotny Amendment - Nays",66,62,0,0,128
1869492,1440256,2024-05-03,House,"House: Robbins - Amendment - H5247A36",126,0,0,0,126
1869492,1440257,2024-05-03,House,"House: Swedzinski - Amendment - H5247A13",63,64,0,0,127
1869492,1440258,2024-05-03,House,"House: Olson, B. - Amendment - H5247A22",128,0,0,0,128
1869492,1440259,2024-05-03,House,"House: H.F. NO. 5247",67,61,0,0,128
1869492,1440260,2024-05-03,House,"House: H.F. NO. 5247",67,60,0,0,127
1869492,1440261,2024-05-03,House,"House: H.F. NO. 5247",67,60,0,0,127
1869492,1440262,2024-05-03,House,"House: H.F. NO. 5247",67,59,0,0,126
1869492,1440263,2024-05-03,House,"House: H.F. NO. 5247",68,60,0,0,128
1869492,1444935,2024-05-19,Senate,"Senate: Senate adopted CC report and repassed bill",34,5,0,0,39
1869492,1444936,2024-05-19,Senate,"Senate: Third reading",34,14,0,0,48
1869492,1445438,2024-05-19,House,"House: H.F. NO. 5247",70,50,0,0,120
1869504,1437184,2024-04-30,House,"House: Edelson - Amendment - H5237A34",69,62,0,0,131
1869504,1437185,2024-04-30,House,"House: Mueller - Amendment - H5237A33",62,69,0,0,131
1869504,1437186,2024-04-30,House,"House: Anderson, P. E - Amendment - H5237A22",62,68,0,0,130
1869504,1437187,2024-04-30,House,"House: Bennett - Amendment - H5237A14",62,68,0,0,130
1869504,1437188,2024-04-30,House,"House: Bakeberg - Amendment - H5237A24",62,68,0,0,130
1869504,1437189,2024-04-30,House,"House: Bakeberg - Amendment - H5237A10",62,68,0,0,130
1869504,1437190,2024-04-30,House,"House: West - Amendment - H5237A12",62,68,0,0,130
1869504,1437191,2024-04-30,House,"House: Franson - Amendment - H5237A8",64,65,0,0,129
1869504,1437192,2024-04-30,House,"House: Knudsen - Amendment - H5237A9",62,68,0,0,130
1869504,1437193,2024-04-30,House,"House: Kresha - Amendment - H5237A25",62,68,0,0,130
1869504,1437194,2024-04-30,House,"House: Kresha - Amendment - H5237A21",62,68,0,0,130
1869504,1437195,2024-04-30,House,"House: Shall the decision of the Speaker stand as the judgment of the House?",68,61,0,0,129
1869504,1437196,2024-04-30,House,"House: Shall the decision of the Speaker stand as the judgment of the House?",68,61,0,0,129
1869504,1437197,2024-04-30,House,"House: Passage, as amended",68,61,0,0,129
1869504,1440131,2024-05-06,Senate,"Senate: Third reading Passed",34,30,0,0,64
1869504,1444825,2024-05-17,Senate,"Senate: Motion to reject CC report, did not prevail",34,33,0,0,67
1869504,1444826,2024-05-17,Senate,"Senate: Senate adopted CC report and repassed bill",34,33,0,0,67
1869504,1444827,2024-05-17,Senate,"Senate: Third reading",34,33,0,0,67
1869504,1444828,2024-05-17,House,"House: H.F. NO. 5237",58,69,0,0,127
1869504,1444829,2024-05-17,House,"House: H.F. NO. 5237",70,58,0,0,128
1870111,1437182,2024-04-30,Senate,"Senate: Third reading Passed",53,13,0,0,66
1870111,1439877,2024-05-06,House,"House: Baker - Amendment - S5335A9",125,0,0,0,125
1870111,1439878,2024-05-06,House,"House: Baker - Amendment - S5335A1",58,70,0,0,128
1870111,1439879,2024-05-06,House,"House: 70 - Amendment to Gillman Amendment - Nays",59,70,0,0,129
1870111,1439880,2024-05-06,House,"House: Gillman - Amendment - S5335A8",59,69,0,0,128
1870111,1439881,2024-05-06,House,"House: Quam - Amendment - S5335A12",59,70,0,0,129
1870111,1439882,2024-05-06,House,"House: Neu Brindley - Amendment - S5335A11",60,69,0,0,129
1870111,1439883,2024-05-06,House,"House: Zeleznikar - Amendment - S5335A13",60,68,0,0,128
1870111,1439884,2024-05-06,House,"House: Neu Brindley - Amendment - S5335A6",60,69,0,0,129
1870111,1439885,2024-05-06,House,"House: Neu Brindley - Amendment - S5335A3",60,69,0,0,129
1870111,1439886,2024-05-06,House,"House: Baker - Amendment - S5335A7-1",59,70,0,0,129
1870111,1439887,2024-05-06,House,"House: 60 - Amendment to Franson Amendment - Nays",69,60,0,0,129
1870111,1439888,2024-05-06,House,"House: Passage, as amended",70,59,0,0,129
1870111,1444897,2024-05-19,Senate,"Senate: Senate adopted CC report and repassed bill",35,32,0,0,67
1870111,1444898,2024-05-19,Senate,"Senate: Third reading",38,27,0,0,65
1870111,1445402,2024-05-19,House,"House: S.F. NO. 5335",69,0,0,0,69
1870139,1436490,2024-04-29,Senate,"Senate: Third reading Passed",34,33,0,0,67
1870139,1440451,2024-05-03,House,"House: Schultz - Amendment - S5289A3",58,67,0,0,125
1870139,1440452,2024-05-03,House,"House: Passage, as amended",74,52,0,0,126
1870139,1444863,2024-05-18,Senate,"Senate: Motion to reject CC report, did not prevail",30,35,0,0,65
1870139,1444864,2024-05-18,Senate,"Senate: Senate adopted CC report and repassed bill",35,24,0,0,59
1870139,1444865,2024-05-18,Senate,"Senate: Senate adopted CC report and repassed bill",35,24,0,0,59
1870139,1444866,2024-05-18,House,"House: S.F. NO. 5289",83,47,0,0,130
1870139,1449904,2024-05-18,Senate,"Senate: Third reading",36,25,0,0,61
1870275,1440089,2024-05-03,House,"House: Rarick - Amendment H5299A5 - H5299A5",60,69,0,0,129
1870275,1440090,2024-05-03,House,"House: McDonald - Amendment - H5299A8",55,68,0,0,123
1870275,1440091,2024-05-03,House,"House: Scott - Amendment H5299A3 - H5299A3",62,68,0,0,130
1870275,1441577,2024-05-07,House,"House: Franson - Amendment - H5299A4",59,68,0,0,127
1870275,1441578,2024-05-07,House,"House: Scott - Amendment - H5299A6",56,69,0,0,125
1870275,1441579,2024-05-07,House,"House: Niska - Amendment - H5299A11",59,68,0,0,127
1870275,1441580,2024-05-07,House,"House: H.F. NO. 5299",69,58,0,0,127
1870275,1441581,2024-05-07,House,"House: H.F. NO. 5299",69,58,0,0,127
1870607,1442860,2024-05-13,Senate,"Senate: Chief author stricken, shown as co-author Dziedzic",55,11,0,0,66
1871937,1443586,2024-05-15,House,"House: Perryman - Amendment - H5363A12",63,65,0,0,128
1871937,1443587,2024-05-15,House,"House: Robbins - Amendment - H5363A16",62,66,0,0,128
1871937,1443588,2024-05-15,House,"House: Baker - Amendment - H5363A17",63,65,0,0,128
1871937,1443589,2024-05-15,House,"House: Rarick - Amendment - H5363A10",61,69,0,0,130
1871937,1443590,2024-05-15,House,"House: Rarick - Amendment - H5363A13",61,69,0,0,130
1871937,1443591,2024-05-15,House,"House: Baker - Amendment - H5363A14",63,67,0,0,130
1871937,1443592,2024-05-15,House,"House: Nash - Amendment - H5363A15",61,69,0,0,130
1871937,1443593,2024-05-15,House,"House: Baker - Amendment - H5363A9",62,68,0,0,130
1871937,1443594,2024-05-15,House,"House: Passage",69,34,0,0,103
1878208,1456246,2024-05-15,Senate,"Senate: Adopted",66,0,0,0,66
