bill_id,roll_call_id,date,chamber,description,yea,nay,nv,absent,total
1641635,1230971,2023-01-03,Senate,"Senate Floor: SR 7, Refer to the Committee on Rules",27,21,0,1,49
1641635,1230999,2023-01-03,Senate,"Senate Floor: SR 7, Refer to the Committee on Rules",27,21,0,1,49
1641680,1230969,2023-01-03,Senate,"Senate Floor: SR 5, Refer to the Committee on Rules",27,21,0,1,49
1641680,1230991,2023-01-03,Senate,"Senate Floor: SR 5, Refer to the Committee on Rules",27,21,0,1,49
1641726,1230968,2023-01-03,Senate,"Senate Floor: SR 3",43,5,1,0,49
1641726,1231105,2023-01-03,Senate,"Senate Floor: SR 3, Rules of the Senate for the 207th and 208th Regular Session",47,2,0,0,49
1641776,1230966,2023-01-03,Senate,"Senate Floor: SR 1",47,2,0,0,49
1641776,1231104,2023-01-03,Senate,"Senate Floor: SR 1, Ethical Conduct Rules of the Senate",47,2,0,0,49
1641829,1230967,2023-01-03,Senate,"Senate Floor: SR 2",47,2,0,0,49
1641829,1231108,2023-01-03,Senate,"Senate Floor: SR 2, Financial Operating Rules of the Senate",47,2,0,0,49
1641878,1230970,2023-01-03,Senate,"Senate Floor: SR 6, Refer to the Committee on Rules",27,21,0,1,49
1641878,1231001,2023-01-03,Senate,"Senate Floor: SR 6, Refer to the Committee on Rules",27,21,0,1,49
1644661,1231162,2023-01-09,Senate,"Senate Transportation: Reported as Committed",14,0,0,0,14
1644661,1231431,2023-01-11,Senate,"Senate Floor: SB 122 PN 12, Final Passage",48,0,0,1,49
1644738,1231122,2023-01-09,Senate,"Senate Transportation: Reported as Committed",14,0,0,0,14
1644738,1232150,2023-01-17,Senate,"Senate Floor: SB 95 PN 8, Bill on Second Consideration",48,0,0,1,49
1644738,1232626,2023-01-18,Senate,"Senate Floor: SB 95 PN 8, Final Passage",49,0,0,0,49
1644738,1232627,2023-01-18,Senate,"Senate Appropriations: Re-Reported as Committed",24,0,0,0,24
1644738,1347416,2023-06-26,House,"House Transportation: Report Bill As Committed",21,0,0,0,21
1644821,1231139,2023-01-09,Senate,"Senate Transportation: Reported as Committed",14,0,0,0,14
1644821,1231254,2023-01-10,Senate,"Senate Floor: SB 96 PN 9, Bill on second consideration",49,0,0,0,49
1644821,1231416,2023-01-11,Senate,"Senate Floor: SB 96 PN 9, Final Passage",48,0,0,1,49
1644821,1347426,2023-06-26,House,"House Transportation: Report Bill As Amended",21,0,0,0,21
1644821,1347427,2023-06-26,House,"House Transportation: Adopt Amendment A01280",21,0,0,0,21
1644905,1231131,2023-01-09,Senate,"Senate Transportation: Reported as Committed",11,3,0,0,14
1644905,1231349,2023-01-11,Senate,"Senate Appropriations: Re-Reported as Committed",16,7,1,0,24
1644905,1231385,2023-01-11,Senate,"Senate Floor: SB 35 PN 13, 2023 A20, Motion to Table HUGHES Amendment No. A-0020",27,21,0,1,49
1644905,1231386,2023-01-11,Senate,"Senate Floor: SB 35 PN 13, Final Passage",29,19,0,1,49
1644990,1231210,2023-01-10,Senate,"Senate Education: Reported as Committed",11,0,0,0,11
1644990,1231390,2023-01-11,Senate,"Senate Floor: SB 84 PN 10, Bill on Second Consideration",48,0,0,1,49
1644990,1232599,2023-01-18,Senate,"Senate Floor: SB 84 PN 10, Bill on Third Consideration",49,0,0,0,49
1644990,1232600,2023-01-18,Senate,"Senate Floor: SB 84 PN 10, Final Passage",49,0,0,0,49
1644990,1343302,2023-06-13,House,"House Education: Report Bill As Committed",21,0,0,0,21
1644990,1356659,2023-10-30,House,"House Floor: SB 84 PN 10, FINAL PASSAGE",201,1,0,1,203
1644990,1356698,2023-10-30,House,"House Appropriations: Re-report Bill As Committed",37,0,0,0,37
1645075,1231121,2023-01-09,Senate,"Senate Transportation: Reported as Committed",9,5,0,0,14
1645075,1263676,2023-02-28,Senate,"Senate Floor: SB 121 PN 11, Final Passage",28,21,0,1,50
1645075,1263677,2023-02-28,Senate,"Senate Appropriations: Re-Reported as Committed",15,9,0,0,24
1645159,1231167,2023-01-09,Senate,"Senate State Government: Reported as Amended",8,3,0,0,11
1645159,1231168,2023-01-09,Senate,"Senate State Government: Adopt Amendment A00004",8,3,0,0,11
1645159,1231241,2023-01-10,Senate,"Senate Rules And Executive Nominations: Re-Reported as Amended",11,6,0,0,17
1645159,1231242,2023-01-10,Senate,"Senate Rules And Executive Nominations: Adopt Amendment A00013",11,6,0,0,17
1645159,1231362,2023-01-11,Senate,"Senate Appropriations: Reported as Committed",15,8,1,0,24
1645159,1231375,2023-01-11,Senate,"Senate Floor: SB 1 PN 26, Motion to Appeal Ruling of the Chair",21,27,0,1,49
1645159,1231376,2023-01-11,Senate,"Senate Floor: SB 1 PN 26, 2023 A16, Motion to Table BOSCOLA Amendment No. A-0016",27,21,0,1,49
1645159,1231377,2023-01-11,Senate,"Senate Floor: SB 1 PN 26, 2023 A17, Motion to Table BOSCOLA Amendment No. A-17",27,21,0,1,49
1645159,1231378,2023-01-11,Senate,"Senate Floor: SB 1 PN 26, 2023 A18, Motion to Table BOSCOLA Amendment No. A-0018",27,21,0,1,49
1645159,1231379,2023-01-11,Senate,"Senate Floor: SB 1 PN 26, Motion to Table",21,27,0,1,49
1645159,1231380,2023-01-11,Senate,"Senate Floor: SB 1 PN 26, Final Passage",28,20,0,1,49
1645159,1265211,2023-03-01,House,"House Judiciary: Report Bill As Amended",12,9,0,0,21
1645159,1265212,2023-03-01,House,"House Judiciary: Adopt Amendment A00091",12,9,0,0,21
1645159,1303904,2023-04-18,House,"House Judiciary: Re-report Bill As Committed",14,7,0,0,21
1645159,1317545,2023-05-03,House,"House Floor: SB 1 PN 385, MOTION TO REVERT PRIOR PRINTERS NUMBER 26",100,101,0,0,201
1645159,1317546,2023-05-03,House,"House Floor: SB 1 PN 385, 2023 A142, CONSTITUTIONALITY OF AMENDMENT",100,101,0,0,201
1645159,1317547,2023-05-03,House,"House Floor: SB 1 PN 385, 2023 A143, CONSTITUTIONALITY OF AMENDMENT",100,101,0,0,201
1645159,1329659,2023-05-22,House,"House Appropriations: Re-report Bill As Committed",25,12,0,0,37
1645159,1329924,2023-05-22,House,"House Floor: SB 1 PN 385, FINAL PASSAGE",145,56,0,0,201
1645247,1231153,2023-01-09,Senate,"Senate State Government: Reported as Committed",8,3,0,0,11
1645247,1231250,2023-01-10,Senate,"Senate Rules And Executive Nominations: Re-Reported as Committed",11,6,0,0,17
1645978,1262337,2023-02-27,Senate,"Senate Environmental Resources And Energy: Reported as Committed",7,4,0,0,11
1645978,1263616,2023-02-28,Senate,"Senate Floor: SR 9 PN 19",31,18,0,1,50
1646085,1231209,2023-01-10,Senate,"Senate Veterans Affairs And Emergency Preparedness: Reported as Committed",11,0,0,0,11
1646085,1271129,2023-03-08,Senate,"Senate Floor: SB 126 PN 16, Final Passage",49,0,0,1,50
1646085,1271130,2023-03-08,Senate,"Senate Appropriations: Re-Reported as Committed",24,0,0,0,24
1646085,1445653,2024-05-21,House,"House Finance: Re-report Bill As Committed",25,0,0,0,25
1646085,1453488,2024-06-04,House,"House Floor: SB 126 PN 16, 2023 A4630, MOTION TO APPEAL RULING OF THE CHAIR",102,100,0,1,203
1646085,1453489,2024-06-04,House,"House Floor: SB 126 PN 16, 2023 A4528",202,0,0,1,203
1646085,1453968,2024-06-05,House,"House Floor: SB 126 PN 1681, FINAL PASSAGE",201,1,0,1,203
1646085,1453969,2024-06-05,House,"House Appropriations: Re-report Bill As Committed",37,0,0,0,37
1646085,1455701,2024-06-10,Senate,"Senate Rules And Executive Nominations: Re-Reported as Committed",17,0,0,0,17
1646085,1456040,2024-06-11,Senate,"Senate Floor: SB 126 PN 1681, Concur in House Amendments",49,0,0,1,50
1646197,1231208,2023-01-10,Senate,"Senate Veterans Affairs And Emergency Preparedness: Reported as Committed",11,0,0,0,11
1646197,1232630,2023-01-18,Senate,"Senate Floor: SB 141 PN 17, Final Passage",49,0,0,0,49
1646197,1232631,2023-01-18,Senate,"Senate Appropriations: Re-Reported as Committed",24,0,0,0,24
1646197,1347397,2023-06-26,House,"House Veterans Affairs And Emergency Preparedness: Report Bill As Committed",21,0,0,0,21
1646197,1355787,2023-10-04,House,"House Floor: SB 141 PN 17, FINAL PASSAGE",200,3,0,0,203
1646197,1355788,2023-10-04,House,"House Appropriations: Re-report Bill As Committed",37,0,0,0,37
1646312,1231236,2023-01-10,Senate,"Senate Education: Reported as Committed",11,0,0,0,11
1646312,1232886,2023-01-18,Senate,"Senate Floor: SB 114 PN 18, Final Passage",49,0,0,0,49
1646312,1232887,2023-01-18,Senate,"Senate Appropriations: Re-Reported as Committed",24,0,0,0,24
1646312,1308203,2023-04-24,House,"House Education: Re-refer Bill To Another Committee",21,0,0,0,21
1646312,1356759,2023-10-31,House,"House Veterans Affairs And Emergency Preparedness: Adopt Amendment A02761",25,0,0,0,25
1646312,1356760,2023-10-31,House,"House Veterans Affairs And Emergency Preparedness: Report Bill As Amended",25,0,0,0,25
1648873,1232535,2023-01-18,Senate,"Senate Consumer Protection And Professional Licensure: Reported as Committed",14,0,0,0,14
1648873,1467883,2024-10-01,Senate,"Senate Appropriations: Re-Reported as Committed",23,0,1,0,24
1648873,1467968,2024-10-01,Senate,"Senate Floor: SB 155 PN 23, Final Passage",48,0,0,2,50
1648873,1468175,2024-10-07,House,"House Consumer Protection, Technology And Utilities: Report Bill As Committed",25,0,0,0,25
1648873,1468850,2024-10-22,House,"House Appropriations: Re-report Bill As Amended",37,0,0,0,37
1648873,1468851,2024-10-22,House,"House Appropriations: Adopt Amendment A06060",22,15,0,0,37
1648873,1468882,2024-10-23,House,"House Floor: SB 155 PN 1972, FINAL PASSAGE",202,0,0,1,203
1652160,1231959,2023-01-11,Senate,"Senate Floor: SR 16 PN 27, Motion Notwithstanding Rule 25",28,20,0,1,49
1652160,1231960,2023-01-11,Senate,"Senate Floor: SR 16 PN 27",28,20,0,1,49
1657139,1316259,2023-05-02,Senate,"Senate Education: Reported as Amended",11,0,0,0,11
1657139,1316260,2023-05-02,Senate,"Senate Education: Adopt Amendment A00161",11,0,0,0,11
1657317,1232826,2023-01-18,Senate,"Senate Environmental Resources And Energy: Reported as Committed",11,0,0,0,11
1657317,1264485,2023-02-28,Senate,"Senate Floor: SB 115 PN 41, Final Passage",49,0,0,1,50
1657317,1264486,2023-02-28,Senate,"Senate Appropriations: Re-Reported as Committed",24,0,0,0,24
1657317,1339034,2023-06-05,House,"House Transportation: Report Bill As Amended",21,0,0,0,21
1657317,1412075,2024-03-20,House,"House Floor: SB 115 PN 41, FINAL PASSAGE",200,1,0,1,202
1657317,1412076,2024-03-20,House,"House Appropriations: Re-report Bill As Committed",37,0,0,0,37
1657435,1459092,2024-06-24,Senate,"Senate Agriculture And Rural Affairs: Reported as Amended A05073",11,0,0,0,11
1657435,1460186,2024-06-26,Senate,"Senate Appropriations: Re-Reported as Committed",23,0,1,0,24
1657435,1460527,2024-06-26,Senate,"Senate Floor: SB 82 PN 1768, Final Passage",50,0,0,0,50
1657435,1461318,2024-06-28,House,"House Agriculture And Rural Affairs: Report Bill As Committed",25,0,0,0,25
1657435,1462116,2024-07-01,House,"House Floor: SB 82 PN 1768, 2023 A5275",202,0,0,1,203
1657435,1462117,2024-07-01,House,"House Floor: SB 82 PN 1768, 2023 A5313",100,102,0,1,203
1657435,1462118,2024-07-01,House,"House Floor: SB 82 PN 1768, 2023 A5335",202,0,0,1,203
1657435,1462160,2024-07-02,House,"House Floor: SB 82 PN 1798, FINAL PASSAGE",201,0,0,2,203
1657435,1462161,2024-07-02,House,"House Appropriations: Re-report Bill As Committed",37,0,0,0,37
1657435,1462385,2024-07-03,Senate,"Senate Rules And Executive Nominations: Re-Reported as Committed",17,0,0,0,17
1657435,1462419,2024-07-03,Senate,"Senate Floor: SB 82 PN 1798, Concur in House Amendments",49,0,0,1,50
1657610,1436342,2024-04-30,Senate,"Senate Communications And Technology: Reported as Amended",7,4,0,0,11
1657610,1436343,2024-04-30,Senate,"Senate Communications And Technology: Adopt Amendment A04170",7,4,0,0,11
1660612,1264870,2023-03-01,Senate,"Senate Veterans Affairs And Emergency Preparedness: Reported as Committed",11,0,0,0,11
1660612,1271124,2023-03-08,Senate,"Senate Floor: SB 162 PN 43, Final Passage",49,0,0,1,50
1660612,1271125,2023-03-08,Senate,"Senate Appropriations: Re-Reported as Committed",24,0,0,0,24
1660612,1356724,2023-10-31,House,"House Veterans Affairs And Emergency Preparedness: Adopt Amendment A02807",25,0,0,0,25
1660612,1356725,2023-10-31,House,"House Veterans Affairs And Emergency Preparedness: Report Bill As Amended",25,0,0,0,25
1666339,1340672,2023-06-07,Senate,"Senate Labor And Industry: Reported as Amended",7,4,0,0,11
1666339,1340673,2023-06-07,Senate,"Senate Labor And Industry: Adopt Amendment A00816",10,1,0,0,11
1666339,1355464,2023-10-02,Senate,"Senate Appropriations: Re-Reported as Committed",14,9,1,0,24
1666339,1355542,2023-10-03,Senate,"Senate Floor: SB 69 PN 858, Final Passage",29,19,0,2,50
1667426,1310783,2023-04-26,Senate,"Senate Veterans Affairs And Emergency Preparedness: Adopt Amendment A00332",11,0,0,0,11
1667426,1310784,2023-04-26,Senate,"Senate Veterans Affairs And Emergency Preparedness: Reported as Amended",11,0,0,0,11
1667426,1346886,2023-06-22,Senate,"Senate Appropriations: Re-Reported as Committed",24,0,0,0,24
1667426,1347715,2023-06-27,Senate,"Senate Floor: SB 81 PN 652, Final Passage",49,0,0,1,50
1667529,1460204,2024-06-26,Senate,"Senate Law And Justice: Reported as Committed",6,5,0,0,11
1668789,1270006,2023-03-07,Senate,"Senate Aging And Youth: Reported as Amended A00162",11,0,0,0,11
1668789,1308504,2023-04-24,Senate,"Senate Appropriations: Re-Reported as Committed",24,0,0,0,24
1668789,1310983,2023-04-26,Senate,"Senate Floor: SB 137 PN 397, Final Passage",50,0,0,0,50
1668828,1322546,2023-05-10,Senate,"Senate Environmental Resources And Energy: Reported as Committed",7,4,0,0,11
1668828,1345358,2023-06-20,Senate,"Senate Appropriations: Re-Reported as Committed",15,9,0,0,24
1668828,1346011,2023-06-21,Senate,"Senate Floor: SB 199 PN 82, Final Passage",28,22,0,0,50
1668865,1262577,2023-02-27,Senate,"Senate Environmental Resources And Energy: Reported as Committed",7,4,0,0,11
1668865,1265118,2023-03-01,Senate,"Senate Appropriations: Re-Reported as Committed",16,8,0,0,24
1668865,1268940,2023-03-06,Senate,"Senate Floor: SB 144 PN 119, 2023 A160, YAW Amendment No. A-160",50,0,0,0,50
1668865,1270338,2023-03-07,Senate,"Senate Floor: SB 144 PN 390, Final Passage",36,14,0,0,50
1668865,1467946,2024-10-01,House,"House Veterans Affairs And Emergency Preparedness: Adopt Amendment A05715",15,10,0,0,25
1668865,1467947,2024-10-01,House,"House Veterans Affairs And Emergency Preparedness: Report Bill As Amended",23,2,0,0,25
1668984,1316934,2023-05-02,Senate,"Senate Game And Fisheries: Reported as Committed",11,0,0,0,11
1668984,1347586,2023-06-26,Senate,"Senate Rules And Executive Nominations: Re-Reported as Committed",16,0,1,0,17
1668984,1348224,2023-06-28,Senate,"Senate Appropriations: Re-Reported as Committed",24,0,0,0,24
1668984,1349020,2023-06-30,Senate,"Senate Floor: SB 146 PN 120, Final Passage",50,0,0,0,50
1668984,1355456,2023-10-02,House,"House Game And Fisheries: Report Bill As Committed",25,0,0,0,25
1668984,1410307,2024-03-18,House,"House Floor: SB 146 PN 120, FINAL PASSAGE",201,0,0,1,202
1668984,1410308,2024-03-18,House,"House Appropriations: Re-report Bill As Committed",37,0,0,0,37
1669025,1354926,2023-09-19,Senate,"Senate State Government: Reported as Committed",10,0,1,0,11
1669061,1437356,2024-05-01,Senate,"Senate Finance: Reported as Committed",10,1,0,0,11
1669084,1311200,2023-04-26,Senate,"Senate Veterans Affairs And Emergency Preparedness: Adopt Amendment A00295",11,0,0,0,11
1669084,1311201,2023-04-26,Senate,"Senate Veterans Affairs And Emergency Preparedness: Reported as Amended",11,0,0,0,11
1669121,1310748,2023-04-26,Senate,"Senate Transportation: Reported as Committed",11,2,1,0,14
1669121,1467795,2024-09-30,Senate,"Senate Floor: SB 153 PN 125, 2023 A5731, WARD, J. Amendment No. A-5731",31,17,0,2,50
1669121,1467955,2024-10-01,Senate,"Senate Floor: SB 153 PN 1916, Final Passage",34,14,0,2,50
1669140,1322563,2023-05-10,Senate,"Senate Environmental Resources And Energy: Reported as Committed",7,4,0,0,11
1669140,1345346,2023-06-20,Senate,"Senate Floor: SB 198 PN 81, 2023 A915, BARTOLOTTA Amendment No. A-0915",28,22,0,0,50
1669140,1345347,2023-06-20,Senate,"Senate Appropriations: Re-Reported as Committed",15,9,0,0,24
1669140,1346006,2023-06-21,Senate,"Senate Floor: SB 198 PN 933, Final Passage",28,22,0,0,50
1669163,1271209,2023-03-08,Senate,"Senate Intergovernmental Operations: Reported as Committed",7,4,0,0,11
1669163,1320606,2023-05-08,Senate,"Senate Appropriations: Re-Reported as Committed",15,9,0,0,24
1669163,1321488,2023-05-09,Senate,"Senate Floor: SB 190 PN 88, Final Passage",28,21,0,1,50
1669243,1356496,2023-10-25,Senate,"Senate Consumer Protection And Professional Licensure: Reported as Committed",14,0,0,0,14
1669243,1362270,2023-12-11,Senate,"Senate Appropriations: Re-Reported as Committed",24,0,0,0,24
1669243,1362357,2023-12-12,Senate,"Senate Floor: SB 142 PN 118, Final Passage",50,0,0,0,50
1669243,1468060,2024-10-02,House,"House Professional Licensure: Report Bill As Committed",25,0,0,0,25
1669243,1468488,2024-10-09,House,"House Floor: SB 142 PN 118, FINAL PASSAGE",201,1,0,1,203
1669243,1468489,2024-10-09,House,"House Appropriations: Re-report Bill As Committed",37,0,0,0,37
1669304,1339346,2023-06-06,Senate,"Senate Judiciary: Adopt Amendment A00043",13,0,1,0,14
1669304,1339347,2023-06-06,Senate,"Senate Judiciary: Reported as Amended",13,0,1,0,14
1669402,1321020,2023-05-09,Senate,"Senate Urban Affairs And Housing: Reported as Committed",11,0,0,0,11
1669402,1340561,2023-06-07,Senate,"Senate Floor: SB 202 PN 83, Final Passage",50,0,0,0,50
1669402,1340562,2023-06-07,Senate,"Senate Appropriations: Re-Reported as Committed",24,0,0,0,24
1669402,1343371,2023-06-13,House,"House Housing And Community Development: Report Bill As Committed",21,0,0,0,21
1669402,1346902,2023-06-22,House,"House Floor: SB 202 PN 83, FINAL PASSAGE",149,53,0,1,203
1669402,1346903,2023-06-22,House,"House Appropriations: Re-report Bill As Committed",37,0,0,0,37
1669425,1270888,2023-03-08,Senate,"Senate Intergovernmental Operations: Reported as Committed",7,4,0,0,11
1669425,1320058,2023-05-08,Senate,"Senate Appropriations: Re-Reported as Committed",15,9,0,0,24
1669425,1321296,2023-05-09,Senate,"Senate Floor: SB 188 PN 86, Final Passage",28,21,0,1,50
1669460,1265003,2023-03-01,Senate,"Senate Transportation: Reported as Committed",14,0,0,0,14
1669460,1270070,2023-03-07,Senate,"Senate Floor: SB 154 PN 126, Final Passage",50,0,0,0,50
1669517,1320728,2023-05-09,Senate,"Senate Urban Affairs And Housing: Reported as Amended A00164",11,0,0,0,11
1669517,1346867,2023-06-22,Senate,"Senate Appropriations: Re-Reported as Committed",23,1,0,0,24
1669517,1362603,2023-12-13,Senate,"Senate Floor: SB 149 PN 734, Final Passage",41,9,0,0,50
1669517,1460201,2024-06-26,House,"House Housing And Community Development: Report Bill As Committed",15,9,1,0,25
1669517,1461911,2024-07-01,House,"House Floor: SB 149 PN 734, FINAL PASSAGE",109,93,0,1,203
1669517,1461912,2024-07-01,House,"House Appropriations: Re-report Bill As Committed",37,0,0,0,37
1669556,1357433,2023-11-13,Senate,"Senate Veterans Affairs And Emergency Preparedness: Reported as Committed",11,0,0,0,11
1669556,1452972,2024-06-03,Senate,"Senate Appropriations: Re-Reported as Committed",24,0,0,0,24
1669556,1454039,2024-06-05,Senate,"Senate Floor: SB 194 PN 79, Final Passage",50,0,0,0,50
1669597,1320976,2023-05-09,Senate,"Senate Agriculture And Rural Affairs: Reported as Committed",11,0,0,0,11
1669597,1338430,2023-06-05,Senate,"Senate Appropriations: Re-Reported as Committed",24,0,0,0,24
1669597,1339446,2023-06-06,Senate,"Senate Floor: SB 152 PN 124, Final Passage",50,0,0,0,50
1669597,1345475,2023-06-20,House,"House Agriculture And Rural Affairs: Report Bill As Committed",20,0,1,0,21
1669597,1356749,2023-10-31,House,"House Floor: SB 152 PN 124, FINAL PASSAGE",198,4,0,1,203
1669597,1356750,2023-10-31,House,"House Appropriations: Re-report Bill As Committed",37,0,0,0,37
1669619,1265006,2023-03-01,Senate,"Senate Transportation: Reported as Committed",14,0,0,0,14
1669775,1411721,2024-03-20,Senate,"Senate Finance: Reported as Committed",11,0,0,0,11
1684224,1265038,2023-03-01,Senate,"Senate Education: Reported as Committed",10,1,0,0,11
1684224,1308390,2023-04-24,Senate,"Senate Appropriations: Re-Reported as Committed",24,0,0,0,24
1684224,1309534,2023-04-25,Senate,"Senate Floor: SB 232 PN 146, 2023 A326, BROOKS Amendment No. A-0326",49,1,0,0,50
1684224,1310785,2023-04-26,Senate,"Senate Floor: SB 232 PN 637, Final Passage",49,1,0,0,50
1684224,1467771,2024-09-30,House,"House Education: Report Bill As Committed",19,6,0,0,25
1684224,1468504,2024-10-09,House,"House Floor: SB 232 PN 637, FINAL PASSAGE",179,23,0,1,203
1684224,1468505,2024-10-09,House,"House Appropriations: Re-report Bill As Committed",37,0,0,0,37
1685101,1270027,2023-03-07,Senate,"Senate Aging And Youth: Reported as Committed",11,0,0,0,11
1685114,1268757,2023-03-06,Senate,"Senate Local Government: Reported as Amended",8,3,0,0,11
1685114,1268758,2023-03-06,Senate,"Senate Local Government: Adopt Amendment A00140",9,2,0,0,11
1685114,1270856,2023-03-08,Senate,"Senate Floor: SB 143 PN 388, Final Passage",40,9,0,1,50
1685154,1268798,2023-03-06,Senate,"Senate Judiciary: Reported as Committed",13,1,0,0,14
1685154,1467313,2024-09-16,Senate,"Senate Appropriations: Re-Reported as Committed",22,1,1,0,24
1685154,1467338,2024-09-17,Senate,"Senate Floor: SB 170 PN 160, Final Passage",47,2,0,1,50
1685154,1468068,2024-10-02,House,"House Judiciary: Report Bill As Committed",24,1,0,0,25
1685154,1468323,2024-10-08,House,"House Floor: SB 170 PN 160, FINAL PASSAGE",194,7,0,2,203
1685154,1468324,2024-10-08,House,"House Appropriations: Re-report Bill As Committed",37,0,0,0,37
1685169,1269995,2023-03-07,Senate,"Senate Aging And Youth: Reported as Committed",11,0,0,0,11
1685209,1346454,2023-06-22,Senate,"Senate Community, Economic And Recreational Development: Reported as Committed",13,0,1,0,14
1685209,1467318,2024-09-16,Senate,"Senate Appropriations: Re-Reported as Committed",23,0,1,0,24
1685209,1467374,2024-09-17,Senate,"Senate Floor: SB 173 PN 163, Final Passage",48,1,0,1,50
1685276,1268938,2023-03-06,Senate,"Senate Judiciary: Reported as Committed",14,0,0,0,14
1685276,1467314,2024-09-16,Senate,"Senate Appropriations: Re-Reported as Committed",23,0,1,0,24
1685276,1467340,2024-09-17,Senate,"Senate Floor: SB 169 PN 159, Final Passage",49,0,0,1,50
1685276,1468083,2024-10-02,House,"House Judiciary: Report Bill As Committed",25,0,0,0,25
1685276,1468326,2024-10-08,House,"House Floor: SB 169 PN 159, FINAL PASSAGE",201,0,0,2,203
1685276,1468327,2024-10-08,House,"House Appropriations: Re-report Bill As Committed",37,0,0,0,37
1685287,1309426,2023-04-25,Senate,"Senate Judiciary: Reported as Amended A00301",11,3,0,0,14
1685287,1315216,2023-05-01,Senate,"Senate Appropriations: Re-Reported as Committed",18,5,1,0,24
1685287,1315599,2023-05-01,Senate,"Senate Floor: SB 165 PN 634, Final Passage",41,9,0,0,50
1685287,1339260,2023-04-25,Senate,"Senate Judiciary: Adopt Amendment A00301",9,5,0,0,14
1685901,1453171,2024-06-04,Senate,"Senate Judiciary: Reported as Amended",14,0,0,0,14
1685901,1453172,2024-06-04,Senate,"Senate Judiciary: Adopt Amendment A04641",14,0,0,0,14
1685901,1456758,2024-06-12,Senate,"Senate Floor: SB 186 PN 1678, Final Passage",48,0,0,2,50
1685901,1461001,2024-06-27,House,"House Judiciary: Report Bill As Committed",25,0,0,0,25
1685901,1462166,2024-07-02,House,"House Floor: SB 186 PN 1678, 2023 A5364",134,67,0,2,203
1685901,1462426,2024-07-03,House,"House Floor: SB 186 PN 1804, FINAL PASSAGE",144,58,0,1,203
1685901,1462427,2024-07-03,House,"House Appropriations: Re-report Bill As Committed",37,0,0,0,37
1687908,1347658,2023-06-27,Senate,"Senate Judiciary: Reported as Amended",10,4,0,0,14
1687908,1347659,2023-06-27,Senate,"Senate Judiciary: Adopt Amendment A01493",9,5,0,0,14
1687908,1355494,2023-10-02,Senate,"Senate Floor: SB 235 PN 977, 2023 A2266, SANTARSIERO Amendment No. A-2266",49,0,0,1,50
1687908,1355495,2023-10-02,Senate,"Senate Floor: SB 235 PN 1130, Motion to Suspend Senate Rule 12",43,6,0,1,50
1687908,1355496,2023-10-02,Senate,"Senate Floor: SB 235 PN 1130, Final Passage",35,14,0,1,50
1688034,1309447,2023-04-25,Senate,"Senate State Government: Reported as Committed",11,0,0,0,11
1688069,1357531,2023-11-14,Senate,"Senate State Government: Reported as Committed",11,0,0,0,11
1688069,1375977,2024-02-05,Senate,"Senate Appropriations: Re-Reported as Committed",23,0,1,0,24
1688069,1378728,2024-02-07,Senate,"Senate Floor: SB 228 PN 197, Final Passage",49,0,0,1,50
1688069,1467913,2024-10-01,House,"House State Government: Re-report Bill As Committed",25,0,0,0,25
1688078,1316645,2023-05-02,Senate,"Senate Community, Economic And Recreational Development: Reported as Committed",14,0,0,0,14
1688078,1320278,2023-05-08,Senate,"Senate Floor: SB 248 PN 212, Final Passage",50,0,0,0,50
1688078,1320279,2023-05-08,Senate,"Senate Appropriations: Re-Reported as Committed",24,0,0,0,24
1688120,1316141,2023-05-02,Senate,"Senate Health And Human Services: Reported as Committed",11,0,0,0,11
1688132,1357441,2023-11-13,Senate,"Senate Intergovernmental Operations: Reported as Amended",7,4,0,0,11
1688132,1357442,2023-11-13,Senate,"Senate Intergovernmental Operations: Adopt Amendment A02903",7,4,0,0,11
1688146,1321006,2023-05-09,Senate,"Senate Agriculture And Rural Affairs: Reported as Committed",11,0,0,0,11
1688146,1339358,2023-06-05,Senate,"Senate Floor: SB 277 PN 241, Final Passage",49,0,0,1,50
1688146,1345473,2023-06-20,House,"House Agriculture And Rural Affairs: Report Bill As Committed",20,0,1,0,21
1688146,1440171,2024-05-07,House,"House Floor: SB 277 PN 241, 2023 A4260",156,45,0,1,202
1688146,1440920,2024-05-08,House,"House Floor: SB 277 PN 1589, FINAL PASSAGE",162,38,0,2,202
1688146,1440921,2024-05-08,House,"House Appropriations: Re-report Bill As Committed",37,0,0,0,37
1688146,1452774,2024-06-03,Senate,"Senate Floor: SB 277 PN 1589, Concur in House Amendments",49,1,0,0,50
1688146,1452775,2024-06-03,Senate,"Senate Rules And Executive Nominations: Re-Reported as Committed",17,0,0,0,17
1688156,1262135,2023-02-27,Senate,"Senate Environmental Resources And Energy: Reported as Committed",7,4,0,0,11
1688156,1264948,2023-03-01,Senate,"Senate Floor: SB 254 PN 217, Final Passage",29,20,0,1,50
1688189,1310818,2023-04-26,Senate,"Senate Health And Human Services: Reported as Committed",7,4,0,0,11
1688189,1317218,2023-05-02,Senate,"Senate Floor: SB 245 PN 210, 2023 A-0441, Motion to Table Hughes Amendment A-0441",28,22,0,0,50
1688189,1317219,2023-05-02,Senate,"Senate Appropriations: Re-Reported as Committed",15,9,0,0,24
1688189,1317471,2023-05-03,Senate,"Senate Floor: SB 245 PN 210, Final Passage",28,21,0,1,50
1688221,1322606,2023-05-10,Senate,"Senate Law And Justice: Reported as Committed",11,0,0,0,11
1688232,1362501,2023-12-13,Senate,"Senate Finance: Reported as Committed",11,0,0,0,11
1688232,1462165,2024-07-02,Senate,"Senate Appropriations: Re-Reported as Committed",24,0,0,0,24
1688232,1462435,2024-07-03,Senate,"Senate Floor: SB 219 PN 188, Final Passage",46,4,0,0,50
1688232,1462726,2024-07-08,House,"House Finance: Report Bill As Committed",14,11,0,0,25
1688232,1462727,2024-07-08,House,"House Finance: Adopt Amendment A05448",11,14,0,0,25
1688232,1462728,2024-07-08,House,"House Finance: Motion that amendment A05442 not Germaine A05442",14,11,0,0,25
1688232,1462749,2024-07-09,House,"House Floor: SB 219 PN 188, MOTION TO TABLE AMENDMENTS",102,100,0,1,203
1688232,1462857,2024-07-10,House,"House Appropriations: Re-report Bill As Committed",37,0,0,0,37
1688232,1462912,2024-07-10,House,"House Floor: SB 219 PN 188, FINAL PASSAGE",102,100,0,1,203
1688285,1356388,2023-10-24,Senate,"Senate Environmental Resources And Energy: Reported as Committed",7,4,0,0,11
1688324,1437413,2024-05-01,Senate,"Senate Finance: Reported as Amended",11,0,0,0,11
1688324,1437414,2024-05-01,Senate,"Senate Finance: Adopt Amendment A04192",11,0,0,0,11
1688324,1439429,2024-05-06,Senate,"Senate Rules And Executive Nominations: Re-Reported as Amended",11,5,1,0,17
1688324,1439430,2024-05-06,Senate,"Senate Rules And Executive Nominations: Adopt Amendment A04334",11,5,1,0,17
1688324,1440566,2024-05-07,Senate,"Senate Floor: SB 269 PN 1584, 2023 A4372, Motion to Table HAYWOOD Amendment No. A-4372",28,22,0,0,50
1688324,1440567,2024-05-07,Senate,"Senate Floor: SB 269 PN 1584, 2023 A4374, Motion to Table HAYWOOD Amendment No. A-4374",28,22,0,0,50
1688324,1440568,2024-05-07,Senate,"Senate Floor: SB 269 PN 1584, Final Passage",36,14,0,0,50
1688324,1440569,2024-05-07,Senate,"Senate Appropriations: Re-Reported as Committed",17,7,0,0,24
1688335,1262133,2023-02-27,Senate,"Senate Environmental Resources And Energy: Reported as Committed",8,3,0,0,11
1688335,1270752,2023-03-08,Senate,"Senate Appropriations: Re-Reported as Committed",17,7,0,0,24
1688335,1271264,2023-03-08,Senate,"Senate Floor: SB 211 PN 180, Final Passage",36,13,0,1,50
1688335,1309574,2023-04-25,House,"House Consumer Protection, Technology And Utilities: Re-refer Bill To Another Committee",21,0,0,0,21
1688335,1467853,2024-10-01,House,"House Environmental Resources And Energy: Report Bill As Committed",24,1,0,0,25
1688357,1270749,2023-03-08,Senate,"Senate Labor And Industry: Reported as Committed",11,0,0,0,11
1688357,1308243,2023-04-24,Senate,"Senate Appropriations: Re-Reported as Committed",18,6,0,0,24
1688357,1315499,2023-05-01,Senate,"Senate Floor: SB 239 PN 205, Final Passage",36,14,0,0,50
1688369,1352419,2023-08-30,Senate,"Senate State Government: Reported as Amended",10,0,1,0,11
1688369,1352420,2023-08-30,Senate,"Senate State Government: Adopt Amendment A01923",10,0,1,0,11
1688369,1354885,2023-09-18,Senate,"Senate State Government: Re-Reported as Amended",9,1,1,0,11
1688369,1354886,2023-09-18,Senate,"Senate State Government: Adopt Amendment A01952",7,3,1,0,11
1688369,1354909,2023-09-19,Senate,"Senate Appropriations: Re-Reported as Committed",23,0,1,0,24
1688369,1355021,2023-09-20,Senate,"Senate Floor: SB 224 PN 1097, Final Passage",45,2,0,3,50
1688369,1355533,2023-10-03,House,"House State Government: Report Bill As Committed",7,18,0,0,25
1688369,1355534,2023-10-03,House,"House State Government: Motion to Reconsider Bill",14,11,0,0,25
1688369,1355535,2023-10-03,House,"House State Government: Report Bill As Committed",13,12,0,0,25
1688369,1355748,2023-10-04,House,"House Floor: SB 224 PN 1097, 2023 A2365, CONSTITUTIONALITY",159,44,0,0,203
1688369,1355749,2023-10-04,House,"House Floor: SB 224 PN 1097, 2023 A2365",123,80,0,0,203
1688369,1355750,2023-10-04,House,"House Floor: SB 224 PN 1097, 2023 A2305",102,101,0,0,203
1688369,1355751,2023-10-04,House,"House Floor: SB 224 PN 1097, MOTION TO TABLE AMENDMENTS",102,101,0,0,203
1688369,1355811,2023-10-04,House,"House Appropriations: Report Bill As Amended",22,15,0,0,37
1688369,1355812,2023-10-04,House,"House Appropriations: Adopt Amendment A02452",22,15,0,0,37
1688369,1355813,2023-10-05,House,"House Floor: SB 224 PN 1160, MOTION TO RECONSIDER THIRD CONSIDERATION",101,102,0,0,203
1688369,1355814,2023-10-05,House,"House Floor: SB 224 PN 1160, FINAL PASSAGE",26,177,0,0,203
1688369,1356022,2023-10-16,House,"House Floor: SB 224 PN 1160, MOTION TO RECONSIDER",102,101,0,0,203
1688369,1356108,2023-10-04,House,"House Appropriations: To Table A02452",15,22,0,0,37
1688369,1356175,2023-10-17,House,"House Appropriations: Adopt Amendment A02604",22,15,0,0,37
1688369,1356176,2023-10-17,House,"House Appropriations: Re-report Bill As Amended",22,15,0,0,37
1688369,1356267,2023-10-18,House,"House Floor: SB 224 PN 1171, 2023 A2606, MOTION TO SUSPEND RULES",101,102,0,0,203
1688369,1356268,2023-10-18,House,"House Floor: SB 224 PN 1171, FINAL PASSAGE",104,99,0,0,203
1688403,1270841,2023-03-08,Senate,"Senate Labor And Industry: Reported as Committed",11,0,0,0,11
1688403,1309561,2023-04-25,Senate,"Senate Floor: SB 226 PN 195, Final Passage",50,0,0,0,50
1688403,1339611,2023-06-06,House,"House Labor And Industry: Report Bill As Committed",21,0,0,0,21
1688403,1344153,2023-06-14,House,"House Floor: SB 226 PN 195, FINAL PASSAGE",203,0,0,0,203
1688403,1344154,2023-06-14,House,"House Appropriations: Re-report Bill As Committed",37,0,0,0,37
1688412,1268763,2023-03-06,Senate,"Senate Judiciary: Reported as Committed",14,0,0,0,14
1688412,1308699,2023-04-24,Senate,"Senate Floor: SB 267 PN 232, Final Passage",50,0,0,0,50
1688412,1468079,2024-10-02,House,"House Judiciary: Report Bill As Committed",25,0,0,0,25
1688412,1468552,2024-10-09,House,"House Floor: SB 267 PN 232, 2023 A5761",202,0,0,1,203
1688412,1468755,2024-10-21,House,"House Floor: SB 267 PN 1954, FINAL PASSAGE",202,0,0,1,203
1688412,1468756,2024-10-21,House,"House Appropriations: Re-report Bill As Committed",37,0,0,0,37
1688412,1468846,2024-10-22,Senate,"Senate Floor: SB 267 PN 1954, Concur in House Amendments",50,0,0,0,50
1688412,1468847,2024-10-22,Senate,"Senate Rules And Executive Nominations: Re-Reported as Committed",17,0,0,0,17
1688480,1321481,2023-05-09,Senate,"Senate State Government: Reported as Amended",11,0,0,0,11
1688480,1321482,2023-05-09,Senate,"Senate State Government: Adopt Amendment A00497",11,0,0,0,11
1688480,1345353,2023-06-20,Senate,"Senate Appropriations: Re-Reported as Committed",24,0,0,0,24
1688492,1310801,2023-04-26,Senate,"Senate Health And Human Services: Reported as Committed",7,4,0,0,11
1688492,1315939,2023-05-01,Senate,"Senate Floor: SB 244 PN 209, 2023 A383, ARGALL Amendment No. A-0383",29,21,0,0,50
1688492,1317216,2023-05-02,Senate,"Senate Appropriations: Re-Reported as Committed",15,9,0,0,24
1688492,1317474,2023-05-03,Senate,"Senate Floor: SB 244 PN 685, Final Passage",28,21,0,1,50
1688502,1345998,2023-06-21,Senate,"Senate Law And Justice: Reported as Amended",11,0,0,0,11
1688502,1345999,2023-06-21,Senate,"Senate Law And Justice: Adopt Amendment A00642",11,0,0,0,11
1688502,1347419,2023-06-26,Senate,"Senate Appropriations: Re-Reported as Committed",22,2,0,0,24
1688502,1347559,2023-06-26,Senate,"Senate Floor: SB 260 PN 935, Final Passage",44,5,0,1,50
1688673,1316124,2023-05-02,Senate,"Senate Health And Human Services: Reported as Committed",11,0,0,0,11
1688673,1321052,2023-05-09,Senate,"Senate Appropriations: Re-Reported as Committed",23,0,1,0,24
1688673,1339322,2023-06-06,Senate,"Senate Floor: SB 262 PN 833, Final Passage",50,0,0,0,50
1688673,1344056,2023-06-14,House,"House Health: Report Bill As Committed",21,0,0,0,21
1688673,1346622,2023-06-22,House,"House Floor: SB 262 PN 833, FINAL PASSAGE",202,0,0,1,203
1688673,1346623,2023-06-22,House,"House Appropriations: Re-report Bill As Committed",37,0,0,0,37
1688693,1311348,2023-04-26,Senate,"Senate Health And Human Services: Reported as Committed",7,4,0,0,11
1688693,1316947,2023-05-02,Senate,"Senate Appropriations: Re-Reported as Committed",15,9,0,0,24
1688693,1317953,2023-05-03,Senate,"Senate Floor: SB 243 PN 208, Final Passage",28,21,0,1,50
1688785,1270927,2023-03-08,Senate,"Senate Urban Affairs And Housing: Reported as Committed",10,1,0,0,11
1688879,1264896,2023-03-01,Senate,"Senate Transportation: Adopt Amendment A00093",14,0,0,0,14
1688879,1264897,2023-03-01,Senate,"Senate Transportation: Reported as Amended",14,0,0,0,14
1688879,1270148,2023-03-07,Senate,"Senate Floor: SB 298 PN 382, Final Passage",50,0,0,0,50
1688879,1348696,2023-06-29,House,"House Transportation: Report Bill As Amended",21,0,0,0,21
1688879,1348697,2023-06-29,House,"House Transportation: Adopt Amendment A01485",21,0,0,0,21
1688879,1462417,2024-07-03,House,"House Floor: SB 298 PN 990, FINAL PASSAGE",201,1,0,1,203
1688879,1462418,2024-07-03,House,"House Appropriations: Re-report Bill As Committed",37,0,0,0,37
1688879,1462730,2024-07-08,Senate,"Senate Floor: SB 298 PN 990, Concur in House Amendments",49,0,0,1,50
1688879,1462731,2024-07-08,Senate,"Senate Rules And Executive Nominations: Re-Reported as Committed",16,1,0,0,17
1689043,1345902,2023-06-21,Senate,"Senate Environmental Resources And Energy: Reported as Committed",7,4,0,0,11
1689067,1265020,2023-03-01,Senate,"Senate Education: Reported as Committed",9,2,0,0,11
1689182,1316403,2023-05-02,Senate,"Senate Education: Reported as Committed",11,0,0,0,11
1689182,1345148,2023-06-19,Senate,"Senate Appropriations: Re-Reported as Committed",24,0,0,0,24
1689182,1345205,2023-06-19,Senate,"Senate Floor: SB 290 PN 264, Final Passage",49,1,0,0,50
1693143,1319971,2023-05-08,Senate,"Senate Intergovernmental Operations: Reported as Amended",7,4,0,0,11
1693143,1319972,2023-05-08,Senate,"Senate Intergovernmental Operations: Adopt Amendment A00483",7,4,0,0,11
1693143,1321031,2023-05-09,Senate,"Senate Appropriations: Re-Reported as Committed",15,8,1,0,24
1693143,1322712,2023-05-10,Senate,"Senate Floor: SB 350 PN 718, 2023 A507, Motion to Table MUTH Amendment No. A-0507",28,20,0,2,50
1693143,1322713,2023-05-10,Senate,"Senate Floor: SB 350 PN 718, 2023 A508, Motion to Table MUTH Amendment No. A-0508",28,20,0,2,50
1693143,1322714,2023-05-10,Senate,"Senate Floor: SB 350 PN 718, 2023 A518, Motion to Table MUTH Amendment No. A-0518",28,20,0,2,50
1693143,1322715,2023-05-10,Senate,"Senate Floor: SB 350 PN 718, Final Passage",29,19,0,2,50
1702422,1268716,2023-03-06,Senate,"Senate Communications And Technology: Reported as Committed",11,0,0,0,11
1702422,1270796,2023-03-08,Senate,"Senate Floor: SB 379 PN 272, Final Passage",49,0,0,1,50
1702422,1362339,2023-12-12,House,"House State Government: Report Bill As Committed",19,6,0,0,25
1702422,1414957,2024-03-25,House,"House Floor: SB 379 PN 272, 2023 A3719",139,62,0,1,202
1704492,1354899,2023-09-19,Senate,"Senate Education: Reported as Amended",7,4,0,0,11
1704492,1354900,2023-09-19,Senate,"Senate Education: Adopt Amendment A01993",7,4,0,0,11
1704492,1356405,2023-10-24,Senate,"Senate Appropriations: Re-Reported as Committed",15,9,0,0,24
1704492,1356454,2023-10-24,Senate,"Senate Floor: SB 340 PN 1101, Final Passage",28,22,0,0,50
1704500,1460212,2024-06-26,Senate,"Senate Law And Justice: Reported as Committed",11,0,0,0,11
1704503,1309621,2023-04-25,Senate,"Senate Judiciary: Reported as Amended A00291",14,0,0,0,14
1704503,1321386,2023-05-09,Senate,"Senate Floor: SB 361 PN 635, Motion to agree to the bill on second consideration",49,0,0,1,50
1704503,1339054,2023-06-05,Senate,"Senate Appropriations: Re-Reported as Committed",24,0,0,0,24
1704503,1340047,2023-04-25,Senate,"Senate Judiciary: Adopt Amendment A00291",14,0,0,0,14
1704503,1340048,2023-06-06,Senate,"Senate Floor: SB 361 PN 635, Final Passage",50,0,0,0,50
1704503,1356703,2023-10-31,House,"House Judiciary: Adopt Amendment A02809",16,8,1,0,25
1704503,1356704,2023-10-31,House,"House Judiciary: Report Bill As Amended",20,5,0,0,25
1704503,1362406,2023-12-12,House,"House Floor: SB 361 PN 1203, 2023 A3257",118,85,0,0,203
1704503,1362407,2023-12-12,House,"House Floor: SB 361 PN 1203, 2023 A3124",203,0,0,0,203
1704503,1362518,2023-12-13,House,"House Floor: SB 361 PN 1283, FINAL PASSAGE",168,35,0,0,203
1704503,1362519,2023-12-13,House,"House Appropriations: Re-report Bill As Committed",37,0,0,0,37
1704503,1362641,2023-12-13,Senate,"Senate Floor: SB 361 PN 1283, Concur in House Amendments",50,0,0,0,50
1704503,1362642,2023-12-13,Senate,"Senate Rules And Executive Nominations: Re-Reported as Committed",17,0,0,0,17
1704504,1453173,2024-06-04,Senate,"Senate Judiciary: Reported as Committed",14,0,0,0,14
1704504,1456629,2024-06-12,Senate,"Senate Floor: SB 187 PN 273, Final Passage",48,0,0,2,50
1704504,1461026,2024-06-27,House,"House Judiciary: Report Bill As Committed",25,0,0,0,25
1704504,1462389,2024-07-03,House,"House Appropriations: Re-report Bill As Committed",37,0,0,0,37
1704504,1462434,2024-07-03,House,"House Floor: SB 187 PN 273, FINAL PASSAGE",202,0,0,1,203
1704508,1320995,2023-05-09,Senate,"Senate State Government: Reported as Committed",9,2,0,0,11
1704510,1316304,2023-05-02,Senate,"Senate Education: Reported as Committed",7,4,0,0,11
1704510,1356378,2023-10-23,Senate,"Senate Appropriations: Re-Reported as Committed",21,3,0,0,24
1704510,1356449,2023-10-24,Senate,"Senate Floor: SB 353 PN 283, Final Passage",42,8,0,0,50
1704514,1309336,2023-04-25,Senate,"Senate Law And Justice: Reported as Committed",11,0,0,0,11
1704515,1310719,2023-04-26,Senate,"Senate Transportation: Reported as Amended",13,0,1,0,14
1704515,1310720,2023-04-26,Senate,"Senate Transportation: Adopt Amendment A00320",13,0,1,0,14
1704517,1316172,2023-05-02,Senate,"Senate Game And Fisheries: Reported as Amended",11,0,0,0,11
1704517,1346879,2023-06-22,Senate,"Senate Appropriations: Re-Reported as Committed",24,0,0,0,24
1704517,1347759,2023-06-27,Senate,"Senate Floor: SB 344 PN 688, Final Passage",49,0,0,1,50
1707268,1263636,2023-02-28,Senate,"Senate Banking And Insurance: Reported as Committed",14,0,0,0,14
1707268,1265130,2023-03-01,Senate,"Senate Appropriations: Re-Reported as Committed",24,0,0,0,24
1707268,1269012,2023-03-06,Senate,"Senate Floor: SB 8 PN 290, Final Passage",50,0,0,0,50
1707268,1308296,2023-04-24,House,"House Insurance: Report Bill As Committed",21,0,0,0,21
1707268,1310997,2023-04-26,House,"House Floor: SB 8 PN 290, FINAL PASSAGE",200,0,0,1,201
1707268,1310998,2023-04-26,House,"House Appropriations: Re-report Bill As Committed",37,0,0,0,37
1715948,1346451,2023-06-22,Senate,"Senate Community, Economic And Recreational Development: Reported as Committed",13,0,1,0,14
1715948,1354892,2023-09-18,Senate,"Senate Floor: SB 373 PN 316, Final Passage",45,0,0,5,50
1715948,1354893,2023-09-18,Senate,"Senate Appropriations: Re-Reported as Committed",22,0,2,0,24
1716026,1347425,2023-06-26,Senate,"Senate State Government: Reported as Committed",11,0,0,0,11
1716026,1354884,2023-09-18,Senate,"Senate Appropriations: Re-Reported as Committed",22,0,2,0,24
1716026,1356379,2023-10-23,Senate,"Senate Floor: SB 282 PN 304, Final Passage",50,0,0,0,50
1716026,1357563,2023-11-14,House,"House State Government: Report Bill As Committed",25,0,0,0,25
1716026,1362622,2023-12-13,House,"House Floor: SB 282 PN 304, FINAL PASSAGE",203,0,0,0,203
1716026,1362623,2023-12-13,House,"House Appropriations: Re-report Bill As Committed",37,0,0,0,37
1716056,1345149,2023-06-19,Senate,"Senate Education: Reported as Amended",11,0,0,0,11
1716056,1345150,2023-06-19,Senate,"Senate Education: Adopt Amendment A01130",11,0,0,0,11
1716086,1320782,2023-05-09,Senate,"Senate State Government: Reported as Amended",11,0,0,0,11
1716086,1320783,2023-05-09,Senate,"Senate State Government: Adopt Amendment A00505",11,0,0,0,11
1716098,1339515,2023-06-06,Senate,"Senate Education: Reported as Amended",11,0,0,0,11
1716098,1339516,2023-06-06,Senate,"Senate Education: Adopt Amendment A00760",11,0,0,0,11
1716098,1347451,2023-06-26,Senate,"Senate Appropriations: Re-Reported as Committed",24,0,0,0,24
1716098,1347782,2023-06-27,Senate,"Senate Floor: SB 209 PN 839, Final Passage",49,0,0,1,50
1716098,1357443,2023-11-13,House,"House Education: Re-report Bill As Committed",26,0,0,0,26
1716098,1362296,2023-12-11,House,"House Floor: SB 209 PN 839, 2023 A3024, MOTION TO APPEAL RULING OF THE CHAIR",102,101,0,0,203
1716098,1462879,2024-07-10,House,"House Appropriations: Re-report Bill As Committed",37,0,0,0,37
1716098,1462977,2024-07-11,House,"House Floor: SB 209 PN 839, FINAL PASSAGE",202,0,0,1,203
1716251,1268908,2023-03-06,Senate,"Senate Judiciary: Reported as Committed",14,0,0,0,14
1716251,1348030,2023-06-28,Senate,"Senate Appropriations: Re-Reported as Committed",24,0,0,0,24
1716265,1347653,2023-06-27,Senate,"Senate Labor And Industry: Reported as Amended",10,0,1,0,11
1716265,1347654,2023-06-27,Senate,"Senate Labor And Industry: Adopt Amendment A01496",10,0,1,0,11
1716265,1468312,2024-10-08,Senate,"Senate Rules And Executive Nominations: Re-Reported as Amended",17,0,0,0,17
1716265,1468313,2024-10-08,Senate,"Senate Rules And Executive Nominations: Adopt Amendment A05920",11,6,0,0,17
1716265,1468478,2024-10-09,Senate,"Senate Appropriations: Re-Reported as Committed",24,0,0,0,24
1716265,1468573,2024-10-09,Senate,"Senate Floor: SB 365 PN 1944, Final Passage",49,0,0,1,50
1716265,1468739,2024-10-21,House,"House Veterans Affairs And Emergency Preparedness: Report Bill As Committed",25,0,0,0,25
1716265,1468898,2024-10-23,House,"House Floor: SB 365 PN 1944, FINAL PASSAGE",201,1,0,1,203
1716265,1468899,2024-10-23,House,"House Appropriations: Re-report Bill As Committed",37,0,0,0,37
1716336,1362398,2023-12-12,Senate,"Senate Transportation: Adopt Amendment A03266",14,0,0,0,14
1716336,1362399,2023-12-12,Senate,"Senate Transportation: Reported as Amended",14,0,0,0,14
1716440,1348733,2023-06-29,Senate,"Senate Environmental Resources And Energy: Reported as Amended",9,2,0,0,11
1716440,1348734,2023-06-29,Senate,"Senate Environmental Resources And Energy: Adopt Amendment A01610",10,1,0,0,11
1716440,1354897,2023-09-18,Senate,"Senate Floor: SB 382 PN 992, Final Passage",44,1,0,5,50
1716440,1354898,2023-09-18,Senate,"Senate Appropriations: Re-Reported as Committed",22,0,2,0,24
1716582,1316112,2023-05-02,Senate,"Senate Game And Fisheries: Reported as Committed",11,0,0,0,11
1716582,1320342,2023-05-08,Senate,"Senate Floor: SB 411 PN 360, Final Passage",50,0,0,0,50
1716582,1320343,2023-05-08,Senate,"Senate Appropriations: Re-Reported as Committed",24,0,0,0,24
1716582,1357653,2023-11-14,House,"House Game And Fisheries: Report Bill As Committed",24,0,1,0,25
1716685,1354928,2023-09-19,Senate,"Senate State Government: Reported as Amended",7,3,1,0,11
1716685,1354929,2023-09-19,Senate,"Senate State Government: Adopt Amendment A02034",7,3,1,0,11
1716721,1356513,2023-10-25,Senate,"Senate Consumer Protection And Professional Licensure: Reported as Amended A02045",14,0,0,0,14
1716721,1375792,2024-02-05,Senate,"Senate Appropriations: Re-Reported as Committed",23,0,1,0,24
1716721,1378765,2024-02-07,Senate,"Senate Floor: SB 403 PN 1187, Final Passage",48,1,0,1,50
1716721,1439963,2024-05-07,House,"House Professional Licensure: Report Bill As Committed",25,0,0,0,25
1716721,1458899,2024-06-24,House,"House Floor: SB 403 PN 1187, FINAL PASSAGE",178,24,0,1,203
1716721,1458900,2024-06-24,House,"House Appropriations: Re-report Bill As Committed",37,0,0,0,37
1716721,1459792,2024-06-24,House,"House Appropriations: Re-report Bill As Committed",37,0,0,0,37
1716747,1321237,2023-05-09,Senate,"Senate State Government: Reported as Committed",11,0,0,0,11
1716761,1411743,2024-03-20,Senate,"Senate Finance: Reported as Committed",7,4,0,0,11
1716808,1316166,2023-05-02,Senate,"Senate Health And Human Services: Reported as Committed",11,0,0,0,11
1716808,1345354,2023-06-20,Senate,"Senate Appropriations: Re-Reported as Committed",24,0,0,0,24
1716808,1346800,2023-06-22,Senate,"Senate Floor: SB 414 PN 361, Final Passage",48,0,0,2,50
1716808,1357856,2023-11-15,House,"House Health: Report Bill As Committed",24,0,1,0,25
1716808,1362577,2023-12-13,House,"House Floor: SB 414 PN 361, FINAL PASSAGE",203,0,0,0,203
1716808,1362578,2023-12-13,House,"House Appropriations: Re-report Bill As Committed",37,0,0,0,37
1716918,1411968,2024-03-20,Senate,"Senate Game And Fisheries: Reported as Amended",7,4,0,0,11
1716918,1411969,2024-03-20,Senate,"Senate Game And Fisheries: Adopt Amendment A03545",8,3,0,0,11
1716918,1453936,2024-06-05,Senate,"Senate Floor: SB 67 PN 1437, 2023 A4754, ROTHMAN Amendment No. A-4754",43,7,0,0,50
1716918,1462188,2024-07-02,Senate,"Senate Floor: SB 67 PN 1686, 2023 A5382, ROTHMAN Amendment No. A-5382",44,6,0,0,50
1716918,1462189,2024-07-02,Senate,"Senate Appropriations: Re-Reported as Committed",19,5,0,0,24
1716918,1462399,2024-07-03,Senate,"Senate Floor: SB 67 PN 1802, Final Passage",33,17,0,0,50
1716918,1467887,2024-10-01,House,"House Game And Fisheries: Report Bill As Committed",15,10,0,0,25
1716918,1468322,2024-10-08,House,"House Floor: SB 67 PN 1802, 2023 A5876",201,0,0,2,203
1716918,1468432,2024-10-08,House,"House Floor: SB 67 PN 1802, MOTION TO TABLE AMENDMENTS",102,99,0,2,203
1716948,1308338,2023-04-24,Senate,"Senate State Government: Reported as Committed",10,0,1,0,11
1716948,1311254,2023-04-26,Senate,"Senate Floor: SB 402 PN 346, Final Passage",50,0,0,0,50
1716948,1467875,2024-10-01,House,"House State Government: Report Bill As Committed",18,7,0,0,25
1716948,1468528,2024-10-09,House,"House Floor: SB 402 PN 346, FINAL PASSAGE",195,7,0,1,203
1716948,1468529,2024-10-09,House,"House Appropriations: Re-report Bill As Committed",37,0,0,0,37
1720302,1270770,2023-03-08,Senate,"Senate Urban Affairs And Housing: Reported as Committed",7,4,0,0,11
1720302,1317343,2023-05-02,Senate,"Senate Floor: SR 45 PN 367",29,21,0,0,50
1720310,1265361,2023-03-01,Senate,"Senate Education: Reported as Committed",11,0,0,0,11
1720310,1269297,2023-03-06,Senate,"Senate Floor: SR 48 PN 368",50,0,0,0,50
1720442,1264877,2023-03-01,Senate,"Senate Veterans Affairs And Emergency Preparedness: Reported as Committed",11,0,0,0,11
1720442,1308318,2023-04-24,Senate,"Senate Appropriations: Re-Reported as Committed",24,0,0,0,24
1720442,1320009,2023-05-08,Senate,"Senate Floor: SB 447 PN 370, Final Passage",50,0,0,0,50
1720442,1356702,2023-10-31,House,"House Veterans Affairs And Emergency Preparedness: Report Bill As Committed",25,0,0,0,25
1720442,1461896,2024-07-01,House,"House Floor: SB 447 PN 370, 2023 A2823",202,0,0,1,203
1720442,1462177,2024-07-02,House,"House Appropriations: Re-report Bill As Committed",37,0,0,0,37
1720442,1462764,2024-07-09,House,"House Floor: SB 447 PN 1799, FINAL PASSAGE",201,1,0,1,203
1720442,1462868,2024-07-10,Senate,"Senate Floor: SB 447 PN 1799, Concur in House Amendments",49,0,0,1,50
1720442,1462869,2024-07-10,Senate,"Senate Rules And Executive Nominations: Re-Reported as Committed",17,0,0,0,17
1720488,1270733,2023-03-08,Senate,"Senate Veterans Affairs And Emergency Preparedness: Reported as Committed",7,3,0,0,10
1720488,1309756,2023-04-25,Senate,"Senate Floor: SB 433 PN 374, Final Passage",31,19,0,0,50
1720536,1264872,2023-03-01,Senate,"Senate Veterans Affairs And Emergency Preparedness: Reported as Committed",7,4,0,0,11
1720577,1345206,2023-06-19,Senate,"Senate Veterans Affairs And Emergency Preparedness: Reported as Amended",11,0,0,0,11
1720577,1345207,2023-06-19,Senate,"Senate Veterans Affairs And Emergency Preparedness: Adopt Amendment A01042",11,0,0,0,11
1720577,1346745,2023-06-22,Senate,"Senate Floor: SR 46 PN 903",48,0,0,2,50
1721705,1265008,2023-03-01,Senate,"Senate Transportation: Reported as Committed",14,0,0,0,14
1721705,1270079,2023-03-07,Senate,"Senate Floor: SB 443 PN 377, Final Passage",50,0,0,0,50
1721804,1265330,2023-03-01,Senate,"Senate Transportation: Adopt Amendment A00088",14,0,0,0,14
1721804,1265331,2023-03-01,Senate,"Senate Transportation: Reported as Amended",14,0,0,0,14
1721906,1265835,2023-03-01,Senate,"Senate Transportation: Reported as Committed",14,0,0,0,14
1721906,1320882,2023-05-09,Senate,"Senate Appropriations: Re-Reported as Committed",22,1,1,0,24
1721906,1338801,2023-06-05,Senate,"Senate Floor: SB 453 PN 378, Final Passage",48,1,0,1,50
1721906,1458967,2024-06-24,House,"House Judiciary: Adopt Amendment A05026",15,10,0,0,25
1721906,1458968,2024-06-24,House,"House Judiciary: Adopt Amendment A05066",25,0,0,0,25
1721906,1458969,2024-06-24,House,"House Judiciary: Report Bill As Amended",14,11,0,0,25
1723409,1266020,2023-03-01,House,"House Floor: HR 1 PN 2",102,100,0,0,202
1723557,1264830,2023-03-01,House,"House Floor: HR 9 PN 3, MOTION TO POSTPONE",99,102,0,1,202
1723557,1264831,2023-03-01,House,"House Floor: HR 9 PN 3",102,100,0,0,202
1723698,1309334,2023-04-25,Senate,"Senate Law And Justice: Reported as Committed",11,0,0,0,11
1723698,1338757,2023-06-05,Senate,"Senate Appropriations: Re-Reported as Committed",23,1,0,0,24
1723698,1340694,2023-06-07,Senate,"Senate Floor: SB 429 PN 855, Final Passage",49,1,0,0,50
1723698,1357714,2023-11-15,House,"House Labor And Industry: Report Bill As Committed",25,0,0,0,25
1723698,1362425,2023-12-12,House,"House Appropriations: Re-report Bill As Committed",37,0,0,0,37
1723698,1362467,2023-12-12,House,"House Floor: SB 429 PN 855, FINAL PASSAGE",201,2,0,0,203
1723785,1362806,2023-12-13,House,"House Local Government: Report Bill As Committed",22,3,0,0,25
1723824,1362804,2023-12-13,House,"House Local Government: Report Bill As Committed",22,3,0,0,25
1723824,1362805,2023-12-13,House,"House Local Government: Adopt Amendment A03273",10,15,0,0,25
1723866,1265214,2023-03-01,House,"House Judiciary: Report Bill As Committed",12,9,0,0,21
1723866,1268948,2023-03-06,House,"House Floor: HB 2 PN 5, 2023 A149",85,116,0,1,202
1723866,1269779,2023-03-07,House,"House Floor: HB 2 PN 5, FINAL PASSAGE",134,67,0,1,202
1723866,1269835,2023-03-07,House,"House Appropriations: Report Bill As Committed",23,14,0,0,37
1723987,1330527,2023-05-23,House,"House Tourism And Economic And Recreational Development: Report Bill As Committed",20,0,1,0,21
1724026,1270821,2023-03-08,Senate,"Senate Urban Affairs And Housing: Reported as Committed",11,0,0,0,11
1724026,1308254,2023-04-24,Senate,"Senate Appropriations: Re-Reported as Committed",24,0,0,0,24
1724026,1309630,2023-04-25,Senate,"Senate Floor: SB 466 PN 384, Final Passage",50,0,0,0,50
1724026,1331847,2023-05-24,House,"House Housing And Community Development: Bring Up The Bill For Consideration",21,0,0,0,21
1724234,1346008,2023-06-21,House,"House Education: Adopt Amendment A01127",21,0,0,0,21
1724234,1346009,2023-06-21,House,"House Education: Report Bill As Amended",21,0,0,0,21
1724234,1348706,2023-06-29,House,"House Rules: Re-report Bill As Committed",33,0,0,0,33
1724234,1349697,2023-07-06,House,"House Floor: HB 27 PN 1639, FINAL PASSAGE",203,0,0,0,203
1724234,1349698,2023-07-06,House,"House Appropriations: Re-report Bill As Committed",37,0,0,0,37
1724234,1354881,2023-09-18,Senate,"Senate Education: Reported as Amended",11,0,0,0,11
1724234,1354882,2023-09-18,Senate,"Senate Education: Adopt Amendment A02013",11,0,0,0,11
1724234,1354914,2023-09-19,Senate,"Senate Floor: HB 27 PN 1987, 2023 A2052, REGAN Amendment No. A-2052",46,0,0,4,50
1724234,1354915,2023-09-19,Senate,"Senate Floor: HB 27 PN 1987, 2023 A2046, COSTA Amendment No. A-2046",45,1,0,4,50
1724234,1355001,2023-09-20,Senate,"Senate Floor: HB 27 PN 2004, Final Passage",47,0,0,3,50
1724234,1355002,2023-09-20,Senate,"Senate Appropriations: Re-Reported as Committed",17,6,1,0,24
1724234,1355769,2023-10-04,House,"House Floor: HB 27 PN 2106, CONCURRENCE",106,97,0,0,203
1724234,1355770,2023-10-04,House,"House Rules: Adopt Amendment A02429",18,15,0,0,33
1724234,1355771,2023-10-04,House,"House Rules: Re-report Bill As Amended",18,15,0,0,33
1724272,1265213,2023-03-01,House,"House Judiciary: Report Bill As Committed",12,9,0,0,21
1724272,1303839,2023-04-18,House,"House Judiciary: Re-report Bill As Committed",14,7,0,0,21
1724272,1308594,2023-04-24,House,"House Floor: HB 1 PN 4, 2023 A158, MOTION TO APPEAL RULING OF THE CHAIR",101,100,0,0,201
1724272,1308595,2023-04-24,House,"House Floor: HB 1 PN 4, 2023 A157, MOTION TO APPEAL RULING OF THE CHAIR",101,100,0,0,201
1724272,1309550,2023-04-25,House,"House Floor: HB 1 PN 4, FINAL PASSAGE",147,54,0,0,201
1724272,1309551,2023-04-25,House,"House Appropriations: Re-report Bill As Committed",36,1,0,0,37
1725017,1356021,2023-10-16,House,"House Children And Youth: Report Bill As Committed",25,0,0,0,25
1725161,1459820,2024-06-25,House,"House Agriculture And Rural Affairs: Adopt Amendment A04846",25,0,0,0,25
1725161,1459821,2024-06-25,House,"House Agriculture And Rural Affairs: Report Bill As Amended",24,1,0,0,25
1725184,1311080,2023-04-26,House,"House Liquor Control: Report Bill As Committed",21,0,0,0,21
1725184,1316380,2023-05-02,House,"House Floor: HB 38 PN 27, FINAL PASSAGE",201,0,0,0,201
1725184,1316381,2023-05-02,House,"House Appropriations: Re-report Bill As Committed",22,1,14,0,37
1725184,1356127,2023-10-17,Senate,"Senate Law And Justice: Reported as Committed",11,0,0,0,11
1725184,1362147,2023-12-11,Senate,"Senate Appropriations: Re-Reported as Committed",24,0,0,0,24
1725184,1362463,2023-12-12,Senate,"Senate Floor: HB 38 PN 27, Final Passage",49,1,0,0,50
1725463,1308233,2023-04-24,House,"House Judiciary: Report Bill As Committed",21,0,0,0,21
1725537,1356053,2023-10-16,House,"House Transportation: Adopt Amendment A02491",25,0,0,0,25
1725537,1356054,2023-10-16,House,"House Transportation: Report Bill As Amended",25,0,0,0,25
1725537,1356673,2023-10-30,House,"House Floor: HB 73 PN 2125, FINAL PASSAGE",202,0,0,1,203
1725537,1356674,2023-10-30,House,"House Appropriations: Re-report Bill As Committed",37,0,0,0,37
1725537,1378259,2024-02-07,Senate,"Senate Transportation: Reported as Committed",13,0,1,0,14
1725537,1460298,2024-06-26,Senate,"Senate Appropriations: Re-Reported as Committed",23,0,1,0,24
1725537,1461006,2024-06-27,Senate,"Senate Floor: HB 73 PN 2125, Final Passage",49,0,0,1,50
1725607,1343968,2023-06-14,House,"House Health: Report Bill As Amended",18,3,0,0,21
1725607,1343969,2023-06-14,House,"House Health: Adopt Amendment A00165",21,0,0,0,21
1725607,1343970,2023-06-14,House,"House Health: Adopt Amendment A00936",20,1,0,0,21
1725607,1346098,2023-06-21,House,"House Rules: Re-report Bill As Committed",33,0,0,0,33
1725607,1346443,2023-06-22,House,"House Floor: HB 78 PN 1591, 2023 A1200",203,0,0,0,203
1725607,1347421,2023-06-26,House,"House Floor: HB 78 PN 1675, FINAL PASSAGE",114,89,0,0,203
1725607,1347422,2023-06-26,House,"House Appropriations: Re-report Bill As Committed",22,15,0,0,37
1726001,1348145,2023-06-28,House,"House State Government: Report Bill As Committed",21,0,0,0,21
1726001,1416226,2024-03-27,House,"House Rules: Re-report Bill As Committed",33,0,0,0,33
1726001,1421863,2024-04-08,House,"House Floor: HB 71 PN 60, FINAL PASSAGE",201,0,0,1,202
1726001,1421864,2024-04-08,House,"House Appropriations: Re-report Bill As Committed",37,0,0,0,37
1726001,1467866,2024-10-01,Senate,"Senate State Government: Reported as Committed",11,0,0,0,11
1726001,1468841,2024-10-22,Senate,"Senate Appropriations: Re-Reported as Committed",24,0,0,0,24
1726057,1339534,2023-06-06,House,"House Agriculture And Rural Affairs: Adopt Amendment A00705",21,0,0,0,21
1726057,1339535,2023-06-06,House,"House Agriculture And Rural Affairs: Report Bill As Amended",21,0,0,0,21
1726057,1345843,2023-06-21,House,"House Rules: Re-report Bill As Committed",33,0,0,0,33
1726057,1346914,2023-06-22,House,"House Floor: HB 72 PN 1455, FINAL PASSAGE",203,0,0,0,203
1726057,1346915,2023-06-22,House,"House Appropriations: Re-report Bill As Committed",37,0,0,0,37
1726261,1452852,2024-06-03,House,"House Judiciary: Report Bill As Committed",25,0,0,0,25
1726742,1339655,2023-06-06,Senate,"Senate Education: Reported as Amended",9,2,0,0,11
1726742,1339656,2023-06-06,Senate,"Senate Education: Adopt Amendment A00778",10,1,0,0,11
1726844,1461929,2024-07-01,Senate,"Senate Consumer Protection And Professional Licensure: Reported as Amended",9,5,0,0,14
1726844,1461930,2024-07-01,Senate,"Senate Consumer Protection And Professional Licensure: Adopt Amendment A05357",8,6,0,0,14
1726844,1462164,2024-07-02,Senate,"Senate Appropriations: Re-Reported as Committed",15,9,0,0,24
1727360,1317465,2023-05-03,House,"House Judiciary: Re-refer Bill To Another Committee",20,0,1,0,21
1727360,1344646,2023-06-14,House,"House Local Government: Report Bill As Committed",21,0,0,0,21
1727528,1459009,2024-06-24,House,"House Education: Report Bill As Amended",13,12,0,0,25
1727528,1459010,2024-06-24,House,"House Education: Adopt Amendment A05039",25,0,0,0,25
1727593,1270757,2023-03-08,Senate,"Senate Veterans Affairs And Emergency Preparedness: Reported as Committed",10,0,0,0,10
1727755,1303826,2023-04-18,House,"House Judiciary: Report Bill As Amended",14,7,0,0,21
1727755,1303827,2023-04-18,House,"House Judiciary: Adopt Amendment A00202",21,0,0,0,21
1727755,1330327,2023-05-23,House,"House Floor: HB 95 PN 957, 2023 A276",100,101,0,0,201
1727755,1330328,2023-05-23,House,"House Floor: HB 95 PN 957, 2023 A278",94,107,0,0,201
1727755,1330329,2023-05-23,House,"House Floor: HB 95 PN 957, 2023 A279",92,109,0,0,201
1727755,1330330,2023-05-23,House,"House Floor: HB 95 PN 957, 2023 A281",100,101,0,0,201
1727755,1331766,2023-05-24,House,"House Appropriations: Re-report Bill As Committed",32,5,0,0,37
1727755,1332666,2023-05-24,House,"House Floor: HB 95 PN 957, FINAL PASSAGE",122,79,0,0,201
1727755,1362265,2023-12-11,Senate,"Senate Judiciary: Reported as Committed",13,0,1,0,14
1727839,1416303,2024-03-27,House,"House Labor And Industry: To Table",11,14,0,0,25
1727839,1416304,2024-03-27,House,"House Labor And Industry: Adopt Amendment A03805",14,11,0,0,25
1727839,1416305,2024-03-27,House,"House Labor And Industry: Adopt Amendment A03742",11,14,0,0,25
1727839,1416306,2024-03-27,House,"House Labor And Industry: Report Bill As Amended",14,11,0,0,25
1727839,1436709,2024-04-30,House,"House Labor And Industry: Adopt Amendment A03747",11,14,0,0,25
1727839,1439456,2024-05-06,House,"House Floor: HB 98 PN 2819, FINAL PASSAGE",102,99,0,1,202
1727839,1439457,2024-05-06,House,"House Appropriations: Re-report Bill As Committed",22,15,0,0,37
1727839,1441677,2024-03-27,House,"House Labor And Industry: Adopt Amendment A03747",11,14,0,0,25
1728139,1270732,2023-03-08,Senate,"Senate Veterans Affairs And Emergency Preparedness: Reported as Committed",10,0,0,0,10
1728527,1308195,2023-04-24,House,"House Education: Adopt Amendment A00262",21,0,0,0,21
1728527,1308196,2023-04-24,House,"House Education: Report Bill As Amended",12,9,0,0,21
1728527,1315736,2023-05-01,House,"House Floor: HB 100 PN 965, 2023 A362",201,0,0,0,201
1728527,1315737,2023-05-01,House,"House Floor: HB 100 PN 965, 2023 A315",100,101,0,0,201
1728527,1316983,2023-05-02,House,"House Floor: HB 100 PN 1093, FINAL PASSAGE",141,60,0,0,201
1728527,1316984,2023-05-02,House,"House Appropriations: Re-report Bill As Committed",22,15,0,0,37
1728527,1339287,2023-06-06,Senate,"Senate Education: Reported as Committed",8,3,0,0,11
1728940,1317661,2023-05-03,House,"House Commerce: Re-refer Bill To Another Committee",21,0,0,0,21
1728940,1317662,2023-05-03,House,"House Commerce: Bring Up The Bill For Consideration",21,0,0,0,21
1728940,1446163,2024-05-21,House,"House Housing And Community Development: Report Bill As Amended",25,0,1,0,26
1728940,1446164,2024-05-21,House,"House Housing And Community Development: Adopt Amendment A04499",25,0,1,0,26
1728940,1461146,2024-06-27,House,"House Floor: HB 126 PN 3133, 2023 A5224",202,0,0,1,203
1728940,1461147,2024-06-27,House,"House Appropriations: Re-report Bill As Committed",37,0,0,0,37
1728940,1461372,2024-06-28,House,"House Floor: HB 126 PN 3434, FINAL PASSAGE",192,10,0,1,203
1728940,1467861,2024-10-01,Senate,"Senate Urban Affairs And Housing: Reported as Committed",9,1,1,0,11
1728989,1455729,2024-06-10,House,"House Transportation: Report Bill As Committed",25,0,0,0,25
1728989,1461908,2024-07-01,House,"House Rules: Re-report Bill As Committed",33,0,0,0,33
1728989,1462181,2024-07-02,House,"House Floor: HB 127 PN 110, FINAL PASSAGE",122,79,0,2,203
1728989,1462182,2024-07-02,House,"House Appropriations: Re-report Bill As Committed",37,0,0,0,37
1729373,1308168,2023-04-24,House,"House Transportation: Report Bill As Amended",21,0,0,0,21
1729373,1308169,2023-04-24,House,"House Transportation: Adopt Amendment A00269",21,0,0,0,21
1729373,1330354,2023-05-23,House,"House Appropriations: Re-report Bill As Committed",37,0,0,0,37
1729373,1331389,2023-05-23,House,"House Floor: HB 134 PN 961, FINAL PASSAGE",178,23,0,0,201
1729373,1454013,2024-06-05,Senate,"Senate Transportation: Reported as Committed",14,0,0,0,14
1729390,1315295,2023-05-01,House,"House Veterans Affairs And Emergency Preparedness: Report Bill As Committed",21,0,0,0,21
1729422,1344545,2023-06-14,House,"House Local Government: Adopt Amendment A01013",21,0,0,0,21
1729422,1344546,2023-06-14,House,"House Local Government: Report Bill As Amended",21,0,0,0,21
1729422,1348612,2023-06-29,House,"House Rules: Re-report Bill As Committed",33,0,0,0,33
1729422,1355481,2023-10-02,House,"House Floor: HB 123 PN 1593, 2023 A1487",200,3,0,0,203
1729422,1355482,2023-10-02,House,"House Floor: HB 123 PN 1593, 2023 A1522",203,0,0,0,203
1729422,1355567,2023-10-03,House,"House Floor: HB 123 PN 2075, FINAL PASSAGE",106,97,0,0,203
1729422,1355724,2023-10-03,House,"House Appropriations: Re-report Bill As Committed",37,0,0,0,37
1729517,1303850,2023-04-18,House,"House Judiciary: Report Bill As Amended",21,0,0,0,21
1729517,1303851,2023-04-18,House,"House Judiciary: Adopt Amendment A00213",21,0,0,0,21
1729517,1315510,2023-05-01,House,"House Floor: HB 115 PN 958, FINAL PASSAGE",201,0,0,0,201
1729517,1315511,2023-05-01,House,"House Appropriations: Re-report Bill As Committed",37,0,0,0,37
1729517,1461980,2024-07-01,Senate,"Senate Judiciary: Reported as Committed",14,0,0,0,14
1729517,1463005,2024-07-11,Senate,"Senate Floor: HB 115 PN 958, Final Passage",49,0,0,1,50
1729517,1463006,2024-07-11,Senate,"Senate Appropriations: Re-Reported as Committed",23,0,1,0,24
1729645,1317655,2023-05-03,House,"House Commerce: Bring Up The Bill For Consideration",21,0,0,0,21
1729645,1317656,2023-05-03,House,"House Commerce: Re-refer Bill To Another Committee",21,0,0,0,21
1729645,1467773,2024-09-30,House,"House Consumer Protection, Technology And Utilities: Adopt Amendment A05628",24,1,0,0,25
1729645,1467774,2024-09-30,House,"House Consumer Protection, Technology And Utilities: Report Bill As Amended",24,1,0,0,25
1729645,1468482,2024-10-09,House,"House Floor: HB 116 PN 3677, 2023 A5791",202,0,0,1,203
1729645,1468483,2024-10-09,House,"House Floor: HB 116 PN 3677, 2023 A5814",99,103,0,1,203
1729645,1468762,2024-10-21,House,"House Floor: HB 116 PN 3755, FINAL PASSAGE",202,0,0,1,203
1729645,1468763,2024-10-21,House,"House Appropriations: Re-report Bill As Committed",37,0,0,0,37
1729691,1415183,2024-03-26,House,"House Transportation: Report Bill As Amended",25,0,0,0,25
1729691,1415184,2024-03-26,House,"House Transportation: Adopt Amendment A03791",25,0,0,0,25
1729691,1428665,2024-04-16,House,"House Floor: HB 105 PN 2806, FINAL PASSAGE",201,0,0,1,202
1729691,1428666,2024-04-16,House,"House Appropriations: Re-report Bill As Committed",37,0,0,0,37
1729703,1355501,2023-10-03,House,"House Consumer Protection, Technology And Utilities: Adopt Amendment A02076",25,0,0,0,25
1729703,1355502,2023-10-03,House,"House Consumer Protection, Technology And Utilities: Report Bill As Amended",25,0,0,0,25
1729703,1356035,2023-10-16,House,"House Floor: HB 109 PN 2084, 2023 A2425",203,0,0,0,203
1729703,1356036,2023-10-16,House,"House Floor: HB 109 PN 2084, 2023 A2478, GERMANENESS OF AMENDMENT",100,103,0,0,203
1729703,1356037,2023-10-16,House,"House Floor: HB 109 PN 2084, 2023 A2480, GERMANENESS OF AMENDMENT",101,102,0,0,203
1729703,1356153,2023-10-17,House,"House Floor: HB 109 PN 2140, FINAL PASSAGE",203,0,0,0,203
1729703,1356154,2023-10-17,House,"House Appropriations: Re-report Bill As Committed",37,0,0,0,37
1729703,1456693,2024-06-12,Senate,"Senate Consumer Protection And Professional Licensure: Reported as Committed",12,0,2,0,14
1729703,1459836,2024-06-25,Senate,"Senate Appropriations: Re-Reported as Committed",24,0,0,0,24
1729703,1460799,2024-06-26,Senate,"Senate Floor: HB 109 PN 2140, Final Passage",46,4,0,0,50
1729969,1339167,2023-06-06,Senate,"Senate Judiciary: Adopt Amendment A00783",13,0,1,0,14
1729969,1339168,2023-06-06,Senate,"Senate Judiciary: Adopt Amendment A00789",13,0,1,0,14
1729969,1339169,2023-06-06,Senate,"Senate Judiciary: Reported as Amended",13,0,1,0,14
1729969,1346883,2023-06-22,Senate,"Senate Appropriations: Re-Reported as Committed",24,0,0,0,24
1729969,1347444,2023-06-26,Senate,"Senate Floor: SB 506 PN 843, Final Passage",49,0,0,1,50
1729969,1348923,2023-06-29,House,"House Judiciary: Report Bill As Committed",21,0,0,0,21
1729969,1362532,2023-12-13,House,"House Floor: SB 506 PN 843, FINAL PASSAGE",203,0,0,0,203
1729969,1362533,2023-12-13,House,"House Appropriations: Re-report Bill As Committed",37,0,0,0,37
1730450,1300303,2023-04-13,House,"House Education: Adopt Amendment A00195",21,0,0,0,21
1730450,1300304,2023-04-13,House,"House Education: Report Bill As Amended A00195",17,4,0,0,21
1730450,1311119,2023-04-26,House,"House Floor: HB 148 PN 955, FINAL PASSAGE",158,43,0,0,201
1730450,1311120,2023-04-26,House,"House Appropriations: Re-report Bill As Committed",37,0,0,0,37
1730663,1310640,2023-04-25,House,"House Finance: Adopt Amendment A00292",18,0,3,0,21
1730663,1350574,2023-04-25,House,"House Finance: Bring Up The Bill For Consideration",21,0,4,0,25
1730713,1292907,2023-04-04,House,"House Health: Report Bill As Amended",21,0,0,0,21
1730713,1292908,2023-04-04,House,"House Health: Adopt Amendment A00172",21,0,0,0,21
1730713,1306532,2023-03-29,House,"House Health: Report Bill As Amended",21,0,0,0,21
1730713,1306533,2023-03-29,House,"House Health: Adopt Amendment A00172",21,0,0,0,21
1730713,1310835,2023-04-26,House,"House Floor: HB 155 PN 951, FINAL PASSAGE",201,0,0,0,201
1730713,1310836,2023-04-26,House,"House Appropriations: Re-report Bill As Committed",37,0,0,0,37
1730713,1467939,2024-10-01,Senate,"Senate Health And Human Services: Reported as Committed",10,0,1,0,11
1730713,1468258,2024-10-07,Senate,"Senate Appropriations: Re-Reported as Committed",23,0,1,0,24
1730713,1468444,2024-10-08,Senate,"Senate Floor: HB 155 PN 951, Final Passage",50,0,0,0,50
1730739,1339498,2023-06-06,House,"House Labor And Industry: Adopt Amendment A00756",11,10,0,0,21
1730739,1339499,2023-06-06,House,"House Labor And Industry: Adopt Amendment A00757",9,12,0,0,21
1730739,1339500,2023-06-06,House,"House Labor And Industry: Report Bill As Amended",11,10,0,0,21
1730739,1362378,2023-12-12,House,"House Floor: HB 181 PN 1461, 2023 A893",100,103,0,0,203
1730739,1362379,2023-12-12,House,"House Floor: HB 181 PN 1461, 2023 A895",101,102,0,0,203
1730739,1362380,2023-12-12,House,"House Floor: HB 181 PN 1461, 2023 A905",101,102,0,0,203
1730739,1362381,2023-12-12,House,"House Floor: HB 181 PN 1461, 2023 A907",101,102,0,0,203
1730739,1362382,2023-12-12,House,"House Floor: HB 181 PN 1461, 2023 A908",101,102,0,0,203
1730739,1362383,2023-12-12,House,"House Floor: HB 181 PN 1461, 2023 A911",101,102,0,0,203
1730739,1362384,2023-12-12,House,"House Floor: HB 181 PN 1461, 2023 A918",101,102,0,0,203
1730739,1362385,2023-12-12,House,"House Floor: HB 181 PN 1461, 2023 A929, GERMANENESS OF AMENDMENT",101,102,0,0,203
1730739,1362386,2023-12-12,House,"House Floor: HB 181 PN 1461, 2023 A3212",101,102,0,0,203
1730739,1362387,2023-12-12,House,"House Floor: HB 181 PN 1461, 2023 A3247",109,94,0,0,203
1730739,1362388,2023-12-12,House,"House Rules: Re-report Bill As Committed",18,15,0,0,33
1730739,1362573,2023-12-13,House,"House Appropriations: Adopt Amendment A03335",22,15,0,0,37
1730739,1362574,2023-12-13,House,"House Appropriations: Re-report Bill As Amended",22,15,0,0,37
1730865,1309571,2023-04-25,House,"House Agriculture And Rural Affairs: Adopt Amendment A00234",21,0,0,0,21
1730865,1309572,2023-04-25,House,"House Agriculture And Rural Affairs: Report Bill As Amended",21,0,0,0,21
1730865,1316461,2023-05-02,House,"House Floor: HB 157 PN 1030, FINAL PASSAGE",201,0,0,0,201
1730865,1316462,2023-05-02,House,"House Appropriations: Re-report Bill As Committed",22,15,0,0,37
1730865,1339325,2023-06-06,Senate,"Senate Agriculture And Rural Affairs: Reported as Committed",11,0,0,0,11
1730865,1356386,2023-10-23,Senate,"Senate Floor: HB 157 PN 1030, Final Passage",46,4,0,0,50
1730865,1356387,2023-10-23,Senate,"Senate Appropriations: Re-Reported as Committed",24,0,0,0,24
1730893,1311086,2023-04-26,House,"House Liquor Control: Report Bill As Committed",21,0,0,0,21
1730893,1316383,2023-05-02,House,"House Floor: HB 198 PN 156, FINAL PASSAGE",151,50,0,0,201
1730893,1316384,2023-05-02,House,"House Appropriations: Re-report Bill As Committed",22,15,0,0,37
1730911,1309710,2023-04-25,House,"House Agriculture And Rural Affairs: Adopt Amendment A00272",21,0,0,0,21
1730911,1309711,2023-04-25,House,"House Agriculture And Rural Affairs: Report Bill As Amended",20,1,0,0,21
1730911,1317435,2023-05-03,House,"House Appropriations: Re-report Bill As Committed",37,0,0,0,37
1730911,1317867,2023-05-03,House,"House Floor: HB 156 PN 1029, FINAL PASSAGE",201,0,0,0,201
1730911,1339044,2023-06-06,Senate,"Senate Agriculture And Rural Affairs: Reported as Committed",11,0,0,0,11
1730911,1356373,2023-10-23,Senate,"Senate Floor: HB 156 PN 1029, Final Passage",50,0,0,0,50
1730911,1356374,2023-10-23,Senate,"Senate Appropriations: Re-Reported as Committed",24,0,0,0,24
1731097,1362488,2023-12-13,House,"House Finance: Re-report Bill As Amended",25,0,0,0,25
1731097,1362489,2023-12-13,House,"House Finance: Re-report Bill As Amended",24,1,0,0,25
1731283,1357794,2023-11-15,House,"House Local Government: Report Bill As Committed",21,4,0,0,25
1731552,1349899,2023-07-06,House,"House Judiciary: Re-refer Bill To Another Committee",21,0,0,0,21
1731772,1441438,2024-05-08,House,"House Appropriations: Re-report Bill As Committed",22,15,0,0,37
1731862,1356735,2023-10-31,House,"House Veterans Affairs And Emergency Preparedness: Report Bill As Committed",25,0,0,0,25
1731950,1348142,2023-06-28,House,"House State Government: Report Bill As Committed",21,0,0,0,21
1731950,1355469,2023-10-02,House,"House Floor: HB 251 PN 214, 2023 A2069, MOTION TO APPEAL RULING OF THE CHAIR",102,101,0,0,203
1731950,1355470,2023-10-02,House,"House Floor: HB 251 PN 214, 2023 A1376, MOTION TO APPEAL RULING OF THE CHAIR",102,101,0,0,203
1731950,1355471,2023-10-02,House,"House Rules: Re-report Bill As Committed",33,0,0,0,33
1731950,1355562,2023-10-03,House,"House Floor: HB 251 PN 214, FINAL PASSAGE",203,0,0,0,203
1731950,1355729,2023-10-03,House,"House Appropriations: Re-report Bill As Committed",37,0,0,0,37
1731997,1415247,2024-03-19,House,"House Environmental Resources And Energy: Adopt Amendment A03646",14,11,0,0,25
1731997,1415248,2024-03-19,House,"House Environmental Resources And Energy: Report Bill As Amended",14,11,0,0,25
1731997,1427145,2024-04-15,House,"House Floor: HB 254 PN 2740, 2023 A3985",99,102,0,1,202
1731997,1427908,2024-04-16,House,"House Floor: HB 254 PN 2740, FINAL PASSAGE",102,99,0,1,202
1731997,1427909,2024-04-16,House,"House Appropriations: Re-report Bill As Committed",22,15,0,0,37
1732019,1318454,2023-05-03,House,"House Local Government: Report Bill As Committed",21,0,0,0,21
1732019,1332296,2023-05-24,House,"House Floor: HB 246 PN 209, FINAL PASSAGE",160,41,0,0,201
1732019,1332297,2023-05-24,House,"House Appropriations: Re-report Bill As Committed",37,0,0,0,37
1732051,1348070,2023-06-28,House,"House State Government: Report Bill As Amended",21,0,0,0,21
1732051,1348071,2023-06-28,House,"House State Government: Adopt Amendment A01491",21,0,0,0,21
1732062,1332518,2023-05-24,House,"House Housing And Community Development: Bring Up The Bill For Consideration as Amended",21,0,0,0,21
1732062,1332519,2023-05-24,House,"House Housing And Community Development: Adopt Amendment A00641",21,0,0,0,21
1732062,1340837,2023-06-07,House,"House Appropriations: Adopt Amendment A00864",37,0,0,0,37
1732062,1340838,2023-06-07,House,"House Appropriations: Re-report Bill As Amended",37,0,0,0,37
1732062,1343667,2023-06-13,House,"House Floor: HB 255 PN 1479, FINAL PASSAGE",124,79,0,0,203
1732249,1348698,2023-06-29,House,"House Transportation: Report Bill As Committed",21,0,0,0,21
1732249,1355248,2023-09-27,House,"House Floor: HB 250 PN 213, FINAL PASSAGE",202,0,0,0,202
1732249,1355249,2023-09-27,House,"House Appropriations: Re-report Bill As Committed",37,0,0,0,37
1732249,1362433,2023-12-12,Senate,"Senate Transportation: Reported as Committed",14,0,0,0,14
1732258,1329643,2023-05-22,House,"House Health: Report Bill As Committed",21,0,0,0,21
1732258,1344083,2023-06-14,House,"House Floor: HR 33 PN 273",202,1,0,0,203
1732277,1452945,2024-06-03,House,"House Agriculture And Rural Affairs: Report Bill As Committed",24,0,1,0,25
1732326,1318654,2023-05-03,House,"House Tourism And Economic And Recreational Development: Report Bill as Committed",13,0,8,0,21
1732373,1330344,2023-05-23,House,"House Veterans Affairs And Emergency Preparedness: Adopt Amendment A00556",21,0,0,0,21
1732373,1330345,2023-05-23,House,"House Veterans Affairs And Emergency Preparedness: Report Bill As Amended",21,0,0,0,21
1732373,1343075,2023-06-12,House,"House Floor: HB 269 PN 1300, FINAL PASSAGE",203,0,0,0,203
1732373,1343076,2023-06-12,House,"House Appropriations: Re-report Bill As Committed",37,0,0,0,37
1732373,1356468,2023-10-24,Senate,"Senate Veterans Affairs And Emergency Preparedness: Reported as Amended",10,0,0,0,10
1732373,1356469,2023-10-24,Senate,"Senate Veterans Affairs And Emergency Preparedness: Adopt Amendment A02640",10,0,0,0,10
1732373,1362301,2023-12-11,Senate,"Senate Appropriations: Re-Reported as Committed",24,0,0,0,24
1732373,1468443,2024-10-08,Senate,"Senate Floor: HB 269 PN 2187, Final Passage",50,0,0,0,50
1732373,1468453,2024-10-09,House,"House Rules: Re-report Bill As Committed",33,0,0,0,33
1732373,1468568,2024-10-09,House,"House Floor: HB 269 PN 2187, CONCURRENCE",202,0,0,1,203
1732384,1422362,2024-04-09,House,"House State Government: Adopt Amendment A03915",25,0,0,0,25
1732384,1422363,2024-04-09,House,"House State Government: Report Bill As Amended",14,11,0,0,25
1732395,1339634,2023-06-05,House,"House State Government: Report Bill As Committed",12,9,0,0,21
1733024,1339040,2023-06-05,House,"House State Government: Report Bill As Committed",12,9,0,0,21
1733106,1300234,2023-04-13,House,"House Education: Adopt Amendment A00196",21,0,0,0,21
1733106,1300235,2023-04-13,House,"House Education: Report Bill As Amended A00196",21,0,0,0,21
1733106,1309762,2023-04-25,House,"House Floor: HB 301 PN 954, 2023 A283",201,0,0,0,201
1733106,1309763,2023-04-25,House,"House Floor: HB 301 PN 954, 2023 A286",201,0,0,0,201
1733106,1311142,2023-04-26,House,"House Floor: HB 301 PN 1035, FINAL PASSAGE",201,0,0,0,201
1733106,1311143,2023-04-26,House,"House Appropriations: Re-report Bill As Committed",37,0,0,0,37
1733106,1339191,2023-06-06,Senate,"Senate Education: Reported as Committed",11,0,0,0,11
1733106,1357633,2023-11-14,Senate,"Senate Appropriations: Motion to Table Amendment A02952 to House Bill 301",15,9,0,0,24
1733106,1357634,2023-11-14,Senate,"Senate Appropriations: Adopt Amendment A03007",21,3,0,0,24
1733106,1357635,2023-11-14,Senate,"Senate Appropriations: Re-Reported as Amended",22,2,0,0,24
1733106,1357709,2023-11-15,House,"House Floor: HB 301 PN 2326, MOTION TO REVERT PRIOR PRINTERS NUMBER",101,102,0,0,203
1733106,1357710,2023-11-15,Senate,"Senate Floor: HB 301 PN 2311, Final Passage",45,5,0,0,50
1733106,1357711,2023-11-15,House,"House Rules: Adopt Amendment A03036",18,15,0,0,33
1733106,1357712,2023-11-15,House,"House Rules: Re-report Bill As Amended",18,15,0,0,33
1733106,1357765,2023-11-15,House,"House Floor: HB 301 PN 2326, CONCURRENCE",102,101,0,0,203
1733106,1362522,2023-12-13,House,"House Floor: HB 301 PN 2311, CONCURRENCE",175,28,0,0,203
1733106,1362523,2023-12-13,House,"House Rules: Re-report Bill As Committed",33,0,0,0,33
1733106,1362524,2023-12-13,Senate,"Senate Rules And Executive Nominations: Motion to Revert to Prior Printer Number 2311",17,0,0,0,17
1733106,1362525,2023-12-13,Senate,"Senate Rules And Executive Nominations: Re-Reported as Committed",16,1,0,0,17
1733106,1362646,2023-12-13,Senate,"Senate Floor: HB 301 PN 2311, Concur in House Amendments to Senate Amendments as Amended",43,7,0,0,50
1733146,1357542,2023-11-14,House,"House State Government: Report Bill As Committed",24,1,0,0,25
1733209,1308343,2023-04-24,Senate,"Senate State Government: Reported as Committed",10,0,1,0,11
1733294,1308215,2023-04-24,House,"House Labor And Industry: Adopt Amendment A00258",21,0,0,0,21
1733294,1308216,2023-04-24,House,"House Labor And Industry: Adopt Amendment A00176",9,12,0,0,21
1733294,1308217,2023-04-24,House,"House Labor And Industry: Report Bill As Amended",13,8,0,0,21
1733294,1315262,2023-05-01,House,"House Floor: HB 299 PN 962, 2023 A304",90,111,0,0,201
1733294,1315263,2023-05-01,House,"House Floor: HB 299 PN 962, 2023 A313",92,109,0,0,201
1733294,1315264,2023-05-01,House,"House Floor: HB 299 PN 962, 2023 A316",100,101,0,0,201
1733294,1315265,2023-05-01,House,"House Floor: HB 299 PN 962, 2023 A318",96,105,0,0,201
1733294,1315266,2023-05-01,House,"House Floor: HB 299 PN 962, 2023 A319",93,108,0,0,201
1733294,1316056,2023-05-02,House,"House Appropriations: Re-report Bill As Committed",22,1,14,0,37
1733294,1316687,2023-05-02,House,"House Floor: HB 299 PN 962, FINAL PASSAGE",116,85,0,0,201
1733434,1319304,2023-05-03,House,"House Local Government: Adopt Amendment A00444",8,13,0,0,21
1733434,1319305,2023-05-03,House,"House Local Government: Report Bill As Committed",19,2,0,0,21
1733434,1339067,2023-06-05,House,"House Floor: HB 298 PN 254, 2023 A520",101,102,0,0,203
1733434,1339068,2023-06-05,House,"House Floor: HB 298 PN 254, 2023 A644",101,102,0,0,203
1733434,1339723,2023-06-06,House,"House Floor: HB 298 PN 254, FINAL PASSAGE",126,77,0,0,203
1733434,1340404,2023-06-06,House,"House Appropriations: Re-report Bill As Committed",37,0,0,0,37
1733475,1310083,2023-04-25,House,"House Agriculture And Rural Affairs: Report Bill As Committed",21,0,0,0,21
1733475,1330544,2023-05-23,House,"House Floor: HB 295 PN 251, FINAL PASSAGE",201,0,0,0,201
1733475,1330545,2023-05-23,House,"House Appropriations: Re-report Bill As Committed",37,0,0,0,37
1733475,1356370,2023-10-23,Senate,"Senate Agriculture And Rural Affairs: Reported as Committed",11,0,0,0,11
1733475,1356461,2023-10-24,Senate,"Senate Appropriations: Re-Reported as Committed",24,0,0,0,24
1733475,1357472,2023-11-13,Senate,"Senate Floor: HB 295 PN 251, Final Passage",50,0,0,0,50
1734100,1366197,2024-01-17,House,"House Judiciary: Adopt Amendment A03125",14,11,0,0,25
1734100,1366198,2024-01-17,House,"House Judiciary: Report Bill As Amended",14,11,0,0,25
1734397,1330821,2023-05-23,House,"House Veterans Affairs And Emergency Preparedness: Report Bill As Committed",21,0,0,0,21
1734604,1355823,2023-10-03,House,"House Professional Licensure: Report Bill As Amended",25,0,0,0,25
1734604,1355824,2023-10-03,House,"House Professional Licensure: Adopt Amendment A02155",25,0,0,0,25
1734604,1356234,2023-10-18,House,"House Floor: HB 327 PN 2082, FINAL PASSAGE",203,0,0,0,203
1734604,1356235,2023-10-18,House,"House Appropriations: Re-report Bill As Committed",37,0,0,0,37
1734604,1456701,2024-06-12,Senate,"Senate Consumer Protection And Professional Licensure: Adopt Amendment",12,0,2,0,14
1734604,1460999,2024-06-27,Senate,"Senate Appropriations: Re-Reported as Committed",24,0,0,0,24
1734604,1463019,2024-07-11,Senate,"Senate Floor: HB 327 PN 2082, Final Passage",49,0,0,1,50
1734638,1427839,2024-04-16,House,"House Children And Youth: Report Bill As Amended A03994",25,0,0,0,25
1734638,1427840,2024-04-16,House,"House Children And Youth: Re-report Bill As Amended",25,0,0,0,25
1735145,1310797,2023-04-26,House,"House Judiciary: Adopt Amendment A00351",12,9,0,0,21
1735145,1310798,2023-04-26,House,"House Judiciary: Report Bill As Amended",12,9,0,0,21
1735145,1317453,2023-05-03,House,"House Floor: HB 338 PN 1090, 2023 A430",21,180,0,0,201
1735145,1329707,2023-05-22,House,"House Floor: HB 338 PN 1090, CONSTITUTIONALITY",101,100,0,0,201
1735145,1329708,2023-05-22,House,"House Floor: HB 338 PN 1090, FINAL PASSAGE",100,101,0,0,201
1735145,1329709,2023-05-22,House,"House Appropriations: Re-report Bill As Committed",22,15,0,0,37
1735213,1366155,2024-01-17,House,"House Judiciary: Adopt Amendment A03089",14,11,0,0,25
1735213,1366156,2024-01-17,House,"House Judiciary: Report Bill As Amended",14,11,0,0,25
1735213,1440023,2024-05-07,House,"House Floor: HB 335 PN 2576, FINAL PASSAGE",101,100,0,1,202
1735213,1440024,2024-05-07,House,"House Appropriations: Re-report Bill As Committed",22,14,1,0,37
1735280,1453917,2024-06-05,House,"House Children And Youth: To Table",11,14,0,0,25
1735280,1453918,2024-06-05,House,"House Children And Youth: Adopt Amendment A04603",15,10,0,0,25
1735280,1453919,2024-06-05,House,"House Children And Youth: Report Bill As Amended",15,10,0,0,25
1735280,1456559,2024-06-12,House,"House Rules: Re-report Bill As Committed",18,15,0,0,33
1735280,1456690,2024-06-12,House,"House Floor: HB 350 PN 3255, 2023 A4946",108,93,0,2,203
1735280,1458932,2024-06-24,House,"House Floor: HB 350 PN 3322, FINAL PASSAGE",119,83,0,1,203
1735280,1458933,2024-06-24,House,"House Appropriations: Re-report Bill As Committed",24,13,0,0,37
1737436,1315343,2023-05-01,House,"House Veterans Affairs And Emergency Preparedness: Report Bill As Committed",21,0,0,0,21
1737436,1348764,2023-06-29,House,"House Floor: HB 358 PN 325, 2023 A1075",203,0,0,0,203
1737436,1349832,2023-07-06,House,"House Floor: HB 358 PN 1798, FINAL PASSAGE",203,0,0,0,203
1737436,1349833,2023-07-06,House,"House Appropriations: Re-report Bill As Committed",37,0,0,0,37
1737436,1376338,2024-02-05,Senate,"Senate Veterans Affairs And Emergency Preparedness: Reported as Committed",11,0,0,0,11
1737436,1436087,2024-04-29,Senate,"Senate Appropriations: Re-Reported as Committed",24,0,0,0,24
1737436,1437169,2024-05-01,Senate,"Senate Floor: HB 358 PN 1798, Final Passage",50,0,0,0,50
1737758,1309573,2023-04-25,House,"House Consumer Protection, Technology And Utilities: Report Bill As Committed",21,0,0,0,21
1737758,1315214,2023-05-01,House,"House Floor: HB 360 PN 327, FINAL PASSAGE",201,0,0,0,201
1737758,1315215,2023-05-01,House,"House Appropriations: Re-report Bill As Committed",37,0,0,0,37
1737817,1317253,2023-04-24,House,"House Game And Fisheries: Bring Up The Bill For Consideration",21,0,0,0,21
1737817,1331440,2023-05-23,House,"House Floor: HB 365 PN 332, FINAL PASSAGE",201,0,0,0,201
1737817,1331441,2023-05-23,House,"House Appropriations: Re-report Bill As Committed",37,0,0,0,37
1737925,1310641,2023-04-25,House,"House Finance: Adopt Amendment A00235",18,0,3,0,21
1737925,1316524,2023-05-02,House,"House Floor: HB 363 PN 1032, 2023 A352",100,101,0,0,201
1737925,1317489,2023-05-03,House,"House Floor: HB 363 PN 1032, FINAL PASSAGE",201,0,0,0,201
1737925,1317490,2023-05-03,House,"House Appropriations: Re-report Bill As Committed",37,0,0,0,37
1739520,1308385,2023-04-24,House,"House Labor And Industry: Report Bill As Committed",13,8,0,0,21
1739520,1316101,2023-05-02,House,"House Appropriations: Re-report Bill As Committed",22,15,0,0,37
1739520,1316769,2023-05-02,House,"House Floor: HB 413 PN 381, FINAL PASSAGE",113,88,0,0,201
1739536,1303775,2023-04-18,House,"House Judiciary: Report Bill As Committed",21,0,0,0,21
1739536,1339691,2023-06-06,House,"House Floor: HB 394 PN 361, FINAL PASSAGE",203,0,0,0,203
1739536,1340555,2023-06-06,House,"House Appropriations: Re-report Bill As Committed",37,0,0,0,37
1739541,1415276,2024-03-26,House,"House Judiciary: Adopt Amendment A03778",25,0,0,0,25
1739541,1415277,2024-03-26,House,"House Judiciary: Report Bill As Amended",25,0,0,0,25
1739541,1436377,2024-04-30,House,"House Appropriations: Re-report Bill As Committed",37,0,0,0,37
1739541,1436837,2024-04-30,House,"House Floor: HB 416 PN 2929, FINAL PASSAGE",199,1,0,2,202
1739541,1461933,2024-07-01,Senate,"Senate Judiciary: Reported as Committed",12,2,0,0,14
1739571,1330618,2023-05-23,House,"House Veterans Affairs And Emergency Preparedness: Adopt Amendment A00536",21,0,0,0,21
1739571,1330619,2023-05-23,House,"House Veterans Affairs And Emergency Preparedness: Report Bill As Amended",21,0,0,0,21
1739571,1346626,2023-06-22,House,"House Floor: HB 404 PN 1301, FINAL PASSAGE",203,0,0,0,203
1739571,1346627,2023-06-22,House,"House Appropriations: Re-report Bill As Committed",37,0,0,0,37
1739571,1355557,2023-10-03,Senate,"Senate Veterans Affairs And Emergency Preparedness: Reported as Committed",11,0,0,0,11
1739571,1355997,2023-10-16,Senate,"Senate Appropriations: Re-Reported as Committed",22,0,2,0,24
1739571,1356236,2023-10-18,Senate,"Senate Floor: HB 404 PN 1301, Final Passage",48,0,0,2,50
1739593,1319237,2023-05-03,House,"House Local Government: Adopt Amendment A00423",20,1,0,0,21
1739593,1319238,2023-05-03,House,"House Local Government: Report Bill As Amended",21,0,0,0,21
1739593,1339069,2023-06-05,House,"House Floor: HB 405 PN 1149, 2023 A537",203,0,0,0,203
1739593,1339307,2023-06-06,House,"House Floor: HB 405 PN 1447, FINAL PASSAGE",203,0,0,0,203
1739593,1340638,2023-06-06,House,"House Appropriations: Re-report Bill As Committed",37,0,0,0,37
1739596,1410894,2024-03-19,House,"House Children And Youth: Adopt Amendment A03052",25,0,0,0,25
1739596,1410895,2024-03-19,House,"House Children And Youth: Report Bill As Amended",25,0,0,0,25
1739606,1311095,2023-04-26,House,"House Human Services: Report Bill As Committed",21,0,0,0,21
1739606,1330865,2023-05-23,House,"House Floor: HB 409 PN 377, FINAL PASSAGE",155,46,0,0,201
1739606,1330866,2023-05-23,House,"House Appropriations: Re-report Bill As Committed",37,0,0,0,37
1739911,1309459,2023-04-25,Senate,"Senate State Government: Reported as Committed",11,0,0,0,11
1739911,1355475,2023-10-02,Senate,"Senate Appropriations: Re-Reported as Committed",23,0,1,0,24
1739911,1356061,2023-10-16,Senate,"Senate Floor: SB 423 PN 410, Final Passage",48,0,0,2,50
1739957,1320770,2023-05-09,Senate,"Senate State Government: Reported as Committed",7,4,0,0,11
1739959,1411014,2024-03-19,Senate,"Senate State Government: Reported as Committed",7,4,0,0,11
1739988,1330807,2023-05-23,House,"House Veterans Affairs And Emergency Preparedness: Report Bill As Committed",21,0,0,0,21
1739992,1308218,2023-04-24,House,"House State Government: Report Bill As Committed",21,0,0,0,21
1739992,1310714,2023-04-26,House,"House Floor: HB 436 PN 403, FINAL PASSAGE",200,1,0,0,201
1739992,1310715,2023-04-26,House,"House Appropriations: Re-report Bill As Committed",37,0,0,0,37
1739999,1347683,2023-06-27,Senate,"Senate Banking And Insurance: Reported as Amended",13,0,1,0,14
1739999,1347684,2023-06-27,Senate,"Senate Banking And Insurance: Adopt Amendment A01175",13,0,1,0,14
1740007,1411005,2024-03-19,Senate,"Senate Education: Reported as Amended",6,4,1,0,11
1740007,1411006,2024-03-19,Senate,"Senate Education: Adopt Amendment A03541",10,0,1,0,11
1740013,1345173,2023-06-19,Senate,"Senate Veterans Affairs And Emergency Preparedness: Reported as Committed",11,0,0,0,11
1740013,1356452,2023-10-24,Senate,"Senate Appropriations: Re-Reported as Amended",24,0,0,0,24
1740013,1356453,2023-10-24,Senate,"Senate Appropriations: Adopt Amendment A02726",24,0,0,0,24
1740013,1356538,2023-10-25,Senate,"Senate Floor: SB 438 PN 1186, Final Passage",50,0,0,0,50
1740013,1456676,2024-06-12,House,"House Veterans Affairs And Emergency Preparedness: Report Bill As Amended",25,0,0,0,25
1740013,1456677,2024-06-12,House,"House Veterans Affairs And Emergency Preparedness: Adopt Amendment A04941",25,0,0,0,25
1740021,1355188,2023-09-26,House,"House Labor And Industry: Adopt Amendment A01963",25,0,0,0,25
1740021,1355189,2023-09-26,House,"House Labor And Industry: Report Bill As Amended",25,0,0,0,25
1740034,1410981,2024-03-19,Senate,"Senate State Government: Amendment failed A03631",4,7,0,0,11
1740034,1410982,2024-03-19,Senate,"Senate State Government: Amendment failed A03618",4,7,0,0,11
1740034,1410983,2024-03-19,Senate,"Senate State Government: Amendment failed A03623",4,7,0,0,11
1740034,1410984,2024-03-19,Senate,"Senate State Government: Reported as Amended",7,4,0,0,11
1740034,1410985,2024-03-19,Senate,"Senate State Government: Adopt Amendment A03621",11,0,0,0,11
1740073,1320811,2023-05-09,Senate,"Senate Finance: Reported as Committed",11,0,0,0,11
1740073,1339031,2023-06-05,Senate,"Senate Appropriations: Re-Reported as Committed",24,0,0,0,24
1740073,1339368,2023-06-06,Senate,"Senate Floor: SB 24 PN 403, Final Passage",50,0,0,0,50
1740073,1362310,2023-12-11,House,"House Finance: Re-report Bill As Amended",25,0,0,0,25
1740073,1362431,2023-12-12,House,"House Floor: SB 24 PN 403, 2023 A3250",102,101,0,0,203
1740073,1362432,2023-12-12,House,"House Floor: SB 24 PN 403, 2023 A3302, MOTION TO SUSPEND RULES",101,102,0,0,203
1740073,1462973,2024-07-11,House,"House Floor: SB 24 PN 1814, FINAL PASSAGE",202,0,0,1,203
1740073,1462974,2024-07-11,House,"House Appropriations: Re-report Bill As Amended",37,0,0,0,37
1740073,1462975,2024-07-11,House,"House Appropriations: Adopt Amendment A05525",37,0,0,0,37
1740073,1463020,2024-07-11,Senate,"Senate Floor: SB 24 PN 1814, Concur in House Amendments",49,0,0,1,50
1740073,1463021,2024-07-11,Senate,"Senate Rules And Executive Nominations: Re-Reported as Committed",17,0,0,0,17
1740126,1316213,2023-05-02,Senate,"Senate Education: Reported as Committed",7,4,0,0,11
1740126,1356362,2023-10-23,Senate,"Senate Appropriations: Re-Reported as Committed",0,3,21,0,24
1740126,1356439,2023-10-24,Senate,"Senate Floor: SB 456 PN 436, Final Passage",42,8,0,0,50
1740446,1309332,2023-04-25,Senate,"Senate Law And Justice: Reported as Committed",11,0,0,0,11
1740446,1453921,2024-06-05,Senate,"Senate Appropriations: Adopt Amendment A03991",24,0,0,0,24
1740446,1453922,2024-06-05,Senate,"Senate Appropriations: Re-Reported as Amended",24,0,0,0,24
1740446,1456003,2024-06-11,Senate,"Senate Floor: SB 464 PN 1685, Final Passage",49,0,0,1,50
1740446,1460953,2024-06-26,House,"House Local Government: Report Bill As Committed",25,0,0,0,25
1740446,1461889,2024-07-01,House,"House Floor: SB 464 PN 1685, FINAL PASSAGE",201,1,0,1,203
1740446,1461890,2024-07-01,House,"House Appropriations: Re-report Bill As Committed",37,0,0,0,37
1740490,1320825,2023-05-09,Senate,"Senate Finance: Reported as Committed",8,3,0,0,11
1740560,1316814,2023-05-02,Senate,"Senate Community, Economic And Recreational Development: Reported as Amended",14,0,0,0,14
1740560,1316815,2023-05-02,Senate,"Senate Community, Economic And Recreational Development: Adopt Amendment A00397",14,0,0,0,14
1740560,1338672,2023-06-05,Senate,"Senate Appropriations: Re-Reported as Committed",24,0,0,0,24
1740560,1345780,2023-06-20,Senate,"Senate Floor: SB 497 PN 691, 2023 A1136, ROBINSON Amendment No. A-1136",49,1,0,0,50
1740560,1346308,2023-06-21,Senate,"Senate Floor: SB 497 PN 932, 2023 A1204, Motion to table MUTH Amendment No. A-1204",28,22,0,0,50
1740560,1346309,2023-06-21,Senate,"Senate Floor: SB 497 PN 932, Final Passage",48,2,0,0,50
1740560,1346310,2023-06-21,Senate,"Senate Floor: SB 497 PN 932, Final Passage - Reconsidertation",47,3,0,0,50
1740560,1347646,2023-06-27,House,"House Consumer Protection, Technology And Utilities: Adopt Amendment A01354",20,1,0,0,21
1740560,1347647,2023-06-27,House,"House Consumer Protection, Technology And Utilities: Report Bill As Amended",21,0,0,0,21
1740560,1362209,2023-12-11,House,"House Floor: SB 497 PN 979, 2023 A1546",116,87,0,0,203
1740560,1362358,2023-12-12,House,"House Appropriations: Re-report Bill As Committed",22,15,0,0,37
1740560,1362469,2023-12-12,House,"House Floor: SB 497 PN 1270, FINAL PASSAGE",155,48,0,0,203
1740560,1423425,2024-04-09,Senate,"Senate Rules And Executive Nominations: Re-Reported as Amended",11,6,0,0,17
1740560,1423426,2024-04-09,Senate,"Senate Rules And Executive Nominations: Adopt Amendment A03947",11,6,0,0,17
1740560,1424693,2024-04-10,Senate,"Senate Floor: SB 497 PN 1517, Concurrence in House Amendments as Amended",46,4,0,0,50
1740560,1453255,2024-06-04,House,"House Floor: SB 497 PN 1517, CONCURRENCE",159,43,0,1,203
1740560,1453256,2024-06-04,House,"House Rules: Re-report Bill As Committed",33,0,0,0,33
1740571,1356431,2023-10-24,Senate,"Senate Veterans Affairs And Emergency Preparedness: Reported as Committed",7,3,0,0,10
1740599,1321246,2023-05-09,Senate,"Senate Finance: Reported as Committed",11,0,0,0,11
1741667,1339095,2023-06-06,Senate,"Senate Judiciary: Adopt Amendment A00790",13,0,1,0,14
1741667,1339096,2023-06-06,Senate,"Senate Judiciary: Reported as Amended",12,1,1,0,14
1741667,1345707,2023-06-20,Senate,"Senate Floor: SB 527 PN 844, Final Passage",44,6,0,0,50
1741667,1362092,2023-12-08,House,"House Judiciary: Adopt Amendment A03005",14,11,0,0,25
1741667,1362093,2023-12-08,House,"House Judiciary: Report Bill As Amended",14,11,0,0,25
1741667,1362439,2023-12-12,House,"House Floor: SB 527 PN 1265, 2023 A3220",197,6,0,0,203
1741667,1362440,2023-12-12,House,"House Appropriations: Adopt Amendment A03330",22,15,0,0,37
1741667,1362441,2023-12-12,House,"House Appropriations: Re-report Bill As Amended A03330",37,0,0,0,37
1741667,1362575,2023-12-13,House,"House Floor: SB 527 PN 1288, FINAL PASSAGE",181,22,0,0,203
1741667,1362576,2023-12-13,Senate,"Senate Rules And Executive Nominations: Re-Reported as Committed",17,0,0,0,17
1741667,1362662,2023-12-13,Senate,"Senate Floor: SB 527 PN 1288, Concur in House Amendments",45,5,0,0,50
1741697,1320725,2023-05-09,Senate,"Senate Urban Affairs And Housing: Reported as Committed",11,0,0,0,11
1741701,1411716,2024-03-20,Senate,"Senate Finance: Reported as Committed",11,0,0,0,11
1741701,1436079,2024-04-29,Senate,"Senate Appropriations: Re-Reported as Committed",24,0,0,0,24
1741701,1436505,2024-04-30,Senate,"Senate Floor: SB 479 PN 510, Final Passage",50,0,0,0,50
1741701,1467943,2024-10-01,House,"House State Government: Adopt Amendment A05703",11,14,0,0,25
1741701,1467944,2024-10-01,House,"House State Government: Adopt Amendment A05704",11,14,0,0,25
1741701,1467945,2024-10-01,House,"House State Government: Report Bill As Committed",14,11,0,0,25
1741725,1316164,2023-05-02,Senate,"Senate Health And Human Services: Reported as Committed",11,0,0,0,11
1741725,1347438,2023-06-26,Senate,"Senate Floor: SB 500 PN 484, Final Passage",49,0,0,1,50
1741725,1347439,2023-06-26,Senate,"Senate Appropriations: Re-Reported as Committed",24,0,0,0,24
1741725,1356228,2023-10-18,House,"House Health: Adopt Amendment A02574",25,0,0,0,25
1741725,1356229,2023-10-18,House,"House Health: Report Bill As Amended",25,0,0,0,25
1741725,1356742,2023-10-31,House,"House Floor: SB 500 PN 1175, 2023 A2775",98,104,0,1,203
1741725,1357415,2023-11-13,House,"House Appropriations: Re-report Bill As Committed",37,0,0,0,37
1741725,1357471,2023-11-13,House,"House Floor: SB 500 PN 1175, FINAL PASSAGE",203,0,0,0,203
1741725,1357558,2023-11-14,Senate,"Senate Floor: SB 500 PN 1175, Concur in House Amendments",50,0,0,0,50
1741725,1357559,2023-11-14,Senate,"Senate Rules And Executive Nominations: Re-Reported as Committed",17,0,0,0,17
1741731,1456472,2024-06-11,Senate,"Senate Game And Fisheries: Reported as Committed",11,0,0,0,11
1741731,1460300,2024-06-26,Senate,"Senate Appropriations: Re-Reported as Committed",23,0,1,0,24
1741731,1461917,2024-07-01,Senate,"Senate Floor: SB 522 PN 494, Final Passage",50,0,0,0,50
1741763,1339586,2023-06-06,Senate,"Senate Urban Affairs And Housing: Reported as Committed",11,0,0,0,11
1741767,1339225,2023-06-06,Senate,"Senate Health And Human Services: Reported as Committed",10,0,1,0,11
1741799,1354964,2023-09-19,Senate,"Senate Transportation: Reported as Committed",13,1,0,0,14
1741799,1355641,2023-10-03,Senate,"Senate Appropriations: Re-Reported as Committed",23,0,1,0,24
1741799,1355772,2023-10-04,Senate,"Senate Floor: SB 473 PN 1152, Final Passage",50,0,0,0,50
1741845,1436616,2024-04-30,Senate,"Senate State Government: Reported as Committed",6,5,0,0,11
1741872,1345169,2023-06-19,Senate,"Senate Veterans Affairs And Emergency Preparedness: Reported as Committed",7,4,0,0,11
1741872,1354894,2023-09-18,Senate,"Senate Floor: SB 531 PN 508, 2023 A1379, BAKER Amendment No. A-1379",35,10,0,5,50
1741872,1355453,2023-10-02,Senate,"Senate Appropriations: Re-Reported as Committed",14,9,1,0,24
1741872,1355575,2023-10-03,Senate,"Senate Floor: SB 531 PN 1098, Final Passage",28,20,0,2,50
1741872,1467508,2024-09-23,House,"House Veterans Affairs And Emergency Preparedness: Adopt Amendment A05624",17,8,0,0,25
1741872,1467509,2024-09-23,House,"House Veterans Affairs And Emergency Preparedness: Report Bill As Amended",17,8,0,0,25
1742249,1449082,2024-05-22,House,"House Local Government: Report Bill As Committed",14,11,0,0,25
1742346,1319236,2023-05-03,House,"House Local Government: Report Bill As Committed",21,0,0,0,21
1742346,1339591,2023-06-06,House,"House Floor: HB 450 PN 418, FINAL PASSAGE",166,37,0,0,203
1742346,1340788,2023-06-06,House,"House Appropriations: Re-report Bill As Committed",37,0,0,0,37
1742346,1460805,2024-06-26,Senate,"Senate Community, Economic And Recreational Development: Reported as Committed",14,0,0,0,14
1742346,1468862,2024-10-22,Senate,"Senate Floor: HB 450 PN 418, Final Passage",49,1,0,0,50
1742346,1468863,2024-10-22,Senate,"Senate Appropriations: Re-Reported as Committed",24,0,0,0,24
1742650,1415352,2024-03-26,House,"House Consumer Protection, Technology And Utilities: Adopt Amendment A03393",25,0,0,0,25
1742650,1415353,2024-03-26,House,"House Consumer Protection, Technology And Utilities: Report Bill As Amended",25,0,0,0,25
1742650,1422708,2024-04-09,House,"House Floor: HB 491 PN 2790, FINAL PASSAGE",201,0,0,1,202
1742650,1422709,2024-04-09,House,"House Appropriations: Re-report Bill As Committed",37,0,0,0,37
1742650,1459825,2024-06-25,Senate,"Senate Consumer Protection And Professional Licensure: Reported as Amended",14,0,0,0,14
1742650,1459826,2024-06-25,Senate,"Senate Consumer Protection And Professional Licensure: Adopt Amendment A05107",14,0,0,0,14
1742653,1461879,2024-07-01,House,"House Education: Report Bill As Amended",25,0,0,0,25
1742653,1461880,2024-07-01,House,"House Education: Adopt Amendment A05220",25,0,0,0,25
1742653,1462894,2024-07-10,House,"House Rules: Re-report Bill As Committed",33,0,0,0,33
1742702,1349879,2023-07-06,House,"House Judiciary: Re-refer Bill To Another Committee",21,0,0,0,21
1742704,1415200,2024-03-26,House,"House Judiciary: Report Bill As Committed",14,11,0,0,25
1742728,1439509,2024-05-06,House,"House Transportation: Report Bill As Amended",25,0,0,0,25
1742728,1439510,2024-05-06,House,"House Transportation: Adopt Amendment A04305",25,0,0,0,25
1742728,1446156,2024-05-21,House,"House Floor: HB 478 PN 3051, 2023 A4413, MOTION TO APPEAL RULING OF THE CHAIR",102,100,0,1,203
1742728,1447700,2024-05-22,House,"House Appropriations: Re-report Bill As Committed",37,0,0,0,37
1742728,1448446,2024-05-22,House,"House Floor: HB 478 PN 3051, FINAL PASSAGE",124,78,0,1,203
1742742,1356215,2023-10-18,House,"House Judiciary: Adopt Amendment A02476",14,11,0,0,25
1742742,1356216,2023-10-18,House,"House Judiciary: Report Bill As Amended",14,11,0,0,25
1742759,1315176,2023-05-01,House,"House Veterans Affairs And Emergency Preparedness: Report Bill As Amended",21,0,0,0,21
1742759,1315177,2023-05-01,House,"House Veterans Affairs And Emergency Preparedness: Adopt Amendment A00257",21,0,0,0,21
1742759,1339070,2023-06-05,House,"House Floor: HB 479 PN 1092, FINAL PASSAGE",203,0,0,0,203
1742759,1340443,2023-06-05,House,"House Appropriations: Re-report Bill As Committed",37,0,0,0,37
1742759,1347670,2023-06-27,Senate,"Senate Health And Human Services: Reported as Committed",11,0,0,0,11
1742759,1348723,2023-06-29,Senate,"Senate Appropriations: Re-Reported as Amended",15,9,0,0,24
1742759,1348724,2023-06-29,Senate,"Senate Appropriations: Adopt Amendment A01648",15,9,0,0,24
1742759,1348927,2023-06-29,Senate,"Senate Floor: HB 479 PN 1804, Motion to Suspend Senate Rule 12",48,2,0,0,50
1742759,1348928,2023-06-29,Senate,"Senate Floor: HB 479 PN 1804, Final Passage",29,21,0,0,50
1742759,1348999,2023-06-30,House,"House Rules: Report Bill As Committed",15,18,0,0,33
1743122,1348049,2023-06-28,House,"House Game And Fisheries: Report Bill As Committed",20,1,0,0,21
1743132,1316131,2023-05-02,Senate,"Senate Education: Reported as Committed",11,0,0,0,11
1743132,1320285,2023-05-08,Senate,"Senate Appropriations: Re-Reported as Committed",24,0,0,0,24
1743132,1347428,2023-06-26,Senate,"Senate Rules And Executive Nominations: Adopt Amendment A00506",16,0,1,0,17
1743132,1347429,2023-06-26,Senate,"Senate Rules And Executive Nominations: Re-Reported as Amended",16,0,1,0,17
1743132,1347697,2023-06-27,Senate,"Senate Floor: SB 460 PN 974, Final Passage",34,15,0,1,50
1743132,1461884,2024-07-01,House,"House Education: Report Bill As Committed",23,2,0,0,25
1743149,1356654,2023-10-30,House,"House Liquor Control: Report Bill As Amended",25,0,0,0,25
1743149,1356655,2023-10-30,House,"House Liquor Control: Adopt Amendment A02747",25,0,0,0,25
1743149,1357638,2023-11-14,House,"House Floor: HB 221 PN 2220, 2023 A2814",203,0,0,0,203
1743149,1357726,2023-11-15,House,"House Floor: HB 221 PN 2308, FINAL PASSAGE",173,30,0,0,203
1743149,1357727,2023-11-15,House,"House Appropriations: Re-report Bill As Committed",37,0,0,0,37
1743199,1292909,2023-04-04,House,"House Health: Adopt Amendment A00181",21,0,0,0,21
1743199,1292910,2023-04-04,House,"House Health: Report Bill As Amended",17,4,0,0,21
1743199,1306143,2023-03-29,House,"House Health: Adopt Amendment A00181",21,0,0,0,21
1743199,1306144,2023-03-29,House,"House Health: Report Bill As Amended",17,4,0,0,21
1743199,1310025,2023-04-25,House,"House Floor: HB 494 PN 952, 2023 A284",201,0,0,0,201
1743199,1310723,2023-04-26,House,"House Floor: HB 494 PN 1034, FINAL PASSAGE",158,43,0,0,201
1743199,1310724,2023-04-26,House,"House Appropriations: Re-report Bill As Committed",37,0,0,0,37
1743322,1329706,2023-05-22,House,"House Transportation: Report Bill As Committed",21,0,0,0,21
1743393,1348021,2023-06-28,House,"House State Government: Report Bill As Amended",16,5,0,0,21
1743393,1348022,2023-06-28,House,"House State Government: Adopt Amendment A01455",18,3,0,0,21
1743410,1292911,2023-04-04,House,"House Health: Report Bill As Committed",20,1,0,0,21
1743410,1292912,2023-04-04,House,"House Health: Adopt Amendment A00183",21,0,0,0,21
1743410,1306128,2023-03-29,House,"House Health: Report Bill As Amended",20,1,0,0,21
1743410,1306129,2023-03-29,House,"House Health: Adopt Amendment A00183",21,0,0,0,21
1743410,1309513,2023-04-25,House,"House Floor: HB 507 PN 953, 2023 A293",201,0,0,0,201
1743410,1310778,2023-04-26,House,"House Floor: HB 507 PN 1033, FINAL PASSAGE",201,0,0,0,201
1743410,1310779,2023-04-26,House,"House Appropriations: Re-report Bill As Committed",37,0,0,0,37
1743410,1356429,2023-10-24,Senate,"Senate Health And Human Services: Reported as Committed",11,0,0,0,11
1743410,1357641,2023-11-14,Senate,"Senate Floor: HB 507 PN 2289, Final Passage",50,0,0,0,50
1743410,1357705,2023-11-15,House,"House Floor: HB 507 PN 2289, CONCURRENCE",203,0,0,0,203
1743410,1357706,2023-11-15,House,"House Rules: Re-report Bill As Committed",33,0,0,0,33
1743440,1348693,2023-06-29,House,"House Veterans Affairs And Emergency Preparedness: Report Bill As Committed",20,0,1,0,21
1743440,1410741,2024-03-18,House,"House Rules: Re-report Bill As Committed",33,0,0,0,33
1743440,1411225,2024-03-19,House,"House Floor: HB 502 PN 471, FINAL PASSAGE",201,0,0,1,202
1743440,1411226,2024-03-19,House,"House Appropriations: Re-report Bill As Committed",37,0,0,0,37
1743481,1429346,2024-04-17,House,"House Finance: Adopt Amendment",25,0,0,0,25
1743481,1429347,2024-04-17,House,"House Finance: Report Bill As Amended",25,0,0,0,25
1743740,1348641,2023-06-29,House,"House Transportation: Report Bill As Amended",21,0,0,0,21
1743740,1348903,2023-06-29,House,"House Transportation: Adopt Amendment A01564",21,0,0,0,21
1743740,1355293,2023-09-27,House,"House Floor: HB 540 PN 1786, 2023 A2128, MOTION TO APPEAL RULING OF THE CHAIR",101,101,0,0,202
1743740,1355294,2023-09-27,House,"House Floor: HB 540 PN 1786, 2023 A2130, MOTION TO APPEAL RULING OF THE CHAIR",101,101,0,0,202
1743740,1355295,2023-09-27,House,"House Floor: HB 540 PN 1786, 2023 A1788",101,101,0,0,202
1743740,1355487,2023-10-02,House,"House Floor: HB 540 PN 1786, FINAL PASSAGE",146,57,0,0,203
1743740,1355488,2023-10-02,House,"House Appropriations: Re-report Bill As Committed",37,0,0,0,37
1743754,1357489,2023-11-14,House,"House Transportation: Report Bill As Committed",25,0,0,0,25
1743754,1429395,2024-04-17,House,"House Floor: HB 538 PN 511, FINAL PASSAGE",198,2,0,2,202
1743754,1429396,2024-04-17,House,"House Appropriations: Re-report Bill As Committed",37,0,0,0,37
1743766,1343932,2023-06-14,House,"House Judiciary: Adopt Amendment A00964",12,9,0,0,21
1743766,1343933,2023-06-14,House,"House Judiciary: Report Bill As Amended",12,9,0,0,21
1743766,1345792,2023-06-21,House,"House Rules: Re-report Bill As Committed",18,15,0,0,33
1743766,1348769,2023-06-29,House,"House Floor: HB 544 PN 1588, 2023 A1107",101,102,0,0,203
1743766,1348770,2023-06-29,House,"House Floor: HB 544 PN 1588, 2023 A1330",180,23,0,0,203
1743766,1348771,2023-06-29,House,"House Floor: HB 544 PN 1588, 2023 A1112",101,102,0,0,203
1743766,1348772,2023-06-29,House,"House Floor: HB 544 PN 1588, 2023 A1123",101,102,0,0,203
1743766,1349676,2023-07-06,House,"House Appropriations: Re-report Bill As Committed",37,0,0,0,37
1743766,1349730,2023-07-06,House,"House Floor: HB 544 PN 1799, FINAL PASSAGE",130,73,0,0,203
1743830,1348206,2023-06-28,House,"House State Government: Report Bill As Committed",13,8,0,0,21
1743830,1356200,2023-10-18,House,"House Floor: HB 573 PN 545, 2023 A1690",203,0,0,0,203
1743830,1356201,2023-10-18,House,"House Floor: HB 573 PN 545, 2023 A1695",203,0,0,0,203
1743830,1356202,2023-10-18,House,"House Floor: HB 573 PN 545, 2023 A2590",102,101,0,0,203
1743830,1356203,2023-10-18,House,"House Rules: Re-report Bill As Committed",18,15,0,0,33
1743877,1340753,2023-06-07,House,"House Professional Licensure: Report Bill As Committed",21,0,0,0,21
1743983,1317759,2023-05-03,House,"House Commerce: Bring Up The Bill For Consideration",21,0,0,0,21
1743983,1317760,2023-05-03,House,"House Commerce: Adopt Amendment",21,0,0,0,21
1743983,1317761,2023-05-03,House,"House Commerce: Adopt Amendment",21,0,0,0,21
1743983,1317762,2023-05-03,House,"House Commerce: Report Bill As Amended",12,9,0,0,21
1743983,1330312,2023-05-23,House,"House Floor: HB 577 PN 1137, 2023 A509",93,108,0,0,201
1743983,1331480,2023-05-23,House,"House Floor: HB 577 PN 1137, 2023 A521",100,101,0,0,201
1743983,1331481,2023-05-23,House,"House Floor: HB 577 PN 1137, 2023 A522",100,101,0,0,201
1743983,1331482,2023-05-23,House,"House Floor: HB 577 PN 1137, 2023 A524",100,101,0,0,201
1743983,1331483,2023-05-23,House,"House Floor: HB 577 PN 1137, 2023 A525",100,101,0,0,201
1743983,1331484,2023-05-23,House,"House Floor: HB 577 PN 1137, 2023 A526",201,0,0,0,201
1743983,1331485,2023-05-23,House,"House Floor: HB 577 PN 1137, 2023 A622",201,0,0,0,201
1743983,1332430,2023-05-24,House,"House Floor: HB 577 PN 1304, FINAL PASSAGE",106,95,0,0,201
1743983,1332431,2023-05-24,House,"House Appropriations: Re-report Bill As Committed",22,15,0,0,37
1744199,1312583,2023-04-25,House,"House Environmental Resources And Energy: Re-refer Bill To Another Committee",12,9,0,0,21
1744211,1460143,2024-06-25,House,"House Environmental Resources And Energy: Adopt Amendment A05103",20,5,0,0,25
1744211,1460144,2024-06-25,House,"House Environmental Resources And Energy: Report Bill As Amended",20,5,0,0,25
1744211,1468852,2024-10-22,House,"House Floor: HB 589 PN 3391, 2023 A5558",166,36,0,1,203
1744276,1339385,2023-06-06,House,"House Agriculture And Rural Affairs: Adopt Amendment A00764",21,0,0,0,21
1744276,1339386,2023-06-06,House,"House Agriculture And Rural Affairs: Report Bill As Amended",21,0,0,0,21
1744276,1345335,2023-06-20,House,"House Floor: HB 580 PN 1456, 2023 A1055",101,102,0,0,203
1744276,1345336,2023-06-20,House,"House Floor: HB 580 PN 1456, 2023 A1056",101,102,0,0,203
1744276,1345337,2023-06-20,House,"House Rules: Re-report Bill As Committed",33,0,0,0,33
1744276,1345977,2023-06-21,House,"House Floor: HB 580 PN 1456, FINAL PASSAGE",141,62,0,0,203
1744276,1345978,2023-06-21,House,"House Appropriations: Re-report Bill As Committed",37,0,0,0,37
1744286,1415297,2024-03-19,House,"House Environmental Resources And Energy: Adopt Amendment A03535",14,11,0,0,25
1744286,1415298,2024-03-19,House,"House Environmental Resources And Energy: Report Bill As Amended",14,11,0,0,25
1744397,1355538,2023-10-03,House,"House Judiciary: Adopt Amendment A02206",25,0,0,0,25
1744397,1355539,2023-10-03,House,"House Judiciary: Report Bill As Amended",15,10,0,0,25
1744742,1348147,2023-06-28,House,"House State Government: Report Bill As Committed",21,0,0,0,21
1744742,1416522,2024-03-27,House,"House Rules: Re-report Bill As Committed",33,0,0,0,33
1744742,1421861,2024-04-08,House,"House Floor: HB 651 PN 590, FINAL PASSAGE",200,1,0,1,202
1744742,1421862,2024-04-08,House,"House Appropriations: Re-report Bill As Committed",37,0,0,0,37
1744776,1461305,2024-06-27,House,"House Finance: Report Bill As Amended",23,2,0,0,25
1744776,1461306,2024-06-27,House,"House Finance: Adopt Amendment",25,0,0,0,25
1744782,1388530,2024-02-20,House,"House Housing And Community Development: Report Bill As Amended",25,0,0,0,25
1744782,1388531,2024-02-20,House,"House Housing And Community Development: Adopt Amendment A03397",25,0,0,0,25
1744782,1416516,2024-03-27,House,"House Floor: HB 657 PN 2725, 2023 A3736, MOTION TO APPEAL RULING OF THE CHAIR",102,99,0,1,202
1744782,1416517,2024-03-27,House,"House Floor: HB 657 PN 2725, 2023 A3800, MOTION TO APPEAL RULING OF THE CHAIR",102,99,0,1,202
1744782,1416518,2024-03-27,House,"House Floor: HB 657 PN 2725, 2023 A3806, MOTION TO APPEAL RULING OF THE CHAIR",102,99,0,1,202
1744782,1416519,2024-03-27,House,"House Floor: HB 657 PN 2725, 2023 A3804",201,0,0,1,202
1744782,1421746,2024-04-08,House,"House Floor: HB 657 PN 2821, FINAL PASSAGE",176,25,0,1,202
1744782,1421747,2024-04-08,House,"House Appropriations: Re-report Bill As Committed",37,0,0,0,37
1744782,1459781,2024-06-25,Senate,"Senate Urban Affairs And Housing: Reported as Amended",9,1,1,0,11
1744782,1459782,2024-06-25,Senate,"Senate Urban Affairs And Housing: Adopt Amendment A05150",10,0,1,0,11
1744827,1301356,2023-04-13,House,"House Housing And Community Development: Re-refer Bill To Another Committee",21,0,0,0,21
1744839,1339035,2023-06-05,House,"House State Government: Report Bill As Committed",11,10,0,0,21
1744839,1348797,2023-06-29,House,"House Floor: HR 41 PN 602, 2023 A748",86,116,0,1,203
1744839,1348798,2023-06-29,House,"House Floor: HR 41 PN 602, 2023 A750",100,102,0,1,203
1744839,1348799,2023-06-29,House,"House Floor: HR 41 PN 602, 2023 A1551",201,1,0,1,203
1744839,1348800,2023-06-29,House,"House Floor: HR 41 PN 602, 2023 A1552",97,105,0,1,203
1744839,1348801,2023-06-29,House,"House Floor: HR 41 PN 1790",138,64,0,1,203
1744862,1356214,2023-10-18,House,"House Judiciary: Report Bill As Committed",14,11,0,0,25
1744876,1355507,2023-10-03,House,"House Consumer Protection, Technology And Utilities: Adopt Amendment A02176",25,0,0,0,25
1744876,1355508,2023-10-03,House,"House Consumer Protection, Technology And Utilities: Report Bill As Amended",25,0,0,0,25
1744876,1356113,2023-10-17,House,"House Floor: HB 636 PN 2085, 2023 A2495, MOTION TO SUSPEND RULES",102,101,0,0,203
1744876,1356189,2023-10-18,House,"House Appropriations: Re-report Bill As Committed",37,0,0,0,37
1744876,1356283,2023-10-18,House,"House Floor: HB 636 PN 2085, FINAL PASSAGE",172,31,0,0,203
1744891,1343550,2023-06-06,House,"House Environmental Resources And Energy: Adopt Amendment A00766",12,9,0,0,21
1744891,1343551,2023-06-06,House,"House Environmental Resources And Energy: Report Bill As Amended A00766",12,9,0,0,21
1744904,1300098,2023-04-13,House,"House Education: Report Bill As Committed",16,4,1,0,21
1744904,1356748,2023-10-31,House,"House Floor: HB 663 PN 604, 2023 A2731",202,0,0,1,203
1744904,1357466,2023-11-13,House,"House Floor: HB 663 PN 2229, FINAL PASSAGE",203,0,0,0,203
1744904,1357467,2023-11-13,House,"House Appropriations: Re-report Bill As Committed",37,0,0,0,37
1744904,1410823,2024-03-19,Senate,"Senate Education: Reported as Committed",10,0,1,0,11
1744904,1462745,2024-07-09,Senate,"Senate Appropriations: Re-Reported as Committed",23,0,1,0,24
1744904,1463013,2024-07-11,Senate,"Senate Floor: HB 663 PN 2229, Final Passage",49,0,0,1,50
1744940,1414617,2024-03-25,House,"House Insurance: Adopt Amendment A02842",25,0,0,0,25
1744940,1414618,2024-03-25,House,"House Insurance: Report Bill As Amended",25,0,0,0,25
1744940,1421755,2024-04-08,House,"House Floor: HB 660 PN 2785, FINAL PASSAGE",201,0,0,1,202
1744940,1421756,2024-04-08,House,"House Appropriations: Re-report Bill As Committed",37,0,0,0,37
1744940,1439913,2024-05-07,Senate,"Senate Banking And Insurance: Reported as Committed",14,0,0,0,14
1744940,1452922,2024-06-03,Senate,"Senate Floor: HB 660 PN 2785, Final Passage",50,0,0,0,50
1744940,1452923,2024-06-03,Senate,"Senate Appropriations: Re-Reported as Committed",24,0,0,0,24
1745589,1316015,2023-05-02,House,"House Children And Youth: Adopt Amendment A00366",21,0,0,0,21
1745589,1316016,2023-05-02,House,"House Children And Youth: Adopt Amendment A00412",21,0,0,0,21
1745589,1316017,2023-05-02,House,"House Children And Youth: Report Bill As Amended",20,1,0,0,21
1745589,1342546,2023-06-12,House,"House Floor: HB 664 PN 1094, FINAL PASSAGE",155,48,0,0,203
1745589,1342547,2023-06-12,House,"House Appropriations: Re-report Bill As Committed",37,0,0,0,37
1745622,1349875,2023-07-07,House,"House Judiciary: Adopt Amendment A01809",21,0,0,0,21
1745622,1349876,2023-07-07,House,"House Judiciary: Re-report Bill As Amended",21,0,0,0,21
1745669,1410830,2024-03-19,House,"House Consumer Protection, Technology And Utilities: Re-refer Bill To Another Committee",25,0,0,0,25
1745690,1300389,2023-04-13,House,"House Education: Adopt Amendment A00189",21,0,0,0,21
1745690,1300390,2023-04-13,House,"House Education: Report Bill As Amended A00189",17,3,1,0,21
1745690,1310098,2023-04-25,House,"House Education: Report Bill As Amended",17,4,0,0,21
1745690,1347455,2023-06-26,House,"House Floor: HB 668 PN 956, 2023 A1186",202,1,0,0,203
1745690,1347598,2023-06-27,House,"House Appropriations: Re-report Bill As Committed",37,0,0,0,37
1745690,1347785,2023-06-27,House,"House Floor: HB 668 PN 1719, FINAL PASSAGE",203,0,0,0,203
1745764,1301357,2023-04-13,House,"House Housing And Community Development: Bring Up The Bill For Consideration",21,0,0,0,21
1745764,1315901,2023-05-01,House,"House Floor: HB 666 PN 609, FINAL PASSAGE",172,29,0,0,201
1745764,1315902,2023-05-01,House,"House Appropriations: Re-report Bill As Committed",37,0,0,0,37
1745764,1362405,2023-12-11,Senate,"Senate Urban Affairs And Housing: Reported as Committed",8,1,2,0,11
1745764,1362500,2023-12-13,Senate,"Senate Appropriations: Re-Reported as Committed",23,1,0,0,24
1745764,1362656,2023-12-13,Senate,"Senate Floor: HB 666 PN 609, Final Passage",43,7,0,0,50
1745821,1340643,2023-06-07,House,"House Children And Youth: Bring Up The Bill For Consideration",20,0,1,0,21
1745821,1340644,2023-06-07,House,"House Children And Youth: Adopt Amendment A00752",20,0,1,0,21
1745821,1340645,2023-06-07,House,"House Children And Youth: Adopt Amendment A00806",20,0,1,0,21
1745821,1340646,2023-06-07,House,"House Children And Youth: Report Bill As Amended",20,0,1,0,21
1745821,1346018,2023-06-21,House,"House Rules: Re-report Bill As Committed",33,0,0,0,33
1745821,1346457,2023-06-22,House,"House Appropriations: Re-report Bill As Committed",37,0,0,0,37
1745821,1346876,2023-06-22,House,"House Floor: HB 665 PN 1470, FINAL PASSAGE",176,27,0,0,203
1746114,1309961,2023-04-25,House,"House Education: Adopt Amendment A00329",21,0,0,0,21
1746114,1310694,2023-04-25,House,"House Education: Adopt Amendment A00324",21,0,0,0,21
1746114,1315279,2023-05-01,House,"House Floor: HB 688 PN 1036, 2023 A360, MOTION TO APPEAL RULING OF THE CHAIR",101,100,0,0,201
1746114,1315280,2023-05-01,House,"House Floor: HB 688 PN 1036, MOTION TO RECOMMIT",100,101,0,0,201
1746114,1315281,2023-05-01,House,"House Floor: HB 688 PN 1036, 2023 A359",100,101,0,0,201
1746114,1315282,2023-05-01,House,"House Floor: HB 688 PN 1036, 2023 A358",94,107,0,0,201
1746114,1316059,2023-05-02,House,"House Appropriations: Re-report Bill As Committed",22,15,0,0,37
1746114,1316710,2023-05-02,House,"House Floor: HB 688 PN 1036, FINAL PASSAGE",119,81,0,1,201
1746449,1317460,2023-05-03,House,"House Judiciary: Adopt Amendment A00373",20,0,1,0,21
1746449,1317461,2023-05-03,House,"House Judiciary: Adopt Amendment A00413",20,0,1,0,21
1746449,1317462,2023-05-03,House,"House Judiciary: Report Bill As Amended",20,0,1,0,21
1746449,1332050,2023-05-24,House,"House Floor: HB 689 PN 1139, 2023 A531",201,0,0,0,201
1746449,1332051,2023-05-24,House,"House Floor: HB 689 PN 1139, 2023 A679, MOTION TO SUSPEND RULES",201,0,0,0,201
1746449,1332052,2023-05-24,House,"House Floor: HB 689 PN 1139, 2023 A679",201,0,0,0,201
1746449,1339072,2023-06-05,House,"House Floor: HB 689 PN 1360, FINAL PASSAGE",189,14,0,0,203
1746449,1340441,2023-06-05,House,"House Appropriations: Re-report Bill As Committed",37,0,0,0,37
1746449,1354936,2023-09-19,Senate,"Senate Judiciary: Adopt Amendment A01990",12,2,0,0,14
1746449,1354937,2023-09-19,Senate,"Senate Judiciary: Reported as Amended",12,2,0,0,14
1746449,1362594,2023-12-13,House,"House Floor: HB 689 PN 2310, CONCURRENCE",153,50,0,0,203
1746449,1362595,2023-12-13,Senate,"Senate Floor: HB 689 PN 2310, Final Passage",47,3,0,0,50
1746449,1362596,2023-12-13,Senate,"Senate Appropriations: Re-Reported as Committed",24,0,0,0,24
1746449,1362597,2023-12-13,House,"House Rules: Re-report Bill As Committed",33,0,0,0,33
1747640,1347982,2023-06-28,House,"House Judiciary: Adopt Amendment A01371",12,9,0,0,21
1747640,1347983,2023-06-28,House,"House Judiciary: Report Bill As Amended",12,9,0,0,21
1747640,1349684,2023-07-06,House,"House Floor: HB 716 PN 1763, 2023 A1581",202,1,0,0,203
1747640,1349685,2023-07-06,House,"House Floor: HB 716 PN 1763, 2023 A1585",103,100,0,0,203
1747640,1349686,2023-07-06,House,"House Rules: Re-report Bill As Committed",18,15,0,0,33
1747640,1349885,2023-07-07,House,"House Floor: HB 716 PN 1824, FINAL PASSAGE",103,100,0,0,203
1747640,1349886,2023-07-07,House,"House Appropriations: Re-report Bill As Committed",37,0,0,0,37
1747694,1339041,2023-06-05,House,"House State Government: Report Bill As Committed",12,9,0,0,21
1747694,1345819,2023-06-21,House,"House Floor: HR 47 PN 666, 2023 A1150",101,102,0,0,203
1747694,1345820,2023-06-21,House,"House Floor: HR 47 PN 666, 2023 A1153",101,102,0,0,203
1747694,1345821,2023-06-21,House,"House Floor: HR 47 PN 666, 2023 A1154",101,102,0,0,203
1747694,1345822,2023-06-21,House,"House Floor: HR 47 PN 666",102,101,0,0,203
1747728,1311199,2023-04-26,House,"House Judiciary: Report Bill As Committed",12,9,0,0,21
1747728,1317768,2023-05-03,House,"House Floor: HB 714 PN 660, 2023 A418, GERMANENESS OF AMENDMENT",100,101,0,0,201
1747728,1317769,2023-05-03,House,"House Floor: HB 714 PN 660, 2023 A425",127,74,0,0,201
1747728,1317770,2023-05-03,House,"House Floor: HB 714 PN 660, 2023 A459",141,60,0,0,201
1747728,1329817,2023-05-22,House,"House Floor: HB 714 PN 1150, FINAL PASSAGE",109,92,0,0,201
1747728,1329818,2023-05-22,House,"House Appropriations: Re-report Bill As Committed",23,14,0,0,37
1747786,1332408,2023-05-24,House,"House Housing And Community Development: Bring Up The Bill For Consideration",21,0,0,0,21
1747786,1342560,2023-06-12,House,"House Floor: HB 711 PN 657, FINAL PASSAGE",110,93,0,0,203
1747786,1342561,2023-06-12,House,"House Appropriations: Re-report Bill As Committed",37,0,0,0,37
1747823,1312948,2023-04-25,House,"House Environmental Resources And Energy: Report Bill As Committed",21,0,0,0,21
1747823,1340794,2023-06-07,House,"House Floor: HB 718 PN 664, FINAL PASSAGE",203,0,0,0,203
1747823,1340795,2023-06-07,House,"House Appropriations: Re-report Bill As Committed",37,0,0,0,37
1747966,1310786,2023-04-26,House,"House Judiciary: Adopt Amendment A00241",12,9,0,0,21
1747966,1310787,2023-04-26,House,"House Judiciary: Report Bill As Amended",12,9,0,0,21
1747966,1317572,2023-05-03,House,"House Floor: HB 731 PN 1091, 2023 A433, MOTION TO APPEAL RULING OF THE CHAIR",101,100,0,0,201
1747966,1329939,2023-05-22,House,"House Appropriations: Re-report Bill As Committed",22,15,0,0,37
1748710,1340606,2023-06-07,House,"House Judiciary: Report Bill As Committed",21,0,0,0,21
1748751,1356727,2023-10-31,House,"House Judiciary: Report Bill As Committed",25,0,0,0,25
1748752,1311339,2023-04-26,House,"House Human Services: Re-refer Bill To Another Committee",21,0,0,0,21
1748752,1339150,2023-06-06,House,"House Health: Report Bill As Committed",21,0,0,0,21
1748752,1356077,2023-10-16,House,"House Rules: Re-report Bill As Amended",33,0,0,0,33
1748752,1356209,2023-10-18,House,"House Floor: HB 754 PN 703, FINAL PASSAGE",203,0,0,0,203
1748752,1356210,2023-10-18,House,"House Appropriations: Re-report Bill As Committed",37,0,0,0,37
1748804,1452605,2024-06-03,House,"House Education: Adopt Amendment A04612",25,0,0,0,25
1748804,1453404,2024-06-03,House,"House Education: Report Bill As Amended",23,2,0,0,25
1748889,1347398,2023-06-22,House,"House Finance: Adopt Amendment A01266",21,0,0,0,21
1748889,1347399,2023-06-22,House,"House Finance: Re-report Bill As Amended",12,9,0,0,21
1748899,1308219,2023-04-24,House,"House Insurance: Report Bill As Committed",21,0,0,0,21
1748899,1315445,2023-05-01,House,"House Floor: HB 739 PN 688, FINAL PASSAGE",201,0,0,0,201
1748899,1315446,2023-05-01,House,"House Appropriations: Re-report Bill As Committed",37,0,0,0,37
1748899,1338616,2023-06-05,Senate,"Senate Banking And Insurance: Reported as Committed",14,0,0,0,14
1748899,1340565,2023-06-07,Senate,"Senate Floor: HB 739 PN 688, Final Passage",50,0,0,0,50
1748899,1340566,2023-06-07,Senate,"Senate Appropriations: Re-Reported as Committed",24,0,0,0,24
1748925,1459827,2024-06-25,Senate,"Senate Consumer Protection And Professional Licensure: Reported as Amended",14,0,0,0,14
1748925,1459828,2024-06-25,Senate,"Senate Consumer Protection And Professional Licensure: Adopt Amendment A05106",14,0,0,0,14
1748935,1332139,2023-05-24,House,"House Judiciary: Report Bill As Committed",21,0,0,0,21
1748973,1308492,2023-04-24,House,"House Insurance: Report Bill As Committed",21,0,0,0,21
1748973,1315487,2023-05-01,House,"House Floor: HB 735 PN 684, FINAL PASSAGE",166,35,0,0,201
1748973,1315488,2023-05-01,House,"House Appropriations: Re-report Bill As Committed",37,0,0,0,37
1748973,1347964,2023-06-27,Senate,"Senate Banking And Insurance: Reported as Amended",13,0,1,0,14
1748973,1347965,2023-06-27,Senate,"Senate Banking And Insurance: Adopt Amendment A01475",13,0,1,0,14
1748973,1356106,2023-10-17,Senate,"Senate Appropriations: Re-Reported as Committed",23,0,1,0,24
1748973,1356462,2023-10-24,Senate,"Senate Floor: HB 735 PN 1739, 2023 A2638, PITTMAN Amendment No. A-2638",50,0,0,0,50
1748973,1356508,2023-10-25,Senate,"Senate Floor: HB 735 PN 2210, Motion to Suspend Rule 12",49,1,0,0,50
1748973,1356509,2023-10-25,Senate,"Senate Floor: HB 735 PN 2210, Final Passage",50,0,0,0,50
1748973,1356657,2023-10-30,House,"House Floor: HB 735 PN 2210, CONCURRENCE",151,51,0,1,203
1748973,1356658,2023-10-30,House,"House Rules: Re-report Bill As Committed",33,0,0,0,33
1748975,1316151,2023-05-02,Senate,"Senate Health And Human Services: Reported as Amended",11,0,0,0,11
1748975,1316152,2023-05-02,Senate,"Senate Health And Human Services: Adopt Amendment A00374",11,0,0,0,11
1748996,1339183,2023-06-06,Senate,"Senate Health And Human Services: Reported as Amended",7,3,1,0,11
1748996,1339184,2023-06-06,Senate,"Senate Health And Human Services: Adopt Amendment A00263",10,0,1,0,11
1749016,1362565,2023-12-13,Senate,"Senate Consumer Protection And Professional Licensure: Adopt Amendment A02615",14,0,0,0,14
1749016,1362566,2023-12-13,Senate,"Senate Consumer Protection And Professional Licensure: Reported as Amended A02615",14,0,0,0,14
1749016,1410245,2024-03-18,Senate,"Senate Floor: SB 560 PN 1293, Final Passage",47,1,0,2,50
1749016,1410246,2024-03-18,Senate,"Senate Appropriations: Re-Reported as Committed",23,0,1,0,24
1749016,1439986,2024-05-07,House,"House Professional Licensure: Report Bill As Committed",23,2,0,0,25
1749016,1462754,2024-07-09,House,"House Appropriations: Re-report Bill As Committed",37,0,0,0,37
1749016,1463028,2024-07-11,House,"House Floor: SB 560 PN 1293, FINAL PASSAGE",201,1,0,1,203
1749019,1345157,2023-06-19,Senate,"Senate Appropriations: Reported as Amended",24,0,0,0,24
1749019,1345158,2023-06-19,Senate,"Senate Appropriations: Adopt Amendment A01125",24,0,0,0,24
1749019,1345953,2023-06-21,Senate,"Senate Floor: SB 483 PN 908, Final Passage",50,0,0,0,50
1749025,1345151,2023-06-19,Senate,"Senate Appropriations: Reported as Amended",24,0,0,0,24
1749025,1345152,2023-06-19,Senate,"Senate Appropriations: Adopt Amendment A00735",24,0,0,0,24
1749025,1345944,2023-06-21,Senate,"Senate Floor: SB 485 PN 910, Final Passage",50,0,0,0,50
1749036,1310806,2023-04-26,Senate,"Senate Transportation: Reported as Committed",10,3,1,0,14
1749036,1346053,2023-06-21,Senate,"Senate Floor: SB 562 PN 570, Final Passage",31,19,0,0,50
1749036,1346054,2023-06-21,Senate,"Senate Appropriations: Re-Reported as Committed",15,9,0,0,24
1749043,1345153,2023-06-19,Senate,"Senate Appropriations: Reported as Amended",24,0,0,0,24
1749043,1345154,2023-06-19,Senate,"Senate Appropriations: Adopt Amendment A00734",24,0,0,0,24
1749043,1346332,2023-06-21,Senate,"Senate Floor: SB 486 PN 911, Final Passage",50,0,0,0,50
1749046,1345159,2023-06-19,Senate,"Senate Appropriations: Reported as Amended",24,0,0,0,24
1749046,1345160,2023-06-19,Senate,"Senate Appropriations: Adopt Amendment A00881",24,0,0,0,24
1749046,1345963,2023-06-21,Senate,"Senate Floor: SB 481 PN 906, Final Passage",50,0,0,0,50
1749058,1339675,2023-06-06,Senate,"Senate Education: Reported as Amended",7,4,0,0,11
1749058,1339676,2023-06-06,Senate,"Senate Education: Adopt Amendment A00797",11,0,0,0,11
1749062,1311118,2023-04-26,Senate,"Senate Transportation: Reported as Committed",10,3,1,0,14
1749062,1345775,2023-06-21,Senate,"Senate Appropriations: Re-Reported as Committed",15,9,0,0,24
1749062,1346073,2023-06-21,Senate,"Senate Floor: SB 561 PN 559, Final Passage",32,18,0,0,50
1749067,1345174,2023-06-19,Senate,"Senate Appropriations: Reported as Amended",24,0,0,0,24
1749067,1345175,2023-06-19,Senate,"Senate Appropriations: Adopt Amendment A00882",24,0,0,0,24
1749067,1346099,2023-06-21,Senate,"Senate Floor: SB 484 PN 909, Final Passage",50,0,0,0,50
1749070,1316143,2023-05-02,Senate,"Senate Health And Human Services: Reported as Committed",11,0,0,0,11
1749081,1345155,2023-06-19,Senate,"Senate Appropriations: Reported as Amended",24,0,0,0,24
1749081,1345156,2023-06-19,Senate,"Senate Appropriations: Adopt Amendment A00885",24,0,0,0,24
1749081,1345952,2023-06-21,Senate,"Senate Floor: SB 489 PN 914, Final Passage",50,0,0,0,50
1749093,1362497,2023-12-13,Senate,"Senate Consumer Protection And Professional Licensure: Reported as Amended A02614",14,0,0,0,14
1749093,1362498,2023-12-13,Senate,"Senate Consumer Protection And Professional Licensure: Adopt Amendment A02614",14,0,0,0,14
1749093,1410212,2024-03-18,Senate,"Senate Floor: SB 559 PN 1292, Final Passage",47,1,0,2,50
1749093,1410213,2024-03-18,Senate,"Senate Appropriations: Re-Reported as Committed",23,0,1,0,24
1749093,1440347,2024-05-07,House,"House Professional Licensure: Report Bill As Committed",23,2,0,0,25
1749093,1462804,2024-07-09,House,"House Appropriations: Re-report Bill As Committed",37,0,0,0,37
1749093,1462980,2024-07-11,House,"House Floor: SB 559 PN 1292, FINAL PASSAGE",201,1,0,1,203
1749111,1310741,2023-04-26,Senate,"Senate Veterans Affairs And Emergency Preparedness: Reported as Committed",11,0,0,0,11
1749112,1355525,2023-10-03,Senate,"Senate Judiciary: Reported as Amended",9,5,0,0,14
1749112,1355526,2023-10-03,Senate,"Senate Judiciary: Adopt Amendment A02265",11,3,0,0,14
1749116,1345163,2023-06-19,Senate,"Senate Appropriations: Reported as Amended",24,0,0,0,24
1749116,1345164,2023-06-19,Senate,"Senate Appropriations: Adopt Amendment A00845",24,0,0,0,24
1749116,1345968,2023-06-21,Senate,"Senate Floor: SB 487 PN 912, Final Passage",50,0,0,0,50
1749121,1345167,2023-06-19,Senate,"Senate Appropriations: Reported as Amended",24,0,0,0,24
1749121,1345168,2023-06-19,Senate,"Senate Appropriations: Adopt Amendment A00884",24,0,0,0,24
1749121,1345970,2023-06-21,Senate,"Senate Floor: SB 488 PN 913, Final Passage",50,0,0,0,50
1749123,1345165,2023-06-19,Senate,"Senate Appropriations: Reported as Amended",24,0,0,0,24
1749123,1345166,2023-06-19,Senate,"Senate Appropriations: Adopt Amendment A00896",24,0,0,0,24
1749123,1345903,2023-06-21,Senate,"Senate Floor: SB 482 PN 907, Final Passage",50,0,0,0,50
1749420,1339527,2023-06-06,House,"House Agriculture And Rural Affairs: Adopt Amendment A00751",20,1,0,0,21
1749420,1339528,2023-06-06,House,"House Agriculture And Rural Affairs: Report Bill As Amended",12,9,0,0,21
1749420,1345224,2023-06-20,House,"House Rules: Re-report Bill As Committed",18,15,0,0,33
1749420,1346090,2023-06-21,House,"House Floor: HB 767 PN 1457, FINAL PASSAGE",102,101,0,0,203
1749420,1346091,2023-06-21,House,"House Appropriations: Re-report Bill As Committed",37,0,0,0,37
1749439,1461035,2024-06-26,House,"House Local Government: Adopt Amendment A05126",14,11,0,0,25
1749439,1461036,2024-06-26,House,"House Local Government: Report Bill As Amended",14,11,0,0,25
1749474,1331784,2023-05-24,House,"House Housing And Community Development: Bring Up Bill For Consideration As Amended",21,0,0,0,21
1749474,1331785,2023-05-24,House,"House Housing And Community Development: Adopt Amendment A00540",21,0,0,0,21
1749474,1357735,2023-11-15,House,"House Floor: HB 775 PN 1357, FINAL PASSAGE",177,26,0,0,203
1749474,1357736,2023-11-15,House,"House Appropriations: Re-report Bill As Committed",37,0,0,0,37
1749474,1424234,2024-04-10,Senate,"Senate Urban Affairs And Housing: Reported as Committed",10,1,0,0,11
1749489,1318638,2023-05-03,House,"House Tourism And Economic And Recreational Development: Report Bill As Committed",19,0,2,0,21
1749489,1333058,2023-05-24,House,"House Floor: HR 51 PN 741",201,0,0,0,201
1749551,1366141,2024-01-17,House,"House Judiciary: Adopt Amendment A03383",14,11,0,0,25
1749551,1366142,2024-01-17,House,"House Judiciary: Report Bill As Amended",14,11,0,0,25
1749551,1416238,2024-03-27,House,"House Floor: HB 777 PN 2578, CONSTITUTIONALITY",101,100,0,1,202
1749551,1416239,2024-03-27,House,"House Floor: HB 777 PN 2578, FINAL PASSAGE",104,97,0,1,202
1749551,1416240,2024-03-27,House,"House Appropriations: Re-report Bill As Committed",22,14,1,0,37
1749588,1308316,2023-04-24,House,"House Labor And Industry: Adopt Amendment A00275",12,9,0,0,21
1749588,1308317,2023-04-24,House,"House Labor And Industry: Report Bill As Amended",12,9,0,0,21
1749588,1316293,2023-05-02,House,"House Floor: HB 760 PN 963, FINAL PASSAGE",114,86,0,1,201
1749588,1316294,2023-05-02,House,"House Appropriations: Re-report Bill As Committed",22,15,0,0,37
1749608,1319059,2023-05-03,House,"House Tourism And Economic And Recreational Development: Report Bill As Committed",21,0,0,0,21
1749615,1343151,2023-06-12,House,"House Transportation: Report Bill As Committed",21,0,0,0,21
1749644,1311558,2023-04-26,House,"House Human Services: Adopt Resolution as Amended",21,0,0,0,21
1749644,1311559,2023-04-26,House,"House Human Services: Adopt Amendment A00302",21,0,0,0,21
1749644,1318154,2023-05-03,House,"House Floor: HR 50 PN 1040",201,0,0,0,201
1749670,1330253,2023-05-22,House,"House Health: Report Bill As Committed",21,0,0,0,21
1749907,1331886,2023-05-24,House,"House Housing And Community Development: Bring Up The Bill For Consideration",21,0,0,0,21
1749907,1340839,2023-06-07,House,"House Floor: HB 788 PN 737, 2023 A860, MOTION TO APPEAL RULING OF THE CHAIR",102,101,0,0,203
1749907,1340840,2023-06-07,House,"House Floor: HB 788 PN 737, 2023 A827, CONSTITUTIONALITY",101,102,0,0,203
1749907,1340841,2023-06-07,House,"House Floor: HB 788 PN 737, 2023 A842",101,102,0,0,203
1749907,1342542,2023-06-12,House,"House Floor: HB 788 PN 737, FINAL PASSAGE",103,100,0,0,203
1749907,1342543,2023-06-12,House,"House Appropriations: Re-report Bill As Committed",37,0,0,0,37
1750042,1319057,2023-05-03,House,"House Tourism And Economic And Recreational Development: Report Bill As Committed",21,0,0,0,21
1750042,1347585,2023-06-27,House,"House Floor: HR 58 PN 748",202,1,0,0,203
1750582,1319190,2023-05-03,House,"House Local Government: Report Bill As Committed",21,0,0,0,21
1750582,1339073,2023-06-05,House,"House Floor: HB 787 PN 736, 2023 A515, MOTION TO SUSPEND RULES",101,102,0,0,203
1750582,1339254,2023-06-06,House,"House Floor: HB 787 PN 736, FINAL PASSAGE",125,78,0,0,203
1750582,1340583,2023-06-06,House,"House Appropriations: Re-report Bill As Committed",37,0,0,0,37
1750842,1308170,2023-04-24,House,"House Transportation: Report Bill As Committed",21,0,0,0,21
1750842,1330314,2023-05-23,House,"House Appropriations: Re-report Bill As Committed",37,0,0,0,37
1750842,1331152,2023-05-23,House,"House Floor: HB 797 PN 757, FINAL PASSAGE",201,0,0,0,201
1750842,1347756,2023-06-27,Senate,"Senate Transportation: Reported as Committed",14,0,0,0,14
1750842,1354930,2023-09-19,Senate,"Senate Appropriations: Re-Reported as Amended",23,0,1,0,24
1750842,1354931,2023-09-19,Senate,"Senate Appropriations: Adopt Amendment A01956",23,0,1,0,24
1750842,1355012,2023-09-20,Senate,"Senate Floor: HB 797 PN 2002, Final Passage",45,2,0,3,50
1750842,1459761,2024-06-25,House,"House Floor: HB 797 PN 2002, CONCURRENCE",202,0,0,1,203
1750842,1459762,2024-06-25,House,"House Rules: Re-report Bill As Committed",33,0,0,0,33
1751004,1341375,2023-06-07,Senate,"Senate Floor: SR 74 PN 579",50,0,0,0,50
1751004,1341376,2023-06-07,Senate,"Senate Rules And Executive Nominations: Reported as Committed",17,0,0,0,17
1751047,1346077,2023-06-21,House,"House Consumer Protection, Technology And Utilities: Adopt Amendment A00810",21,0,0,0,21
1751047,1346078,2023-06-21,House,"House Consumer Protection, Technology And Utilities: Report Bill As Amended",20,1,0,0,21
1751047,1347597,2023-06-27,House,"House Rules: Re-report Bill As Committed",32,0,1,0,33
1751047,1347784,2023-06-27,House,"House Floor: HB 791 PN 1652, 2023 A1313",194,9,0,0,203
1751047,1348103,2023-06-28,House,"House Floor: HB 791 PN 1754, FINAL PASSAGE",119,84,0,0,203
1751047,1348104,2023-06-28,House,"House Appropriations: Re-report Bill As Committed",37,0,0,0,37
1751701,1343927,2023-06-14,House,"House Health: Report Bill As Committed",20,1,0,0,21
1751701,1348188,2023-06-28,House,"House Floor: HB 807 PN 765, 2023 A1514, MOTION TO APPEAL RULING OF THE CHAIR",102,101,0,0,203
1751701,1348189,2023-06-28,House,"House Floor: HB 807 PN 765, 2023 A1498, MOTION TO APPEAL RULING OF THE CHAIR",102,101,0,0,203
1751701,1348190,2023-06-28,House,"House Rules: Re-report Bill As Committed",33,0,0,0,33
1751701,1348604,2023-06-29,House,"House Appropriations: Re-report Bill As Committed",22,15,0,0,37
1751701,1348796,2023-06-29,House,"House Floor: HB 807 PN 765, FINAL PASSAGE",106,97,0,0,203
1751743,1311166,2023-04-26,House,"House Veterans Affairs And Emergency Preparedness: Re-refer Bill To Another Committee",21,0,0,0,21
1751743,1330013,2023-05-22,House,"House Education: Report Bill As Committed",21,0,0,0,21
1751743,1331254,2023-05-23,House,"House Floor: HB 804 PN 762, 2023 A561",201,0,0,0,201
1751743,1332406,2023-05-24,House,"House Floor: HB 804 PN 1305, FINAL PASSAGE",201,0,0,0,201
1751743,1332407,2023-05-24,House,"House Appropriations: Re-report Bill As Committed",37,0,0,0,37
1751743,1347450,2023-06-26,Senate,"Senate Veterans Affairs And Emergency Preparedness: Reported as Committed",11,0,0,0,11
1751743,1347746,2023-06-27,Senate,"Senate Floor: HB 804 PN 1305, Motion to Agree to the Bill on Second Consideration",49,0,0,1,50
1751743,1348242,2023-06-28,Senate,"Senate Appropriations: Re-Reported as Committed",24,0,0,0,24
1751743,1355758,2023-10-04,Senate,"Senate Floor: HB 804 PN 1305, Final Passage",50,0,0,0,50
1752037,1343929,2023-06-14,House,"House Health: Report Bill As Amended",19,2,0,0,21
1752037,1343930,2023-06-14,House,"House Health: Adopt Amendment A00928",21,0,0,0,21
1752037,1347389,2023-06-26,House,"House Rules: Re-report Bill As Committed",33,0,0,0,33
1752037,1347471,2023-06-26,House,"House Floor: HB 818 PN 1592, 2023 A1083",103,100,0,0,203
1752037,1347631,2023-06-27,House,"House Appropriations: Re-report Bill As Committed",37,0,0,0,37
1752037,1347958,2023-06-27,House,"House Floor: HB 818 PN 1720, FINAL PASSAGE",102,101,0,0,203
1752067,1309388,2023-04-24,House,"House State Government: Report Bill As Committed",12,9,0,0,21
1752067,1339074,2023-06-05,House,"House Floor: HB 815 PN 772, 2023 A676",101,102,0,0,203
1752067,1339075,2023-06-05,House,"House Floor: HB 815 PN 772, 2023 A699",101,102,0,0,203
1752067,1339492,2023-06-06,House,"House Floor: HB 815 PN 772, FINAL PASSAGE",102,101,0,0,203
1752067,1340396,2023-06-06,House,"House Appropriations: Re-report Bill As Committed",37,0,0,0,37
1752130,1330602,2023-05-23,House,"House Labor And Industry: Adopt Amendment A00575",9,12,0,0,21
1752130,1330603,2023-05-23,House,"House Labor And Industry: Report Bill As Committed",12,9,0,0,21
1752130,1339077,2023-06-05,House,"House Floor: HR 60 PN 785, 2023 A670",93,110,0,0,203
1752130,1339078,2023-06-05,House,"House Floor: HR 60 PN 785, 2023 A611, GERMANENESS OF AMENDMENT",101,102,0,0,203
1752130,1339079,2023-06-05,House,"House Floor: HR 60 PN 785, 2023 A677, GERMANENESS OF AMENDMENT",101,102,0,0,203
1752130,1339080,2023-06-05,House,"House Floor: HR 60 PN 785",139,64,0,0,203
1752147,1410229,2024-03-18,House,"House Transportation: Report Bill As Amended",25,0,0,0,25
1752147,1410230,2024-03-18,House,"House Transportation: Adopt Amendment A03572",25,0,0,0,25
1752147,1424281,2024-04-10,House,"House Floor: HB 816 PN 2732, FINAL PASSAGE",200,0,0,2,202
1752147,1424282,2024-04-10,House,"House Appropriations: Re-report Bill As Committed",37,0,0,0,37
1752147,1460299,2024-06-26,Senate,"Senate Transportation: Reported as Committed",14,0,0,0,14
1752147,1462380,2024-07-02,Senate,"Senate Floor: HB 816 PN 2732, Final Passage",50,0,0,0,50
1752147,1462381,2024-07-02,Senate,"Senate Appropriations: Re-Reported as Committed",24,0,0,0,24
1752158,1301358,2023-04-13,House,"House Housing And Community Development: Bring Up The Bill For Consideration",21,0,0,0,21
1752158,1309419,2023-04-25,House,"House Floor: HR 61 PN 786",201,0,0,0,201
1752178,1356055,2023-10-16,House,"House Transportation: Report Bill As Amended",25,0,0,0,25
1752178,1356056,2023-10-16,House,"House Transportation: Adopt Amendment A02492",25,0,0,0,25
1752178,1356656,2023-10-30,House,"House Floor: HB 826 PN 2126, FINAL PASSAGE",202,0,0,1,203
1752178,1356699,2023-10-30,House,"House Appropriations: Re-report Bill As Committed",37,0,0,0,37
1752200,1343937,2023-06-14,House,"House Health: Report Bill As Committed",20,1,0,0,21
1752200,1347386,2023-06-26,House,"House Rules: Re-report Bill As Committed",33,0,0,0,33
1752200,1347611,2023-06-27,House,"House Appropriations: Re-report Bill As Committed",37,0,0,0,37
1752200,1347947,2023-06-27,House,"House Floor: HB 817 PN 774, FINAL PASSAGE",102,101,0,0,203
1752228,1339345,2023-06-05,House,"House State Government: Report Bill As Committed",12,9,0,0,21
1752758,1310841,2023-04-26,House,"House Liquor Control: Adopt Amendment A00207",21,0,0,0,21
1752758,1310842,2023-04-26,House,"House Liquor Control: Report Bill As Amended",21,0,0,0,21
1752758,1317588,2023-05-03,House,"House Floor: HB 829 PN 1039, FINAL PASSAGE",199,2,0,0,201
1752758,1317589,2023-05-03,House,"House Appropriations: Re-report Bill As Committed",37,0,0,0,37
1752758,1460210,2024-06-26,Senate,"Senate Law And Justice: Reported as Amended",11,0,0,0,11
1752758,1460211,2024-06-26,Senate,"Senate Law And Justice: Adopt Amendment A05254",11,0,0,0,11
1752758,1460977,2024-06-27,Senate,"Senate Floor: HB 829 PN 3417, 2023 A5284, SANTARSIERO Amendment No. A-5284",47,2,0,1,50
1752758,1461931,2024-07-01,Senate,"Senate Appropriations: Re-Reported as Committed",24,0,0,0,24
1752758,1462187,2024-07-02,Senate,"Senate Floor: HB 829 PN 3426, Final Passage",47,3,0,0,50
1752758,1462395,2024-07-03,House,"House Rules: Re-report Bill As Committed",33,0,0,0,33
1752758,1462433,2024-07-03,House,"House Floor: HB 829 PN 3426, CONCURRENCE",202,0,0,1,203
1752839,1345799,2023-06-21,House,"House Judiciary: Report Bill As Committed",12,9,0,0,21
1752839,1348610,2023-06-29,House,"House Rules: Re-report Bill As Committed",18,15,0,0,33
1752839,1348805,2023-06-29,House,"House Floor: HB 841 PN 814, 2023 A1572",203,0,0,0,203
1752839,1349677,2023-07-06,House,"House Appropriations: Re-report Bill As Committed",37,0,0,0,37
1752839,1349715,2023-07-06,House,"House Floor: HB 841 PN 1801, FINAL PASSAGE",102,101,0,0,203
1752987,1345807,2023-06-21,Senate,"Senate Law And Justice: Reported as Amended",10,1,0,0,11
1752987,1345808,2023-06-21,Senate,"Senate Law And Justice: Adopt Amendment A00804",10,1,0,0,11
1753056,1356219,2023-10-18,House,"House Commerce: Adopt Amendment A02552",14,11,0,0,25
1753056,1356220,2023-10-18,House,"House Commerce: Report Bill As Amended A02552",14,11,0,0,25
1753056,1356781,2023-10-31,House,"House Floor: HB 842 PN 2167, 2023 A2678",100,102,0,1,203
1753056,1356782,2023-10-31,House,"House Floor: HB 842 PN 2167, 2023 A2697",101,101,0,1,203
1753056,1356783,2023-10-31,House,"House Floor: HB 842 PN 2167, 2023 A2664, MOTION TO APPEAL RULING OF THE CHAIR",102,100,0,1,203
1753056,1356784,2023-10-31,House,"House Floor: HB 842 PN 2167, 2023 A2704, MOTION TO APPEAL RULING OF THE CHAIR",102,100,0,1,203
1753056,1356785,2023-10-31,House,"House Floor: HB 842 PN 2167, 2023 A2700, MOTION TO APPEAL RULING OF THE CHAIR",102,100,0,1,203
1753056,1357461,2023-11-13,House,"House Floor: HB 842 PN 2167, FINAL PASSAGE",102,101,0,0,203
1753056,1357462,2023-11-13,House,"House Appropriations: Re-report Bill As Committed",37,0,0,0,37
1753181,1309412,2023-04-24,House,"House State Government: Report Bill As Amended",12,9,0,0,21
1753181,1309413,2023-04-24,House,"House State Government: Adopt Amendment A00289",12,9,0,0,21
1753181,1436637,2024-04-30,House,"House Floor: HB 847 PN 1019, 2023 A4212",102,98,0,2,202
1753181,1437198,2024-05-01,House,"House Appropriations: Re-report Bill As Committed",22,14,1,0,37
1753181,1437446,2024-05-01,House,"House Floor: HB 847 PN 3018, FINAL PASSAGE",102,99,0,1,202
1753197,1343920,2023-06-13,House,"House Housing And Community Development: Adopt Amendment A00812",12,9,0,0,21
1753197,1343921,2023-06-13,House,"House Housing And Community Development: Report Bill As Amended",12,9,0,0,21
1753197,1347418,2023-06-26,House,"House Floor: HR 66 PN 1564",110,93,0,0,203
1753364,1355725,2023-10-04,House,"House Judiciary: Adopt Amendment A02332",25,0,0,0,25
1753364,1355726,2023-10-04,House,"House Judiciary: Report Bill As Amended",15,10,0,0,25
1753364,1357428,2023-11-13,House,"House Floor: HB 863 PN 2105, 2023 A2766",102,101,0,0,203
1753364,1357636,2023-11-14,House,"House Floor: HB 863 PN 2285, FINAL PASSAGE",115,88,0,0,203
1753364,1357637,2023-11-14,House,"House Appropriations: Re-report Bill As Committed",22,15,0,0,37
1753364,1362291,2023-12-11,Senate,"Senate Law And Justice: Reported as Amended",11,0,0,0,11
1753364,1362292,2023-12-11,Senate,"Senate Law And Justice: Adopt Amendment A03263",11,0,0,0,11
1753364,1362658,2023-12-13,House,"House Floor: HB 863 PN 2410, CONCURRENCE",118,85,0,0,203
1753364,1362659,2023-12-13,Senate,"Senate Floor: HB 863 PN 2410, Final Passage",50,0,0,0,50
1753364,1362660,2023-12-13,House,"House Rules: Re-report Bill As Committed",33,0,0,0,33
1753374,1346880,2023-06-22,House,"House Human Services: Report Bill As Amended",20,1,0,0,21
1753374,1346881,2023-06-22,House,"House Human Services: Adopt Amendment",21,0,0,0,21
1753374,1347592,2023-06-27,House,"House Rules: Re-report Bill As Committed",32,0,1,0,33
1753374,1347771,2023-06-27,House,"House Floor: HB 850 PN 1691, 2023 A1358",101,102,0,0,203
1753374,1347772,2023-06-27,House,"House Floor: HB 850 PN 1691, 2023 A1363",101,102,0,0,203
1753374,1347773,2023-06-27,House,"House Floor: HB 850 PN 1691, 2023 A1370",101,102,0,0,203
1753374,1347774,2023-06-27,House,"House Floor: HB 850 PN 1691, 2023 A1416",101,102,0,0,203
1753374,1347775,2023-06-27,House,"House Floor: HB 850 PN 1691, 2023 A1421, MOTION TO TABLE",102,101,0,0,203
1753374,1347776,2023-06-27,House,"House Floor: HB 850 PN 1691, 2023 A1440",101,102,0,0,203
1753374,1348090,2023-06-28,House,"House Floor: HB 850 PN 1691, FINAL PASSAGE",131,72,0,0,203
1753374,1348091,2023-06-28,House,"House Appropriations: Re-report Bill As Committed",22,15,0,0,37
1753374,1462387,2024-07-03,Senate,"Senate Health And Human Services: Reported as Amended",11,0,0,0,11
1753374,1462388,2024-07-03,Senate,"Senate Health And Human Services: Adopt Amendment A05240",11,0,0,0,11
1753489,1439966,2024-05-07,House,"House Education: Adopt Amendment A04287",23,2,0,0,25
1753489,1439967,2024-05-07,House,"House Education: Report Bill As Amended",18,7,0,0,25
1753489,1452874,2024-06-03,House,"House Floor: HB 851 PN 3070, 2023 A4541, MOTION TO APPEAL RULING OF THE CHAIR",102,0,100,1,203
1753489,1453161,2024-06-04,House,"House Floor: HB 851 PN 3070, FINAL PASSAGE",117,85,0,1,203
1753489,1453162,2024-06-04,House,"House Appropriations: Re-report Bill As Committed",23,14,0,0,37
1753513,1330263,2023-05-23,House,"House Human Services: Adopt Amendment",21,0,0,0,21
1753513,1330264,2023-05-23,House,"House Human Services: Report Bill As Amended",21,0,0,0,21
1753513,1339724,2023-06-06,House,"House Floor: HB 849 PN 1296, 2023 A844, MOTION TO SUSPEND RULES",202,1,0,0,203
1753513,1339725,2023-06-06,House,"House Floor: HB 849 PN 1296, 2023 A844",200,3,0,0,203
1753513,1340855,2023-06-07,House,"House Floor: HB 849 PN 1463, FINAL PASSAGE",173,30,0,0,203
1753513,1340856,2023-06-07,House,"House Appropriations: Re-report Bill As Committed",37,0,0,0,37
1753522,1347382,2023-06-26,House,"House Housing And Community Development: Adopt Amendment A01197",21,0,0,0,21
1753522,1347383,2023-06-26,House,"House Housing And Community Development: Report Bill As Amended",21,0,0,0,21
1753522,1349674,2023-07-06,House,"House Rules: Re-report Bill As Committed",33,0,0,0,33
1753522,1349865,2023-07-07,House,"House Floor: HB 859 PN 1716, FINAL PASSAGE",124,79,0,0,203
1753522,1349866,2023-07-07,House,"House Appropriations: Re-report Bill As Committed",37,0,0,0,37
1753739,1339328,2023-06-05,House,"House State Government: Report Bill As Committed",12,9,0,0,21
1753869,1349557,2023-07-05,House,"House Human Services: Report Bill As Committed",20,1,0,0,21
1753869,1355603,2023-10-03,House,"House Rules: Re-report Bill As Committed",33,0,0,0,33
1753892,1317254,2023-04-24,House,"House Game And Fisheries: Bring Up The Bill For Consideration",21,0,0,0,21
1753892,1331160,2023-05-23,House,"House Floor: HB 877 PN 853, FINAL PASSAGE",201,0,0,0,201
1753892,1331161,2023-05-23,House,"House Appropriations: Re-report Bill As Committed",37,0,0,0,37
1754181,1321715,2023-05-10,Senate,"Senate Transportation: Reported as Amended",13,1,0,0,14
1754181,1321716,2023-05-10,Senate,"Senate Transportation: Adopt Amendment A00517",10,4,0,0,14
1754181,1346022,2023-06-21,Senate,"Senate Floor: SB 37 PN 737, 2023 A1208, BROWN Amendment No. A-1208",48,2,0,0,50
1754181,1346773,2023-06-22,Senate,"Senate Floor: SB 37 PN 939, Final Passage",37,11,0,2,50
1754181,1346774,2023-06-22,Senate,"Senate Appropriations: Re-Reported as Committed",20,4,0,0,24
1754181,1415335,2024-03-26,House,"House Transportation: Report Bill As Amended",19,6,0,0,25
1754181,1415336,2024-03-26,House,"House Transportation: Adopt Amendment A03795",15,10,0,0,25
1754181,1415337,2024-03-26,House,"House Transportation: Adopt Amendment A03504",25,0,0,0,25
1754181,1421789,2024-04-08,House,"House Floor: SB 37 PN 1458, 2023 A3812",91,110,0,1,202
1754181,1421790,2024-04-08,House,"House Floor: SB 37 PN 1458, 2023 A3815",100,101,0,1,202
1754181,1422784,2024-04-09,House,"House Floor: SB 37 PN 1458, FINAL PASSAGE",124,77,0,1,202
1754181,1422785,2024-04-09,House,"House Appropriations: Re-report Bill As Committed",29,8,0,0,37
1754181,1439742,2024-05-06,Senate,"Senate Rules And Executive Nominations: Re-Reported as Amended",16,0,1,0,17
1754181,1439743,2024-05-06,Senate,"Senate Rules And Executive Nominations: Adopt Amendment A04141",16,0,1,0,17
1754181,1440525,2024-05-07,Senate,"Senate Floor: SB 37 PN 1588, Concurrence in House Amendments as Amended",37,13,0,0,50
1754181,1440526,2024-05-08,House,"House Rules: Re-report Bill As Committed",32,0,1,0,33
1754181,1441035,2024-05-08,House,"House Floor: SB 37 PN 1588, CONCURRENCE",126,74,0,2,202
1754327,1330801,2023-05-23,House,"House Veterans Affairs And Emergency Preparedness: Adopt Amendment A00553",21,0,0,0,21
1754327,1330802,2023-05-23,House,"House Veterans Affairs And Emergency Preparedness: Report Bill As Amended",21,0,0,0,21
1754327,1343289,2023-06-13,House,"House Appropriations: Re-report Bill As Committed",37,0,0,0,37
1754327,1343642,2023-06-13,House,"House Floor: HB 892 PN 1302, FINAL PASSAGE",203,0,0,0,203
1754601,1343494,2023-06-13,House,"House Education: Report Bill As Committed",18,3,0,0,21
1754601,1345985,2023-06-21,House,"House Rules: Re-report Bill As Committed",33,0,0,0,33
1754601,1346439,2023-06-22,House,"House Floor: HB 897 PN 895, 2023 A1097",203,0,0,0,203
1754601,1347432,2023-06-26,House,"House Floor: HB 897 PN 1676, FINAL PASSAGE",203,0,0,0,203
1754601,1347433,2023-06-26,House,"House Appropriations: Re-report Bill As Committed",37,0,0,0,37
1754601,1460954,2024-06-27,Senate,"Senate Education: Reported as Amended",11,0,0,0,11
1754601,1460955,2024-06-27,Senate,"Senate Education: Adopt Amendment A05256",11,0,0,0,11
1754601,1462984,2024-07-11,Senate,"Senate Appropriations: Adopt Amendment A05536",23,0,1,0,24
1754601,1462985,2024-07-11,Senate,"Senate Appropriations: Re-Reported as Amended",23,0,1,0,24
1754601,1463040,2024-07-11,House,"House Floor: HB 897 PN , MOTION TO PROCEED BRADFORD",173,29,0,1,203
1754601,1463041,2024-07-11,House,"House Floor: HB 897 PN 3505, CONCURRENCE",187,15,0,1,203
1754601,1463042,2024-07-11,Senate,"Senate Floor: HB 897 PN 3505, Final Passage",46,3,0,1,50
1754601,1463043,2024-07-11,House,"House Rules: Report Bill As Committed",18,15,0,0,33
1754614,1303785,2023-04-18,House,"House Judiciary: Report Bill As Amended",21,0,0,0,21
1754614,1303786,2023-04-18,House,"House Judiciary: Adopt Amendment A00209",21,0,0,0,21
1754614,1343654,2023-06-13,House,"House Floor: HB 900 PN 959, FINAL PASSAGE",203,0,0,0,203
1754614,1343655,2023-06-13,House,"House Appropriations: Re-report Bill As Committed",37,0,0,0,37
1754614,1362259,2023-12-11,Senate,"Senate Judiciary: Reported as Amended",13,0,1,0,14
1754614,1362260,2023-12-11,Senate,"Senate Judiciary: Adopt Amendment A03225",13,0,1,0,14
1754614,1362423,2023-12-12,Senate,"Senate Appropriations: Re-Reported as Committed",24,0,0,0,24
1754614,1362611,2023-12-13,House,"House Floor: HB 900 PN 2406, CONCURRENCE",203,0,0,0,203
1754614,1362612,2023-12-13,Senate,"Senate Floor: HB 900 PN 2406, Final Passage",50,0,0,0,50
1754614,1362613,2023-12-13,House,"House Rules: Re-report Bill As Committed",33,0,0,0,33
1754709,1310728,2023-04-26,House,"House Veterans Affairs And Emergency Preparedness: Report Bill As Committed",21,0,0,0,21
1754709,1317455,2023-05-03,House,"House Floor: HR 71 PN 890",201,0,0,0,201
1754946,1349857,2023-07-06,House,"House Judiciary: Re-refer Bill To Another Committee",21,0,0,0,21
1754946,1356779,2023-10-31,House,"House State Government: Report Bill As Amended",23,2,0,0,25
1754946,1356780,2023-10-31,House,"House State Government: Adopt Amendment A01957",25,0,0,0,25
1754946,1357696,2023-11-15,House,"House Floor: HB 908 PN 2232, 2023 A2923",192,11,0,0,203
1754946,1362294,2023-12-11,House,"House Floor: HB 908 PN 2322, FINAL PASSAGE",166,37,0,0,203
1754946,1362295,2023-12-11,House,"House Appropriations: Re-report Bill As Committed",37,0,0,0,37
1754954,1340610,2023-06-07,House,"House Judiciary: Adopt Amendment A00738",21,0,0,0,21
1754954,1340611,2023-06-07,House,"House Judiciary: Report Bill As Amended",12,9,0,0,21
1755054,1356304,2023-10-18,House,"House Local Government: Report Bill As Committed",14,11,0,0,25
1755063,1415682,2024-03-26,House,"House Environmental Resources And Energy: Re-refer Bill To Another Committee",25,0,0,0,25
1755074,1308180,2023-04-24,House,"House Judiciary: Report Bill As Committed",21,0,0,0,21
1755074,1317838,2023-05-03,House,"House Floor: HB 917 PN 905, 2023 A443",201,0,0,0,201
1755074,1329837,2023-05-22,House,"House Floor: HB 917 PN 1151, FINAL PASSAGE",201,0,0,0,201
1755074,1329838,2023-05-22,House,"House Appropriations: Re-report Bill As Committed",37,0,0,0,37
1755074,1357592,2023-11-14,Senate,"Senate Judiciary: Reported as Amended",14,0,0,0,14
1755074,1357593,2023-11-14,Senate,"Senate Judiciary: Adopt Amendment A02925",14,0,0,0,14
1755074,1421892,2024-04-08,Senate,"Senate Appropriations: Re-Reported as Committed",24,0,0,0,24
1755074,1423145,2024-04-09,Senate,"Senate Floor: HB 917 PN 2874, Final Passage",50,0,0,0,50
1755074,1424047,2024-04-10,House,"House Rules: Re-report Bill As Committed",33,0,0,0,33
1755074,1424472,2024-04-10,House,"House Floor: HB 917 PN 2874, CONCURRENCE",200,0,0,2,202
1755146,1309575,2023-04-25,House,"House Consumer Protection, Technology And Utilities: Re-refer Bill To Another Committee",21,0,0,0,21
1755156,1317895,2023-05-03,House,"House Commerce: Bring Up The Bill For Consideration",21,0,0,0,21
1755156,1317896,2023-05-03,House,"House Commerce: Adopt Amendment",21,0,0,0,21
1755156,1317897,2023-05-03,House,"House Commerce: Adopt Amendment",21,0,0,0,21
1755156,1317898,2023-05-03,House,"House Commerce: Report Bill As Amended",21,0,0,0,21
1755156,1331467,2023-05-23,House,"House Floor: HB 922 PN 1138, 2023 A516",99,102,0,0,201
1755156,1331468,2023-05-23,House,"House Floor: HB 922 PN 1138, 2023 A562",100,101,0,0,201
1755156,1331730,2023-05-24,House,"House Appropriations: Re-report Bill As Committed",37,0,0,0,37
1755156,1332404,2023-05-24,House,"House Floor: HB 922 PN 1138, FINAL PASSAGE",119,82,0,0,201
1755185,1355287,2023-09-27,House,"House Judiciary: Report Bill As Committed",14,11,0,0,25
1755309,1308262,2023-04-24,House,"House Labor And Industry: Adopt Amendment A00230",9,12,0,0,21
1755309,1308263,2023-04-24,House,"House Labor And Industry: Adopt Amendment A00259",21,0,0,0,21
1755309,1308264,2023-04-24,House,"House Labor And Industry: Adopt Amendment A00224",9,12,0,0,21
1755309,1308265,2023-04-24,House,"House Labor And Industry: Adopt Amendment A00226",9,12,0,0,21
1755309,1308266,2023-04-24,House,"House Labor And Industry: Report Bill As Amended",12,9,0,0,21
1755309,1315310,2023-05-01,House,"House Floor: HB 930 PN 964, 2023 A310",92,109,0,0,201
1755309,1315311,2023-05-01,House,"House Floor: HB 930 PN 964, 2023 A309",86,115,0,0,201
1755309,1316062,2023-05-02,House,"House Appropriations: Re-report Bill As Committed",22,1,14,0,37
1755309,1316722,2023-05-02,House,"House Floor: HB 930 PN 964, FINAL PASSAGE",112,88,0,1,201
1755439,1330622,2023-05-23,House,"House Human Services: Adopt Amendment",20,0,0,0,20
1755439,1330623,2023-05-23,House,"House Human Services: Report Bill As Amended",21,0,0,0,21
1755499,1456564,2024-06-12,House,"House Health: Report Bill As Committed",24,0,0,0,24
1755508,1329797,2023-05-22,House,"House Health: Report Bill As Committed",21,0,0,0,21
1755517,1339374,2023-06-05,House,"House State Government: Report Bill As Amended",12,9,0,0,21
1755517,1339375,2023-06-05,House,"House State Government: Adopt Amendment A00471",12,9,0,0,21
1755517,1362640,2023-12-13,House,"House Floor: HR 75 PN 1444",202,1,0,0,203
1755621,1338752,2023-06-05,House,"House Aging And Older Adult Services: Report Bill As Committed",21,0,0,0,21
1755621,1345253,2023-06-20,House,"House Floor: HR 77 PN 946",202,1,0,0,203
1755726,1357525,2023-11-14,House,"House Judiciary: Adopt Amendment A02919",25,0,0,0,25
1755726,1357526,2023-11-14,House,"House Judiciary: Report Bill As Amended",14,11,0,0,25
1755739,1308394,2023-04-24,House,"House Judiciary: Adopt Amendment A00287",12,9,0,0,21
1755739,1308396,2023-04-24,House,"House Judiciary: Report Bill As Amended",12,9,0,0,21
1755739,1315411,2023-05-01,House,"House Appropriations: Re-report Bill As Amended",22,15,0,0,37
1755739,1316138,2023-05-01,House,"House Appropriations: Adopt Amendment A00391",22,15,0,0,37
1755739,1316139,2023-05-01,House,"House Appropriations: Adopt Amendment A00393",22,15,0,0,37
1755739,1316140,2023-05-02,House,"House Floor: HB 300 PN 1020, MOTION TO OBJECT TO COMMITTEE REPORT",101,100,0,0,201
1755739,1316752,2023-05-02,House,"House Floor: HB 300 PN 1135, FINAL PASSAGE",102,98,0,1,201
1755754,1315220,2023-05-01,House,"House Labor And Industry: Adopt Amendment A00371",9,12,0,0,21
1755754,1315221,2023-05-01,House,"House Labor And Industry: Report Bill As Committed",12,9,0,0,21
1755754,1316480,2023-05-02,House,"House Floor: HB 950 PN 937, 2023 A408",101,100,0,0,201
1755754,1316481,2023-05-02,House,"House Floor: HB 950 PN 937, 2023 A405, MOTION TO APPEAL RULING OF THE CHAIR",101,100,0,0,201
1755754,1316482,2023-05-02,House,"House Floor: HB 950 PN 937, MOTION TO RECOMMIT",100,101,0,0,201
1755754,1316483,2023-05-02,House,"House Floor: HB 950 PN 937, 2023 A388",89,112,0,0,201
1755754,1317430,2023-05-03,House,"House Appropriations: Re-report Bill As Committed",22,15,0,0,37
1755754,1317714,2023-05-03,House,"House Floor: HB 950 PN 1136, FINAL PASSAGE",102,99,0,0,201
1755778,1356706,2023-10-31,House,"House Judiciary: Report Bill As Committed",15,10,0,0,25
1755883,1354966,2023-09-19,Senate,"Senate Transportation: Reported as Committed",14,0,0,0,14
1755883,1357458,2023-11-13,Senate,"Senate Appropriations: Re-Reported as Committed",23,1,0,0,24
1755883,1362263,2023-12-11,Senate,"Senate Floor: SB 597 PN 592, Final Passage",48,0,0,2,50
1755883,1362264,2023-12-11,Senate,"Senate Floor: SB 597 PN 592, Final Passage-Reconsidered",47,1,0,2,50
1755897,1355551,2023-10-03,Senate,"Senate Judiciary: Reported as Amended",9,5,0,0,14
1755897,1355552,2023-10-03,Senate,"Senate Judiciary: Adopt Amendment A02198",10,4,0,0,14
1755897,1357654,2023-11-14,Senate,"Senate Floor: SB 596 PN 1146, 2023 A2983, SANTARSIERO Amendment No. A-2983",46,4,0,0,50
1755897,1357655,2023-11-14,Senate,"Senate Appropriations: Re-Reported as Committed",18,6,0,0,24
1755897,1357668,2023-11-15,Senate,"Senate Floor: SB 596 PN 1232, Final Passage",46,4,0,0,50
1755897,1362109,2023-12-08,House,"House Judiciary: Adopt Amendment A03141",14,11,0,0,25
1755897,1362110,2023-12-08,House,"House Judiciary: Report Bill As Amended",14,11,0,0,25
1755897,1362443,2023-12-12,House,"House Floor: SB 596 PN 1266, 2023 A3215",192,11,0,0,203
1755897,1362444,2023-12-12,House,"House Floor: SB 596 PN 1266, 2023 A3221",140,63,0,0,203
1755897,1362542,2023-12-13,House,"House Floor: SB 596 PN 1284, FINAL PASSAGE",179,24,0,0,203
1755897,1362543,2023-12-13,House,"House Appropriations: Re-report Bill As Committed",37,0,0,0,37
1755897,1362652,2023-12-13,Senate,"Senate Floor: SB 596 PN 1284, Concur in House Amendments",45,5,0,0,50
1755897,1362653,2023-12-13,Senate,"Senate Rules And Executive Nominations: Re-Reported as Committed",15,2,0,0,17
1755926,1309442,2023-04-25,Senate,"Senate Judiciary: Reported as Amended",14,0,0,0,14
1755926,1317636,2023-05-03,Senate,"Senate Floor: SB 598 PN 636, Final Passage",49,0,0,1,50
1755926,1321396,2023-05-09,Senate,"Senate Floor: SB 598 PN 721, Motion to Reconsider on Final Passage",49,0,0,1,50
1755926,1339520,2023-04-25,Senate,"Senate Judiciary: Adopt Amendment A00322",14,0,0,0,14
1755926,1355232,2023-09-27,House,"House Judiciary: Re-report Bill As Committed",25,0,0,0,25
1755942,1362686,2023-12-13,House,"House Local Government: Report Bill As Amended",22,3,0,0,25
1755942,1362687,2023-12-13,House,"House Local Government: Adopt Amendment A03267",25,0,0,0,25
1755942,1362688,2023-12-13,House,"House Local Government: Adopt Amendment A03120",25,0,0,0,25
1755954,1345220,2023-06-20,House,"House Transportation: Re-refer Bill To Another Committee",21,0,0,0,21
1755954,1468169,2024-10-07,House,"House Liquor Control: Report Bill As Committed",25,0,0,0,25
1756013,1309667,2023-04-25,House,"House Agriculture And Rural Affairs: Report Bill As Committed",21,0,0,0,21
1756013,1329673,2023-05-22,House,"House Appropriations: Re-report Bill As Committed",37,0,0,0,37
1756013,1330136,2023-05-22,House,"House Floor: HB 953 PN 950, FINAL PASSAGE",200,1,0,0,201
1756377,1339223,2023-06-06,House,"House Finance: Re-refer Bill To Another Committee",21,0,0,0,21
1756377,1411002,2024-03-19,House,"House Children And Youth: Re-refer Bill To Another Committee",25,0,0,0,25
1756427,1355825,2023-10-04,House,"House Children And Youth: Adopt Amendment A02131",24,0,1,0,25
1756427,1355826,2023-10-04,House,"House Children And Youth: Report Bill As Amended",14,10,1,0,25
1756478,1331690,2023-05-23,House,"House Environmental Resources And Energy: Adopt Amendment A00639",12,9,0,0,21
1756478,1331691,2023-05-23,House,"House Environmental Resources And Energy: Report Bill As Amended A00639",12,9,0,0,21
1756542,1415197,2024-03-26,House,"House Children And Youth: Report Bill As Amended A03642",13,11,1,0,25
1756542,1415198,2024-03-26,House,"House Children And Youth: Report Bill As Committed",14,11,0,0,25
1756581,1330682,2023-05-23,House,"House Consumer Protection, Technology And Utilities: Adopt Amendment A00555",21,0,0,0,21
1756581,1330683,2023-05-23,House,"House Consumer Protection, Technology And Utilities: Report Bill As Amended",20,1,0,0,21
1756615,1355744,2023-10-04,House,"House Children And Youth: Adopt Amendment A02114",14,10,1,0,25
1756615,1355745,2023-10-04,House,"House Children And Youth: Report Bill As Amended",13,11,1,0,25
1756634,1346810,2023-06-22,Senate,"Senate Appropriations: Reported as Committed",15,9,0,0,24
1756687,1362320,2023-12-12,House,"House State Government: Adopt Amendment A03069",25,0,0,0,25
1756687,1362321,2023-12-12,House,"House State Government: Report Bill As Amended",25,0,0,0,25
1756687,1410201,2024-03-18,House,"House Floor: HB 974 PN 2412, 2023 A3327",100,101,0,1,202
1756687,1410202,2024-03-18,House,"House Floor: HB 974 PN 2412, 2023 A3334",99,102,0,1,202
1756687,1410203,2024-03-18,House,"House Floor: HB 974 PN 2412, 2023 A3318",201,0,0,1,202
1756687,1411071,2024-03-19,House,"House Floor: HB 974 PN 2733, FINAL PASSAGE",201,0,0,1,202
1756687,1411072,2024-03-19,House,"House Appropriations: Re-report Bill As Committed",37,0,0,0,37
1756737,1330316,2023-05-23,House,"House Labor And Industry: Adopt Amendment A00548",21,0,0,0,21
1756737,1330317,2023-05-23,House,"House Labor And Industry: Report Bill As Amended",12,9,0,0,21
1756737,1330318,2023-05-23,House,"House Labor And Industry: Adopt Amendment A00564",9,12,0,0,21
1756737,1343600,2023-06-13,House,"House Floor: HB 967 PN 1298, 2023 A681",193,10,0,0,203
1756737,1343938,2023-06-14,House,"House Appropriations: Re-report Bill As Committed",22,15,0,0,37
1756737,1345402,2023-06-20,House,"House Floor: HB 967 PN 1565, FINAL PASSAGE",108,95,0,0,203
1757091,1356104,2023-10-17,House,"House State Government: Report Bill As Amended",13,12,0,0,25
1757091,1356105,2023-10-17,House,"House State Government: Adopt Amendment A02571",14,11,0,0,25
1757091,1468777,2024-10-21,House,"House Floor: HB 976 PN 2157, 2023 A6002",112,90,0,1,203
1757091,1468778,2024-10-21,House,"House Floor: HB 976 PN 2157, 2023 A6003",111,91,0,1,203
1757204,1468063,2024-10-02,House,"House Judiciary: Adopt Amendment A05008",25,0,0,0,25
1757204,1468064,2024-10-02,House,"House Judiciary: Report Bill As Amended",20,5,0,0,25
1757240,1356102,2023-10-17,House,"House State Government: Report Bill As Amended",14,11,0,0,25
1757240,1356103,2023-10-17,House,"House State Government: Adopt Amendment A02572",14,11,0,0,25
1757254,1355713,2023-10-04,Senate,"Senate Labor And Industry: Reported as Amended",10,1,0,0,11
1757254,1355714,2023-10-04,Senate,"Senate Labor And Industry: Adopt Amendment A02367",9,2,0,0,11
1757301,1308201,2023-04-24,House,"House Education: Adopt Amendment A00273",21,0,0,0,21
1757301,1308202,2023-04-24,House,"House Education: Report Bill As Amended",12,9,0,0,21
1757301,1315491,2023-05-01,House,"House Floor: HB 141 PN 966, FINAL PASSAGE",120,81,0,0,201
1757301,1315492,2023-05-01,House,"House Appropriations: Re-report Bill As Committed",22,15,0,0,37
1757474,1309405,2023-04-25,Senate,"Senate Judiciary: Reported as Committed",14,0,0,0,14
1757474,1315921,2023-05-01,Senate,"Senate Floor: SB 645 PN 618, 2023 A355, HUGHES Amendment No. A-355",47,3,0,0,50
1757474,1436027,2024-04-29,Senate,"Senate Appropriations: Re-Reported as Committed",22,2,0,0,24
1757474,1460868,2024-06-26,Senate,"Senate Floor: SB 645 PN 686, 2023 A5135, LAUGHLIN Amendment No. A-5135",50,0,0,0,50
1757474,1460988,2024-06-27,Senate,"Senate Floor: SB 645 PN 1789, Final Passage",42,7,0,1,50
1757474,1461299,2024-06-27,House,"House Housing And Community Development: Report Bill As Committed",14,9,2,0,25
1757474,1461894,2024-07-01,House,"House Floor: SB 645 PN 1789, FINAL PASSAGE",102,100,0,1,203
1757474,1461895,2024-07-01,House,"House Appropriations: Re-report Bill As Committed",37,0,0,0,37
1757726,1356207,2023-10-18,Senate,"Senate Education: Reported as Amended",7,4,0,0,11
1757726,1356208,2023-10-18,Senate,"Senate Education: Adopt Amendment A02607",7,4,0,0,11
1757726,1356406,2023-10-24,Senate,"Senate Appropriations: Re-Reported as Committed",15,9,0,0,24
1757726,1356456,2023-10-24,Senate,"Senate Floor: SB 7 PN 1174, 2023 A-2667, Motion to Table CAPPELLETTI Amendment No. A-2667",28,22,0,0,50
1757726,1356457,2023-10-24,Senate,"Senate Floor: SB 7 PN 1174, 2023 A-2667, Final Passage",29,21,0,0,50
1758084,1316069,2023-05-02,Senate,"Senate Education: Reported as Amended",10,1,0,0,11
1758084,1316070,2023-05-02,Senate,"Senate Education: Adopt Amendment A00390",11,0,0,0,11
1758084,1320275,2023-05-08,Senate,"Senate Appropriations: Re-Reported as Committed",23,1,0,0,24
1758084,1321389,2023-05-09,Senate,"Senate Floor: SB 647 PN 729, Final Passage",44,5,0,1,50
1758129,1310121,2023-04-25,House,"House Education: Report Bill As Committed",21,0,0,0,21
1758129,1316909,2023-05-02,House,"House Floor: HR 84 PN 1018",201,0,0,0,201
1758190,1310870,2023-04-26,House,"House Judiciary: Report Bill As Committed",12,9,0,0,21
1758190,1317667,2023-05-03,House,"House Floor: HB 1018 PN 960, 2023 A453",119,82,0,0,201
1758190,1329884,2023-05-22,House,"House Floor: HB 1018 PN 1152, CONSTITUTIONALITY",103,98,0,0,201
1758190,1329885,2023-05-22,House,"House Floor: HB 1018 PN 1152, CONSTITUTIONALITY",103,98,0,0,201
1758190,1329886,2023-05-22,House,"House Floor: HB 1018 PN 1152, FINAL PASSAGE",102,99,0,0,201
1758190,1329887,2023-05-22,House,"House Appropriations: Re-report Bill As Committed",22,15,0,0,37
1758219,1416319,2024-03-27,House,"House Health: Re-refer Bill To Another Committee",25,0,0,0,25
1758219,1439527,2024-05-06,House,"House Insurance: Adopt Amendment A04256",25,0,0,0,25
1758219,1439528,2024-05-06,House,"House Insurance: Re-report Bill As Amended",25,0,0,0,25
1758219,1455680,2024-06-10,House,"House Appropriations: Re-report Bill As Committed",37,0,0,0,37
1758219,1455750,2024-06-10,House,"House Floor: HB 1021 PN 3053, FINAL PASSAGE",201,0,0,2,203
1758280,1332154,2023-05-24,House,"House Judiciary: Report Bill As Committed",12,9,0,0,21
1758280,1349867,2023-07-07,House,"House Floor: HB 1024 PN 1021, 2023 A1046, MOTION TO TABLE",102,101,0,0,203
1758280,1349868,2023-07-07,House,"House Floor: HB 1024 PN 1021, 2023 A1047",101,102,0,0,203
1758280,1349869,2023-07-07,House,"House Floor: HB 1024 PN 1021, 2023 A1057",101,102,0,0,203
1758280,1349870,2023-07-07,House,"House Floor: HB 1024 PN 1021, 2023 A1462",101,102,0,0,203
1758280,1349871,2023-07-07,House,"House Floor: HB 1024 PN 1021, 2023 A1580",102,101,0,0,203
1758280,1349872,2023-07-07,House,"House Floor: HB 1024 PN 1021, 2023 A1669",102,101,0,0,203
1758280,1349897,2023-07-07,House,"House Floor: HB 1024 PN 1021, 2023 A718, MOTION TO APPEAL RULING OF THE CHAIR",102,101,0,0,203
1758280,1356686,2023-10-30,House,"House Appropriations: Adopt Amendment A02788",22,15,0,0,37
1758280,1356687,2023-10-30,House,"House Appropriations: Re-report Bill As Amended A02788",22,15,0,0,37
1758280,1356778,2023-10-31,House,"House Floor: HB 1024 PN 2224, FINAL PASSAGE",112,90,0,1,203
1758291,1332015,2023-05-24,House,"House Judiciary: Adopt Amendment A00569",21,0,0,0,21
1758291,1332016,2023-05-24,House,"House Judiciary: Report Bill As Amended",12,9,0,0,21
1758291,1349877,2023-07-07,House,"House Floor: HB 1026 PN 1359, 2023 A1297",102,101,0,0,203
1758318,1329868,2023-05-22,House,"House Education: Re-refer Bill To Another Committee",21,0,0,0,21
1758318,1331906,2023-05-24,House,"House Judiciary: Adopt Amendment A00653",21,0,0,0,21
1758318,1331907,2023-05-24,House,"House Judiciary: Adopt Amendment A00655",21,0,0,0,21
1758318,1331908,2023-05-24,House,"House Judiciary: Report Bill As Amended",12,9,0,0,21
1758318,1349887,2023-07-07,House,"House Floor: HB 1025 PN 1358, 2023 A1560",203,0,0,0,203
1758318,1349888,2023-07-07,House,"House Floor: HB 1025 PN 1358, 2023 A1054, MOTION TO TABLE",102,101,0,0,203
1758318,1349889,2023-07-07,House,"House Floor: HB 1025 PN 1358, 2023 A1675",101,102,0,0,203
1758318,1356722,2023-10-31,House,"House Floor: HB 1025 PN 1834, FINAL PASSAGE",111,91,0,1,203
1758318,1356723,2023-10-31,House,"House Appropriations: Re-report Bill As Committed",37,0,0,0,37
1758345,1331817,2023-05-24,House,"House Judiciary: Report Bill As Committed",12,9,0,0,21
1758345,1349890,2023-07-07,House,"House Floor: HB 1027 PN 1024, 2023 A1049, MOTION TO TABLE",102,101,0,0,203
1758345,1349891,2023-07-07,House,"House Floor: HB 1027 PN 1024, 2023 A1332",102,101,0,0,203
1758345,1349892,2023-07-07,House,"House Floor: HB 1027 PN 1024, 2023 A1579",102,101,0,0,203
1758345,1349893,2023-07-07,House,"House Floor: HB 1027 PN 1024, 2023 A1050",101,102,0,0,203
1758345,1349894,2023-07-07,House,"House Floor: HB 1027 PN 1024, 2023 A1463",101,102,0,0,203
1758345,1356695,2023-10-30,House,"House Appropriations: Adopt Amendment A02791",22,15,0,0,37
1758345,1356696,2023-10-30,House,"House Appropriations: Re-report Bill As Amended A02791",22,15,0,0,37
1758345,1356794,2023-10-31,House,"House Floor: HB 1027 PN 2225, FINAL PASSAGE",116,86,0,1,203
1758384,1310789,2023-04-26,Senate,"Senate Transportation: Adopt Amendment A00346",13,0,1,0,14
1758384,1310790,2023-04-26,Senate,"Senate Transportation: Reported as Amended",8,5,1,0,14
1758384,1315910,2023-05-01,Senate,"Senate Floor: SB 140 PN 654, 2023 A399, LANGERHOLC Amendment No. A-0399",30,20,0,0,50
1758384,1317161,2023-05-02,Senate,"Senate Floor: SB 140 PN 684, 2023 A426, HAYWOOD Amendment No. A-0426",21,29,0,0,50
1758384,1317162,2023-05-02,Senate,"Senate Floor: SB 140 PN 684, Final Passage",29,21,0,0,50
1758384,1317163,2023-05-02,Senate,"Senate Appropriations: Re-Reported as Committed",15,9,0,0,24
1758384,1317422,2023-05-02,Senate,"Senate Floor: SB 140 PN 684, 2023 A-0441, Motion to Table Hughes Amendment A-0441",28,22,0,0,50
1758384,1362207,2023-12-11,House,"House Judiciary: Report Bill As Committed",14,11,0,0,25
1758384,1362586,2023-12-13,House,"House Floor: SB 140 PN 684, FINAL PASSAGE",159,44,0,0,203
1758384,1362587,2023-12-13,House,"House Appropriations: Re-report Bill As Committed",37,0,0,0,37
1758406,1320006,2023-05-08,Senate,"Senate Intergovernmental Operations: Reported as Committed",7,4,0,0,11
1758452,1330168,2023-05-22,House,"House Health: Report Bill As Committed",21,0,0,0,21
1758491,1317413,2023-05-03,House,"House Consumer Protection, Technology And Utilities: Report Bill As Committed",19,2,0,0,21
1758491,1331878,2023-05-24,House,"House Floor: HB 1028 PN 1025, 2023 A550",201,0,0,0,201
1758491,1331879,2023-05-24,House,"House Floor: HB 1028 PN 1025, 2023 A671",80,121,0,0,201
1758491,1331880,2023-05-24,House,"House Floor: HB 1028 PN 1025, 2023 A672",82,119,0,0,201
1758491,1331881,2023-05-24,House,"House Floor: HB 1028 PN 1025, 2023 A673",71,130,0,0,201
1758491,1331882,2023-05-24,House,"House Floor: HB 1028 PN 1025, 2023 A701, MOTION TO SUSPEND RULES",201,0,0,0,201
1758491,1331883,2023-05-24,House,"House Floor: HB 1028 PN 1025, 2023 A701",201,0,0,0,201
1758491,1339063,2023-06-05,House,"House Floor: HB 1028 PN 1361, FINAL PASSAGE",141,62,0,0,203
1758491,1340397,2023-06-05,House,"House Appropriations: Re-report Bill As Committed",28,9,0,0,37
1758685,1318477,2023-05-03,House,"House Tourism And Economic And Recreational Development: Report Bill As Committed",21,0,0,0,21
1758685,1331022,2023-05-23,House,"House Floor: HR 87 PN 1038",129,72,0,0,201
1758767,1468264,2024-10-07,House,"House Transportation: Report Bill As Amended",22,3,0,0,25
1758767,1468265,2024-10-07,House,"House Transportation: Adopt Amendment A05847",25,0,0,0,25
1758782,1317429,2023-05-03,House,"House Transportation: Report Bill As Committed",21,0,0,0,21
1758782,1339064,2023-06-05,House,"House Floor: HB 1031 PN 1047, FINAL PASSAGE",203,0,0,0,203
1758782,1340422,2023-06-05,House,"House Appropriations: Re-report Bill As Committed",37,0,0,0,37
1758782,1345773,2023-06-20,Senate,"Senate Game And Fisheries: Reported as Committed",11,0,0,0,11
1758782,1346108,2023-06-21,Senate,"Senate Floor: HB 1031 PN 1047, motion to agree to the bill on second consideration",50,0,0,0,50
1758782,1349248,2023-06-30,Senate,"Senate Floor: HB 1031 PN 1047, Final Passage",50,0,0,0,50
1758792,1322547,2023-05-10,Senate,"Senate Transportation: Reported as Committed",14,0,0,0,14
1758792,1347076,2023-06-22,Senate,"Senate Floor: SB 655 PN 638, Motion to agree to the bill on second consideration",48,0,0,2,50
1758809,1330278,2023-05-23,House,"House Consumer Protection, Technology And Utilities: Report Bill As Committed",21,0,0,0,21
1758809,1348150,2023-06-28,House,"House Floor: HB 1032 PN 1041, 2023 A1060, MOTION TO APPEAL RULING OF THE CHAIR",102,101,0,0,203
1758809,1348151,2023-06-28,House,"House Floor: HB 1032 PN 1041, 2023 A542",203,0,0,0,203
1758809,1348152,2023-06-28,House,"House Floor: HB 1032 PN 1041, 2023 A1002",203,0,0,0,203
1758809,1348153,2023-06-28,House,"House Floor: HB 1032 PN 1041, 2023 A539",203,0,0,0,203
1758809,1348154,2023-06-28,House,"House Floor: HB 1032 PN 1041, 2023 A543",101,102,0,0,203
1758809,1348155,2023-06-28,House,"House Floor: HB 1032 PN 1041, 2023 A538, MOTION TO TABLE",102,101,0,0,203
1758809,1348767,2023-06-29,House,"House Floor: HB 1032 PN 1785, FINAL PASSAGE",134,69,0,0,203
1758809,1348768,2023-06-29,House,"House Appropriations: Re-report Bill As Committed",22,15,0,0,37
1758809,1460215,2024-06-26,Senate,"Senate Community, Economic And Recreational Development: Adopt Amendment",14,0,0,0,14
1758809,1460216,2024-06-26,Senate,"Senate Community, Economic And Recreational Development: Adopt Amendment A05235",14,0,0,0,14
1758809,1462787,2024-07-09,Senate,"Senate Floor: HB 1032 PN 3415, 2023 A5418, LAUGHLIN Amendment No. A-5418",44,5,0,1,50
1758809,1462924,2024-07-10,Senate,"Senate Floor: HB 1032 PN 3495, Final Passage",42,7,0,1,50
1758809,1462925,2024-07-10,Senate,"Senate Appropriations: Re-Reported as Committed",23,0,1,0,24
1758809,1462961,2024-07-11,House,"House Rules: Re-report Bill As Committed",33,0,0,0,33
1758809,1463018,2024-07-11,House,"House Floor: HB 1032 PN 3495, CONCURRENCE",112,90,0,1,203
1758837,1344607,2023-06-14,House,"House Local Government: Adopt Amendment A00921",21,0,0,0,21
1758837,1344608,2023-06-14,House,"House Local Government: Adopt Amendment A00962",2,19,0,0,21
1758837,1344609,2023-06-14,House,"House Local Government: Adopt Amendment A00963",20,1,0,0,21
1758837,1344610,2023-06-14,House,"House Local Government: Report Bill As Amended",21,0,0,0,21
1758879,1348665,2023-06-29,House,"House Transportation: Report Bill As Amended",21,0,0,0,21
1758879,1348666,2023-06-29,House,"House Transportation: Adopt Amendment A01548",21,0,0,0,21
1758879,1355276,2023-09-27,House,"House Floor: HB 1044 PN 1787, 2023 A1785",101,101,0,0,202
1758879,1355472,2023-10-02,House,"House Floor: HB 1044 PN 1787, FINAL PASSAGE",118,85,0,0,203
1758879,1355473,2023-10-02,House,"House Appropriations: Re-report Bill As Committed",37,0,0,0,37
1758885,1316002,2023-05-02,House,"House Children And Youth: Report Resolution As Committed",21,0,0,0,21
1758885,1329693,2023-05-22,House,"House Floor: HR 91 PN 1043",201,0,0,0,201
1758903,1322561,2023-05-10,Senate,"Senate Transportation: Reported as Amended",14,0,0,0,14
1758903,1322562,2023-05-10,Senate,"Senate Transportation: Adopt Amendment A00486",14,0,0,0,14
1758903,1340919,2023-06-07,Senate,"Senate Floor: SB 621 PN 738, Motion to Argee",50,0,0,0,50
1758903,1345203,2023-06-19,Senate,"Senate Floor: SB 621 PN 738, Final Passage",50,0,0,0,50
1758903,1347380,2023-06-26,House,"House Transportation: Report Bill As Amended",21,0,0,0,21
1758903,1347381,2023-06-26,House,"House Transportation: Adopt Amendment A01191",21,0,0,0,21
1758903,1355251,2023-09-27,House,"House Floor: SB 621 PN 965, 2023 A2094",202,0,0,0,202
1758903,1355457,2023-10-02,House,"House Appropriations: Re-report Bill As Committed",37,0,0,0,37
1758903,1355459,2023-10-02,House,"House Floor: SB 621 PN 1115, FINAL PASSAGE",202,1,0,0,203
1758903,1355549,2023-10-03,Senate,"Senate Rules And Executive Nominations: Re-Reported as Amended",16,0,1,0,17
1758903,1355550,2023-10-03,Senate,"Senate Rules And Executive Nominations: Adopt Amendment A02283",16,0,1,0,17
1758903,1355708,2023-10-04,Senate,"Senate Floor: SB 621 PN 1149, Concur in House Amendments as Amended",50,0,0,0,50
1758903,1355784,2023-10-04,House,"House Floor: SB 621 PN 1149, CONCURRENCE",202,1,0,0,203
1758903,1355785,2023-10-04,House,"House Rules: Re-report Bill As Committed",33,0,0,0,33
1759323,1427845,2024-04-16,House,"House Children And Youth: Report Bill As Committed",25,0,0,0,25
1759349,1342816,2023-06-12,House,"House Insurance: Adopt Amendment A00674",21,0,0,0,21
1759349,1342817,2023-06-12,House,"House Insurance: Report Bill As Amended A00674",21,0,0,0,21
1759349,1346037,2023-06-21,House,"House Rules: Re-report Bill As Committed",33,0,0,0,33
1759349,1347417,2023-06-26,House,"House Appropriations: Re-report Bill As Committed",37,0,0,0,37
1759349,1347474,2023-06-26,House,"House Floor: HB 1050 PN 1532, FINAL PASSAGE",199,4,0,0,203
1759357,1329883,2023-05-22,House,"House Health: Report Bill As Committed",21,0,0,0,21
1759391,1340769,2023-06-07,House,"House Children And Youth: Bring Up The Bill For Consideration",20,0,1,0,21
1759391,1340770,2023-06-07,House,"House Children And Youth: Adopt Amendment A00834",20,0,1,0,21
1759391,1340771,2023-06-07,House,"House Children And Youth: Report Bill As Amended",21,0,0,0,21
1759391,1345797,2023-06-21,House,"House Rules: Re-report Bill As Committed",33,0,0,0,33
1759391,1346506,2023-06-22,House,"House Floor: HB 1058 PN 1471, FINAL PASSAGE",203,0,0,0,203
1759391,1346507,2023-06-22,House,"House Appropriations: Re-report Bill As Committed",37,0,0,0,37
1759391,1354895,2023-09-19,Senate,"Senate Aging And Youth: Reported as Committed",11,0,0,0,11
1759391,1357600,2023-11-14,Senate,"Senate Appropriations: Re-Reported as Committed",24,0,0,0,24
1759391,1362269,2023-12-11,Senate,"Senate Floor: HB 1058 PN 1471, Final Passage",48,0,0,2,50
1759416,1329660,2023-05-22,House,"House Health: Report Bill As Committed",21,0,0,0,21
1759424,1330607,2023-05-23,House,"House Finance: Re-refer Bill To Another Committee",19,0,1,0,20
1759424,1446159,2024-05-21,House,"House Housing And Community Development: Adopt Amendment A03809",14,11,1,0,26
1759424,1446160,2024-05-21,House,"House Housing And Community Development: Report Bill As Amended",14,11,1,0,26
1759424,1453189,2024-06-04,House,"House Floor: HB 1064 PN 3134, 2023 A4662, MOTION TO APPEAL RULING OF THE CHAIR",102,100,0,1,203
1759424,1455686,2024-06-10,House,"House Floor: HB 1064 PN 3134, FINAL PASSAGE",104,97,0,2,203
1759424,1455687,2024-06-10,House,"House Appropriations: Re-report Bill As Committed",22,15,0,0,37
1759433,1347393,2023-06-26,House,"House Housing And Community Development: Report Bill As Amended",21,0,0,0,21
1759433,1347394,2023-06-26,House,"House Housing And Community Development: Adopt Amendment A01199",21,0,0,0,21
1759433,1355455,2023-10-02,House,"House Rules: Re-report Bill As Committed",33,0,0,0,33
1759433,1355651,2023-10-03,House,"House Floor: HB 1062 PN 1717, FINAL PASSAGE",118,85,0,0,203
1759433,1355773,2023-10-03,House,"House Appropriations: Re-report Bill As Committed",37,0,0,0,37
1759458,1362625,2023-12-13,House,"House Veterans Affairs And Emergency Preparedness: Adopt Amendment A03132",25,0,0,0,25
1759458,1362626,2023-12-13,House,"House Veterans Affairs And Emergency Preparedness: Adopt Amendment A03262",25,0,0,0,25
1759458,1362627,2023-12-13,House,"House Veterans Affairs And Emergency Preparedness: Report Bill As Amended",25,0,0,0,25
1759458,1411185,2024-03-19,House,"House Floor: HB 843 PN 2449, 2023 A3613",201,0,0,1,202
1759458,1411924,2024-03-20,House,"House Floor: HB 843 PN 2748, FINAL PASSAGE",201,0,0,1,202
1759458,1411925,2024-03-20,House,"House Appropriations: Re-report Bill As Committed",37,0,0,0,37
1759458,1468377,2024-10-08,Senate,"Senate Veterans Affairs And Emergency Preparedness: Reported as Committed",11,0,0,0,11
1759458,1468459,2024-10-09,Senate,"Senate Appropriations: Re-Reported as Committed",24,0,0,0,24
1759458,1468842,2024-10-22,Senate,"Senate Floor: HB 843 PN 2748, Final Passage",50,0,0,0,50
1759531,1316511,2023-05-02,Senate,"Senate Health And Human Services: Reported as Committed",11,0,0,0,11
1759701,1342757,2023-06-06,House,"House Education: Report Bill As Committed",12,9,0,0,21
1759701,1342758,2023-06-12,House,"House Floor: HB 1067 PN 1086, 2023 A870",101,102,0,0,203
1759701,1342759,2023-06-12,House,"House Rules: Re-report Bill As Committed",18,15,0,0,33
1759701,1343490,2023-06-13,House,"House Appropriations: Re-report Bill As Committed",37,0,0,0,37
1759701,1347454,2023-06-26,House,"House Floor: HB 1067 PN 1086, FINAL PASSAGE",110,93,0,0,203
1759735,1339454,2023-06-06,House,"House Health: Adopt Amendment A00794",12,9,0,0,21
1759735,1339455,2023-06-06,House,"House Health: Report Bill As Amended",12,9,0,0,21
1759735,1347599,2023-06-27,House,"House Floor: HB 106 PN 1462, 2023 A1426",141,62,0,0,203
1759735,1347600,2023-06-27,House,"House Floor: HB 106 PN 1462, 2023 A931",86,117,0,0,203
1759735,1347601,2023-06-27,House,"House Floor: HB 106 PN 1462, 2023 A944",87,116,0,0,203
1759735,1347602,2023-06-27,House,"House Floor: HB 106 PN 1462, 2023 A946",87,116,0,0,203
1759735,1347603,2023-06-27,House,"House Floor: HB 106 PN 1462, 2023 A947",91,112,0,0,203
1759735,1347604,2023-06-27,House,"House Floor: HB 106 PN 1462, 2023 A1020",86,117,0,0,203
1759735,1347605,2023-06-27,House,"House Floor: HB 106 PN 1462, 2023 A1080",91,112,0,0,203
1759735,1347606,2023-06-27,House,"House Rules: Re-report Bill As Committed",18,14,1,0,33
1759735,1347761,2023-06-27,House,"House Floor: HB 106 PN 1462, 2023 A1118",88,115,0,0,203
1759735,1347762,2023-06-27,House,"House Floor: HB 106 PN 1462, 2023 A1177",92,111,0,0,203
1759735,1348125,2023-06-28,House,"House Floor: HB 106 PN 1743, FINAL PASSAGE",119,84,0,0,203
1759735,1348126,2023-06-28,House,"House Appropriations: Re-report Bill As Committed",22,15,0,0,37
1759779,1339047,2023-06-05,House,"House State Government: Report Bill As Committed",12,9,0,0,21
1759959,1317624,2023-05-03,Senate,"Senate Aging And Youth: Reported as Committed",11,0,0,0,11
1759959,1345161,2023-06-19,Senate,"Senate Floor: SB 607 PN 657, Final Passage",50,0,0,0,50
1759959,1345162,2023-06-19,Senate,"Senate Appropriations: Re-Reported as Committed",24,0,0,0,24
1759959,1355324,2023-09-27,House,"House Aging And Older Adult Services: Report Bill As Committed",25,0,0,0,25
1759959,1362308,2023-12-11,House,"House Floor: SB 607 PN 657, FINAL PASSAGE",203,0,0,0,203
1759959,1362309,2023-12-11,House,"House Appropriations: Re-report Bill As Committed",37,0,0,0,37
1760019,1320820,2023-05-09,Senate,"Senate Finance: Reported as Committed",11,0,0,0,11
1760033,1329991,2023-05-22,House,"House Health: Report Bill As Committed",21,0,0,0,21
1760037,1322538,2023-05-10,Senate,"Senate Transportation: Reported as Committed",14,0,0,0,14
1760037,1339765,2023-06-06,Senate,"Senate Floor: SB 630 PN 668, Motion to Agree",50,0,0,0,50
1760037,1347430,2023-06-26,Senate,"Senate Floor: SB 630 PN 668, Final Passage",49,0,0,1,50
1760064,1467782,2024-09-30,House,"House Consumer Protection, Technology And Utilities: Report Bill As Committed",18,7,0,0,25
1760064,1467919,2024-10-01,House,"House Floor: HB 1077 PN 1104, 2023 A5751",109,93,0,1,203
1760064,1468065,2024-10-02,House,"House Floor: HB 1077 PN 3694, FINAL PASSAGE",111,91,0,1,203
1760064,1468066,2024-10-02,House,"House Appropriations: Re-report Bill As Committed",22,15,0,0,37
1760079,1317998,2023-05-03,House,"House Transportation: Report Bill As Committed",21,0,0,0,21
1760079,1332039,2023-05-24,House,"House Floor: HR 97 PN 1117",201,0,0,0,201
1760094,1452625,2024-06-03,House,"House Education: Adopt Amendment A04611",14,11,0,0,25
1760094,1452626,2024-06-03,House,"House Education: Report Bill As Committed",17,8,0,0,25
1760140,1315865,2023-05-01,Senate,"Senate Finance: Reported as Committed",7,4,0,0,11
1760140,1316892,2023-05-02,Senate,"Senate Appropriations: Motion to Table",9,15,0,0,24
1760140,1316893,2023-05-02,Senate,"Senate Appropriations: Re-Reported as Committed",16,8,0,0,24
1760140,1317615,2023-05-03,Senate,"Senate Floor: SB 671 PN 671, 2023 A467, Motion to Table BOSCOLA Amendment No. A-0467",27,22,0,1,50
1760140,1317616,2023-05-03,Senate,"Senate Floor: SB 671 PN 671, Final Passage",28,21,0,1,50
1760140,1403671,2023-05-02,Senate,"Senate Appropriations: Re-Reported as Committed",16,8,0,0,24
1760363,1332011,2023-05-24,House,"House Judiciary: Report Bill As Committed",21,0,0,0,21
1760363,1342755,2023-06-12,House,"House Floor: HB 1085 PN 1089, FINAL PASSAGE",132,71,0,0,203
1760363,1342756,2023-06-12,House,"House Appropriations: Re-report Bill As Committed",37,0,0,0,37
1760396,1330000,2023-05-22,House,"House Health: Report Bill As Committed",21,0,0,0,21
1760396,1342458,2023-06-05,House,"House Floor: HR 99 PN 1119",202,1,0,0,203
1760408,1356092,2023-10-17,Senate,"Senate Law And Justice: Reported as Committed",11,0,0,0,11
1760415,1322572,2023-05-10,Senate,"Senate Transportation: Reported as Committed",14,0,0,0,14
1760446,1357530,2023-11-14,Senate,"Senate State Government: Reported as Committed",11,0,0,0,11
1760446,1362153,2023-12-11,Senate,"Senate Appropriations: Re-Reported as Committed",24,0,0,0,24
1760446,1362639,2023-12-13,Senate,"Senate Floor: SB 634 PN 673, Final Passage",50,0,0,0,50
1760473,1340600,2023-06-07,Senate,"Senate Transportation: Reported as Amended",13,1,0,0,14
1760473,1340601,2023-06-07,Senate,"Senate Transportation: Adopt Amendment A00848",13,1,0,0,14
1760473,1346020,2023-06-21,Senate,"Senate Floor: SB 656 PN 859, Final Passage",41,9,0,0,50
1760473,1346021,2023-06-21,Senate,"Senate Appropriations: Re-Reported as Committed",21,3,0,0,24
1760473,1362138,2023-12-11,House,"House Transportation: Report Bill As Committed",22,3,0,0,25
1760473,1362454,2023-12-12,House,"House Floor: SB 656 PN 859, 2023 A3116",101,102,0,0,203
1760473,1362455,2023-12-12,House,"House Floor: SB 656 PN 859, 2023 A3287",203,0,0,0,203
1760473,1422493,2024-04-09,House,"House Appropriations: Adopt Amendment A03857",22,15,0,0,37
1760473,1424152,2024-04-10,House,"House Appropriations: Re-report Bill As Amended",22,15,0,0,37
1760473,1462746,2024-07-09,House,"House Appropriations: Re-report Bill As Amended",37,0,0,0,37
1760473,1462747,2024-07-09,House,"House Appropriations: Adopt Amendment A05483",37,0,0,0,37
1760473,1462898,2024-07-10,House,"House Floor: SB 656 PN 1811, FINAL PASSAGE",190,12,0,1,203
1760473,1462967,2024-07-11,Senate,"Senate Rules And Executive Nominations: Re-Reported as Committed",16,1,0,0,17
1760473,1463030,2024-07-11,Senate,"Senate Floor: SB 656 PN 1811, Concur in House Amendments",44,5,0,1,50
1760541,1347993,2023-06-28,House,"House Game And Fisheries: Re-refer Bill To Another Committee",21,0,0,0,21
1760545,1343332,2023-06-13,House,"House Appropriations: Report Bill As Committed",22,15,0,0,37
1760545,1344147,2023-06-14,House,"House Floor: HB 622 PN 1131, 2023 A994",84,119,0,0,203
1760545,1344148,2023-06-14,House,"House Rules: Re-report Bill As Committed",18,15,0,0,33
1760545,1346323,2023-06-21,House,"House Appropriations: Adopt Amendment A00716",22,15,0,0,37
1760545,1346461,2023-06-22,House,"House Appropriations: Re-report Bill As Amended",22,15,0,0,37
1760545,1347007,2023-06-22,House,"House Floor: HB 622 PN 1686, FINAL PASSAGE",102,101,0,0,203
1760545,1347734,2023-06-27,Senate,"Senate Appropriations: Reported as Committed",24,0,0,0,24
1760545,1349193,2023-06-30,Senate,"Senate Floor: HB 622 PN 1686, Final Passage",49,1,0,0,50
1760548,1343588,2023-06-13,House,"House Appropriations: Report Bill As Committed",22,15,0,0,37
1760548,1344093,2023-06-14,House,"House Rules: Re-report Bill As Committed",18,15,0,0,33
1760548,1346277,2023-06-21,House,"House Appropriations: Adopt Amendment A01151",22,15,0,0,37
1760548,1346455,2023-06-22,House,"House Appropriations: Re-report Bill As Amended",22,15,0,0,37
1760548,1347003,2023-06-22,House,"House Floor: HB 616 PN 1683, FINAL PASSAGE",102,101,0,0,203
1760548,1347643,2023-06-27,Senate,"Senate Appropriations: Reported as Committed",24,0,0,0,24
1760548,1349194,2023-06-30,Senate,"Senate Floor: HB 616 PN 1683, Final Passage",49,1,0,0,50
1760552,1343402,2023-06-13,House,"House Appropriations: Report Bill As Committed",22,15,0,0,37
1760552,1344156,2023-06-14,House,"House Rules: Re-report Bill As Committed",18,15,0,0,33
1760552,1346761,2023-06-22,House,"House Floor: HB 623 PN 1132, FINAL PASSAGE",102,101,0,0,203
1760552,1346762,2023-06-22,House,"House Appropriations: Re-report Bill As Committed",22,15,0,0,37
1760552,1347729,2023-06-27,Senate,"Senate Appropriations: Reported as Committed",24,0,0,0,24
1760552,1357482,2023-11-13,Senate,"Senate Floor: HB 623 PN 1132, Final Passage",48,2,0,0,50
1760556,1330826,2023-05-23,House,"House Veterans Affairs And Emergency Preparedness: Adopt Amendment A00535",21,0,0,0,21
1760556,1330827,2023-05-23,House,"House Veterans Affairs And Emergency Preparedness: Report Bill As Amended",21,0,0,0,21
1760556,1340887,2023-06-07,House,"House Floor: HB 1086 PN 1303, FINAL PASSAGE",190,13,0,0,203
1760556,1340888,2023-06-07,House,"House Appropriations: Re-report Bill As Committed",37,0,0,0,37
1760556,1357434,2023-11-13,Senate,"Senate Veterans Affairs And Emergency Preparedness: Reported as Committed",11,0,0,0,11
1760556,1462748,2024-07-09,Senate,"Senate Appropriations: Re-Reported as Committed",23,0,1,0,24
1760556,1462819,2024-07-09,Senate,"Senate Floor: HB 1086 PN 1303, Final Passage",48,1,0,1,50
1760560,1343530,2023-06-13,House,"House Appropriations: Report Bill As Committed",22,15,0,0,37
1760560,1344065,2023-06-14,House,"House Floor: HB 614 PN 1123, 2023 A973",203,0,0,0,203
1760560,1344066,2023-06-14,House,"House Rules: Re-report Bill As Committed",18,15,0,0,33
1760560,1346232,2023-06-21,House,"House Appropriations: Adopt Amendment A01131",22,15,0,0,37
1760560,1346911,2023-06-22,House,"House Floor: HB 614 PN 1682, FINAL PASSAGE",102,101,0,0,203
1760560,1346912,2023-06-22,House,"House Appropriations: Re-report Bill As Amended",22,15,0,0,37
1760560,1347730,2023-06-27,Senate,"Senate Appropriations: Reported as Committed",24,0,0,0,24
1760560,1348231,2023-06-28,Senate,"Senate Floor: HB 614 PN 1682, Motion to Agree on the Bill in Second Consideration",50,0,0,0,50
1760560,1349182,2023-06-30,Senate,"Senate Floor: HB 614 PN 1682, Final Passage",49,1,0,0,50
1760570,1343567,2023-06-13,House,"House Appropriations: Report Bill As Committed",22,15,0,0,37
1760570,1344081,2023-06-14,House,"House Rules: Re-report Bill As Committed",18,15,0,0,33
1760570,1346183,2023-06-21,House,"House Appropriations: Adopt Amendment A00715",22,15,0,0,37
1760570,1347001,2023-06-22,House,"House Floor: HB 619 PN 1685, FINAL PASSAGE",102,101,0,0,203
1760570,1347002,2023-06-22,House,"House Appropriations: Re-report Bill As Amended",22,15,0,0,37
1760570,1347740,2023-06-27,Senate,"Senate Appropriations: Reported as Committed",24,0,0,0,24
1760570,1349188,2023-06-30,Senate,"Senate Floor: HB 619 PN 1685, Final Passage",49,1,0,0,50
1760573,1343944,2023-06-13,House,"House Appropriations: Report Bill As Committed",22,15,0,0,37
1760573,1343945,2023-06-14,House,"House Rules: Re-report Bill As Committed",18,15,0,0,33
1760573,1346906,2023-06-22,House,"House Floor: HB 615 PN 1124, FINAL PASSAGE",102,101,0,0,203
1760573,1346907,2023-06-22,House,"House Appropriations: Re-report Bill As Committed",22,15,0,0,37
1760573,1347648,2023-06-27,Senate,"Senate Appropriations: Reported as Committed",24,0,0,0,24
1760573,1349195,2023-06-30,Senate,"Senate Floor: HB 615 PN 1124, Final Passage",49,1,0,0,50
1760584,1343846,2023-06-13,House,"House Appropriations: Report Bill As Committed",22,15,0,0,37
1760584,1343963,2023-06-14,House,"House Rules: Re-report Bill As Committed",18,15,0,0,33
1760584,1346460,2023-06-22,House,"House Appropriations: Re-report Bill As Committed",22,15,0,0,37
1760584,1347009,2023-06-22,House,"House Floor: HB 620 PN 1129, FINAL PASSAGE",102,101,0,0,203
1760584,1347738,2023-06-27,Senate,"Senate Appropriations: Reported as Committed",24,0,0,0,24
1760584,1349189,2023-06-30,Senate,"Senate Floor: HB 620 PN 1129, Final Passage",50,0,0,0,50
1760587,1345812,2023-06-21,House,"House Appropriations: Re-report Bill As Committed",22,15,0,0,37
1760587,1346406,2023-06-21,House,"House Rules: Re-report Bill As Committed",18,15,0,0,33
1760587,1346407,2023-06-22,House,"House Floor: HB 613 PN 1122, SECOND CONSIDERATION",118,85,0,0,203
1760587,1346859,2023-06-22,House,"House Appropriations: Re-report Bill As Committed",24,13,0,0,37
1760587,1347581,2023-06-26,House,"House Floor: HB 613 PN 1122, FINAL PASSAGE",177,26,0,0,203
1760587,1347677,2023-06-27,Senate,"Senate Appropriations: Reported as Committed",24,0,0,0,24
1760587,1362464,2023-12-12,Senate,"Senate Appropriations: Re-Reported as Amended",24,0,0,0,24
1760587,1362465,2023-12-12,Senate,"Senate Appropriations: Adopt Amendment A03286",16,8,0,0,24
1760587,1362535,2023-12-13,House,"House Floor: HB 613 PN 2430, CONCURRENCE",124,79,0,0,203
1760587,1362536,2023-12-13,House,"House Rules: Re-report Bill As Committed",18,15,0,0,33
1760587,1362649,2023-12-13,House,"House Floor: HB 613 PN 2430, MOTION TO RECONSIDER",105,98,0,0,203
1760587,1362650,2023-12-13,House,"House Floor: HB 613 PN 2430, CONCURRENCE",127,76,0,0,203
1760587,1362651,2023-12-13,Senate,"Senate Floor: HB 613 PN 2430, Final Passage",47,3,0,0,50
1760587,1462167,2024-07-02,Senate,"Senate Rules And Executive Nominations: Re-Reported as Amended",17,0,0,0,17
1760587,1462168,2024-07-02,Senate,"Senate Rules And Executive Nominations: Adopt Amendment A05392",17,0,0,0,17
1760587,1462394,2024-07-03,Senate,"Senate Floor: HB 613 PN 3479, Final Passage",44,6,0,0,50
1760587,1462736,2024-07-09,House,"House Rules: Re-report Bill As Committed",33,0,0,0,33
1760587,1463029,2024-07-11,House,"House Floor: HB 613 PN 3479, CONCURRENCE",145,57,0,1,203
1760590,1330870,2023-05-23,House,"House Veterans Affairs And Emergency Preparedness: Report Bill As Committed",21,0,0,0,21
1760601,1329663,2023-05-22,House,"House Appropriations: Report Bill As Committed",22,15,0,0,37
1760601,1330336,2023-05-23,House,"House Floor: HB 611 PN 1120, 2023 A567",100,101,0,0,201
1760601,1330337,2023-05-23,House,"House Floor: HB 611 PN 1120, 2023 A576, CONSTITUTIONALITY",100,101,0,0,201
1760601,1330338,2023-05-23,House,"House Floor: HB 611 PN 1120, 2023 A578",100,101,0,0,201
1760601,1330339,2023-05-23,House,"House Floor: HB 611 PN 1120, 2023 A580",98,103,0,0,201
1760601,1330340,2023-05-23,House,"House Floor: HB 611 PN 1120, 2023 A582",92,109,0,0,201
1760601,1331546,2023-05-23,House,"House Floor: HB 611 PN 1120, 2023 A590",92,109,0,0,201
1760601,1331547,2023-05-23,House,"House Floor: HB 611 PN 1120, 2023 A591",92,109,0,0,201
1760601,1331548,2023-05-23,House,"House Floor: HB 611 PN 1120, 2023 A595",90,111,0,0,201
1760601,1331549,2023-05-23,House,"House Floor: HB 611 PN 1120, 2023 A584",92,109,0,0,201
1760601,1331550,2023-05-23,House,"House Floor: HB 611 PN 1120, 2023 A586",94,107,0,0,201
1760601,1331551,2023-05-23,House,"House Floor: HB 611 PN 1120, 2023 A588",92,109,0,0,201
1760601,1331552,2023-05-23,House,"House Floor: HB 611 PN 1120, 2023 A610",100,101,0,0,201
1760601,1331553,2023-05-23,House,"House Floor: HB 611 PN 1120, 2023 A613",97,104,0,0,201
1760601,1331554,2023-05-23,House,"House Floor: HB 611 PN 1120, 2023 A614",97,104,0,0,201
1760601,1331555,2023-05-23,House,"House Floor: HB 611 PN 1120, 2023 A615",100,101,0,0,201
1760601,1331556,2023-05-23,House,"House Floor: HB 611 PN 1120, 2023 A616",100,101,0,0,201
1760601,1331557,2023-05-23,House,"House Floor: HB 611 PN 1120, 2023 A617",100,101,0,0,201
1760601,1331558,2023-05-23,House,"House Floor: HB 611 PN 1120, 2023 A619",100,101,0,0,201
1760601,1331559,2023-05-23,House,"House Floor: HB 611 PN 1120, 2023 A623",100,101,0,0,201
1760601,1331560,2023-05-23,House,"House Floor: HB 611 PN 1120, 2023 A628",94,107,0,0,201
1760601,1331561,2023-05-23,House,"House Floor: HB 611 PN 1120, 2023 A625",96,105,0,0,201
1760601,1331562,2023-05-23,House,"House Floor: HB 611 PN 1120, 2023 A627",99,102,0,0,201
1760601,1339071,2023-06-05,House,"House Floor: HB 611 PN 1434, FINAL PASSAGE",102,101,0,0,203
1760601,1340392,2023-06-05,House,"House Appropriations: Adopt Amendment A00793",22,15,0,0,37
1760601,1340393,2023-06-05,House,"House Appropriations: Re-report Bill As Amended",22,15,0,0,37
1760601,1346575,2023-06-22,Senate,"Senate Appropriations: Reported as Amended",15,9,0,0,24
1760601,1346576,2023-06-22,Senate,"Senate Appropriations: Adopt Amendment A01156",15,9,0,0,24
1760601,1349062,2023-06-30,Senate,"Senate Floor: HB 611 PN 1811, Motion to Suspend Senate Rule 12",44,6,0,0,50
1760601,1349063,2023-06-30,Senate,"Senate Floor: HB 611 PN 1811, Final Passage",29,21,0,0,50
1760601,1349064,2023-06-30,Senate,"Senate Appropriations: Re-Reported as Amended",15,9,0,0,24
1760601,1349065,2023-06-30,Senate,"Senate Appropriations: Adopt Amendment A01724",15,9,0,0,24
1760601,1349555,2023-07-05,House,"House Floor: HB 611 PN 1811, CONCURRENCE",117,86,0,0,203
1760601,1349556,2023-07-05,House,"House Rules: Re-report Bill As Committed",18,15,0,0,33
1760608,1346401,2023-06-21,House,"House Appropriations: Report Bill As Committed",22,15,0,0,37
1760608,1346402,2023-06-21,House,"House Rules: Re-report Bill As Committed",18,15,0,0,33
1760608,1346849,2023-06-22,House,"House Floor: HB 612 PN 1121, MOTION TO APPEAL RULING OF THE CHAIR",102,101,0,0,203
1760608,1346850,2023-06-22,House,"House Floor: HB 612 PN 1121, SECOND CONSIDERATION",115,88,0,0,203
1760608,1346851,2023-06-22,House,"House Appropriations: Report Bill As Amended",23,14,0,0,37
1760608,1346852,2023-06-22,House,"House Appropriations: Adopt Amendment",22,15,0,0,37
1760608,1347434,2023-06-26,House,"House Floor: HB 612 PN 1703, FINAL PASSAGE",118,85,0,0,203
1760608,1349841,2023-07-06,House,"House Floor: HB 612 PN 1703, MOTION TO RECONSIDER",102,101,0,0,203
1760608,1349842,2023-07-06,House,"House Floor: HB 612 PN 1703, FINAL PASSAGE",130,73,0,0,203
1760608,1356731,2023-10-31,House,"House Floor: HB 612 PN 1703, MOTION TO RECONSIDER",202,0,0,1,203
1760608,1356732,2023-10-31,House,"House Floor: HB 612 PN 1703, 2023 A2828, MOTION TO SUSPEND RULES",201,1,0,1,203
1760608,1356733,2023-10-31,House,"House Floor: HB 612 PN 1703, 2023 A2828",202,0,0,1,203
1760608,1356734,2023-10-31,House,"House Floor: HB 612 PN 2233, FINAL PASSAGE",145,57,0,1,203
1760613,1343323,2023-06-13,House,"House Appropriations: Report Bill As Committed",22,15,0,0,37
1760613,1344128,2023-06-14,House,"House Rules: Re-report Bill As Committed",18,15,0,0,33
1760613,1346473,2023-06-22,House,"House Appropriations: Re-report Bill As Committed",22,15,0,0,37
1760613,1347020,2023-06-22,House,"House Floor: HB 617 PN 1126, FINAL PASSAGE",102,101,0,0,203
1760613,1347739,2023-06-27,Senate,"Senate Appropriations: Reported as Committed",24,0,0,0,24
1760613,1348996,2023-06-30,Senate,"Senate Floor: HB 617 PN 1126, Final Passage",50,0,0,0,50
1760617,1343351,2023-06-13,House,"House Appropriations: Report Bill As Committed",22,15,0,0,37
1760617,1344145,2023-06-14,House,"House Rules: Re-report Bill As Committed",18,15,0,0,33
1760617,1345955,2023-06-21,House,"House Floor: HB 621 PN 1130, 2023 A979",27,176,0,0,203
1760617,1346653,2023-06-22,House,"House Floor: HB 621 PN 1130, FINAL PASSAGE",102,101,0,0,203
1760617,1346654,2023-06-22,House,"House Appropriations: Re-report Bill As Committed",22,15,0,0,37
1760617,1347705,2023-06-27,Senate,"Senate Appropriations: Reported as Committed",24,0,0,0,24
1760617,1348986,2023-06-30,Senate,"Senate Floor: HB 621 PN 1130, Final Passage",49,1,0,0,50
1760618,1343503,2023-06-13,House,"House Appropriations: Report Bill As Committed",22,15,0,0,37
1760618,1344055,2023-06-14,House,"House Rules: Re-report Bill As Committed",18,15,0,0,33
1760618,1346116,2023-06-21,House,"House Appropriations: Adopt Amendment A00714",22,15,0,0,37
1760618,1346909,2023-06-22,House,"House Floor: HB 618 PN 1684, FINAL PASSAGE",102,101,0,0,203
1760618,1346910,2023-06-22,House,"House Appropriations: Re-report Bill As Amended",22,15,0,0,37
1760618,1347727,2023-06-27,Senate,"Senate Appropriations: Reported as Committed",24,0,0,0,24
1760618,1349158,2023-06-30,Senate,"Senate Floor: HB 618 PN 1684, Final Passage",50,0,0,0,50
1760676,1329716,2023-05-22,House,"House Transportation: Report Bill As Committed",21,0,0,0,21
1760676,1342687,2023-06-12,House,"House Floor: HB 1092 PN 1140, 2023 A876",203,0,0,0,203
1760676,1343500,2023-06-13,House,"House Floor: HB 1092 PN 1536, FINAL PASSAGE",155,48,0,0,203
1760676,1343501,2023-06-13,House,"House Appropriations: Re-report Bill As Committed",37,0,0,0,37
1760706,1330020,2023-05-22,House,"House Education: Report Bill As Committed",21,0,0,0,21
1760706,1331328,2023-05-23,House,"House Floor: HB 1094 PN 1142, 2023 A604",201,0,0,0,201
1760706,1331685,2023-05-24,House,"House Appropriations: Re-report Bill As Committed",37,0,0,0,37
1760706,1332421,2023-05-24,House,"House Floor: HB 1094 PN 1306, FINAL PASSAGE",201,0,0,0,201
1760706,1347968,2023-06-27,Senate,"Senate Education: Reported as Committed",11,0,0,0,11
1760706,1356385,2023-10-23,Senate,"Senate Appropriations: Re-Reported as Committed",24,0,0,0,24
1760706,1356507,2023-10-25,Senate,"Senate Floor: HB 1094 PN 1306, Final Passage",50,0,0,0,50
1760737,1356445,2023-10-24,Senate,"Senate Health And Human Services: Reported as Amended",11,0,0,0,11
1760737,1356446,2023-10-24,Senate,"Senate Health And Human Services: Adopt Amendment A02666",11,0,0,0,11
1760737,1357457,2023-11-13,Senate,"Senate Appropriations: Re-Reported as Committed",24,0,0,0,24
1760737,1357651,2023-11-14,Senate,"Senate Floor: SB 668 PN 1180, Final Passage",50,0,0,0,50
1760737,1416180,2024-03-27,House,"House Health: Report Bill As Amended",25,0,0,0,25
1760737,1416181,2024-03-27,House,"House Health: Adopt Amendment A03757",21,4,0,0,25
1760737,1468086,2024-10-02,House,"House Floor: SB 668 PN 1460, 2023 A5718",202,0,0,1,203
1760737,1468218,2024-10-07,House,"House Floor: SB 668 PN 1928, FINAL PASSAGE",200,2,0,1,203
1760737,1468219,2024-10-07,House,"House Appropriations: Re-report Bill As Committed",37,0,0,0,37
1760737,1468321,2024-10-08,Senate,"Senate Rules And Executive Nominations: Re-Reported as Committed",17,0,0,0,17
1760737,1468433,2024-10-08,Senate,"Senate Floor: SB 668 PN 1928, Concur in House Amendments",50,0,0,0,50
1760766,1339668,2023-06-05,House,"House State Government: Report Bill As Committed",12,9,0,0,21
1760766,1346437,2023-06-22,House,"House Floor: HR 100 PN 1147",202,1,0,0,203
1760780,1340707,2023-06-07,Senate,"Senate Finance: Reported as Committed",7,4,0,0,11
1760780,1354910,2023-09-19,Senate,"Senate Floor: SB 654 PN 698, Final Passage",44,2,0,4,50
1760780,1354911,2023-09-19,Senate,"Senate Appropriations: Re-Reported as Committed",21,2,1,0,24
1760780,1362325,2023-12-12,House,"House Finance: Re-report Bill As Committed",21,2,2,0,25
1760780,1362545,2023-12-13,House,"House Floor: SB 654 PN 698, 2023 A3309",102,101,0,0,203
1760780,1410346,2024-03-18,House,"House Appropriations: To Strike Amendment",15,22,0,0,37
1760780,1410347,2024-03-18,House,"House Appropriations: Re-report Bill As Amended",22,15,0,0,37
1760780,1410348,2024-03-18,House,"House Appropriations: Adopt Amendment A03627",22,15,0,0,37
1760780,1411162,2024-03-19,House,"House Appropriations: Re-report Bill As Amended",22,15,0,0,37
1760780,1411163,2024-03-19,House,"House Appropriations: Adopt Amendment A03667",22,15,0,0,37
1760780,1412439,2024-03-20,House,"House Floor: SB 654 PN 1433, FINAL PASSAGE",106,95,0,1,202
1760780,1462963,2024-07-11,Senate,"Senate Rules And Executive Nominations: Re-Reported as Amended",15,2,0,0,17
1760780,1462964,2024-07-11,Senate,"Senate Rules And Executive Nominations: Adopt Amendment A05533",15,2,0,0,17
1760780,1463025,2024-07-11,House,"House Floor: SB 654 PN 1815, CONCURRENCE",129,73,0,1,203
1760780,1463026,2024-07-11,Senate,"Senate Floor: SB 654 PN 1815, Concurrence in House Amendments as Amended",43,6,0,1,50
1760780,1463027,2024-07-11,House,"House Rules: Re-report Bill As Committed",18,15,0,0,33
1760882,1347131,2023-06-22,House,"House Liquor Control: Adopt Amendment A01087",21,0,0,0,21
1760882,1347132,2023-06-22,House,"House Liquor Control: Adopt Amendment A01155",21,0,0,0,21
1760882,1347133,2023-06-22,House,"House Liquor Control: Report Bill As Amended",21,0,0,0,21
1760882,1348761,2023-06-29,House,"House Rules: Re-report Bill As Committed",33,0,0,0,33
1760882,1349716,2023-07-06,House,"House Floor: HB 1096 PN 1687, FINAL PASSAGE",172,31,0,0,203
1760882,1349717,2023-07-06,House,"House Appropriations: Re-report Bill As Committed",37,0,0,0,37
1760882,1356397,2023-10-24,Senate,"Senate Law And Justice: Reported as Amended",11,0,0,0,11
1760882,1356398,2023-10-24,Senate,"Senate Law And Justice: Adopt Amendment A02724",11,0,0,0,11
1760882,1362299,2023-12-11,Senate,"Senate Floor: HB 1096 PN 2189, 2023 A3145, PITTMAN Amendment No. A-3145",48,0,0,2,50
1760882,1362400,2023-12-12,Senate,"Senate Floor: HB 1096 PN 2411, 2023 A3320, WILLIAMS, A. Amendment No. A-3320",50,0,0,0,50
1760882,1362401,2023-12-12,Senate,"Senate Appropriations: Re-Reported as Committed",24,0,0,0,24
1760882,1362643,2023-12-13,House,"House Floor: HB 1096 PN 2433, CONCURRENCE",199,4,0,0,203
1760882,1362644,2023-12-13,Senate,"Senate Floor: HB 1096 PN 2433, Final Passage",49,1,0,0,50
1760882,1362645,2023-12-13,House,"House Rules: Re-report Bill As Committed",33,0,0,0,33
1760988,1329696,2023-05-22,House,"House Education: Adopt Amendment A00496",21,0,0,0,21
1760988,1329697,2023-05-22,House,"House Education: Report Bill As Amended",21,0,0,0,21
1760988,1339065,2023-06-05,House,"House Floor: HB 1097 PN 1288, FINAL PASSAGE",203,0,0,0,203
1760988,1340584,2023-06-05,House,"House Appropriations: Re-report Bill As Committed",37,0,0,0,37
1760988,1440513,2024-05-07,Senate,"Senate Education: Reported as Committed",11,0,0,0,11
1760988,1452950,2024-06-03,Senate,"Senate Appropriations: Re-Reported as Committed",24,0,0,0,24
1760988,1453920,2024-06-05,Senate,"Senate Floor: HB 1097 PN 1288, Final Passage",50,0,0,0,50
1761026,1436606,2024-04-30,Senate,"Senate State Government: Reported as Committed",9,2,0,0,11
1761040,1362592,2023-12-13,Senate,"Senate Floor: SR 110 PN 704",50,0,0,0,50
1761040,1362593,2023-12-13,Senate,"Senate Finance: Reported as Committed",11,0,0,0,11
1761053,1349900,2023-06-22,House,"House Human Services: Re-refer Bill To Another Committee",25,0,0,0,25
1761133,1412212,2024-03-20,Senate,"Senate Finance: Reported as Amended",9,2,0,0,11
1761133,1412213,2024-03-20,Senate,"Senate Finance: Adopt Amendment A03612",10,1,0,0,11
1761159,1343971,2023-06-14,House,"House Judiciary: Report Bill As Committed",12,9,0,0,21
1761159,1346126,2023-06-21,House,"House Rules: Re-report Bill As Committed",18,15,0,0,33
1761159,1346511,2023-06-22,House,"House Floor: HB 1108 PN 1164, 2023 A1065",202,1,0,0,203
1761159,1346512,2023-06-22,House,"House Floor: HB 1108 PN 1164, 2023 A1267",199,4,0,0,203
1761159,1346513,2023-06-22,House,"House Floor: HB 1108 PN 1164, 2023 A1181",100,103,0,0,203
1761159,1347391,2023-06-26,House,"House Appropriations: Re-report Bill As Committed",37,0,0,0,37
1761159,1347475,2023-06-26,House,"House Floor: HB 1108 PN 1677, FINAL PASSAGE",125,78,0,0,203
1761171,1331026,2023-05-23,House,"House Finance: Re-report Bill As Committed",20,0,1,0,21
1761171,1331027,2023-05-23,House,"House Finance: Adopt Amendment A00527",8,12,1,0,21
1761171,1331760,2023-05-24,House,"House Floor: HB 1100 PN 1148, 2023 A608, MOTION TO APPEAL RULING OF THE CHAIR",101,100,0,0,201
1761171,1331761,2023-05-24,House,"House Floor: HB 1100 PN 1148, 2023 A634, MOTION TO TABLE",101,100,0,0,201
1761171,1331762,2023-05-24,House,"House Floor: HB 1100 PN 1148, 2023 A656",71,130,0,0,201
1761171,1331763,2023-05-24,House,"House Floor: HB 1100 PN 1148, 2023 A668",201,0,0,0,201
1761171,1339066,2023-06-05,House,"House Floor: HB 1100 PN 1362, FINAL PASSAGE",194,9,0,0,203
1761171,1340409,2023-06-05,House,"House Appropriations: Re-report Bill As Committed",22,15,0,0,37
1761171,1347614,2023-06-27,Senate,"Senate Finance: Reported as Amended",11,0,0,0,11
1761171,1347615,2023-06-27,Senate,"Senate Finance: Adopt Amendment A01478",11,0,0,0,11
1761171,1348980,2023-06-30,Senate,"Senate Appropriations: Re-Reported as Committed",24,0,0,0,24
1761171,1349162,2023-06-30,Senate,"Senate Floor: HB 1100 PN 1740, Final Passage",50,0,0,0,50
1761171,1349670,2023-07-05,House,"House Floor: HB 1100 PN 1740, CONCURRENCE",197,6,0,0,203
1761171,1349671,2023-07-05,House,"House Rules: Re-report Bill As Committed",33,0,0,0,33
1761284,1329839,2023-05-22,House,"House Health: Report Bill As Committed",21,0,0,0,21
1761284,1342777,2023-06-12,House,"House Floor: HB 1131 PN 1186, 2023 A782",101,102,0,0,203
1761284,1343412,2023-06-13,House,"House Floor: HB 1131 PN 1186, FINAL PASSAGE",199,4,0,0,203
1761284,1343413,2023-06-13,House,"House Appropriations: Re-report Bill As Committed",37,0,0,0,37
1761284,1362272,2023-12-11,Senate,"Senate Health And Human Services: Reported as Committed",10,0,1,0,11
1761284,1362364,2023-12-12,Senate,"Senate Appropriations: Re-Reported as Committed",24,0,0,0,24
1761284,1362634,2023-12-13,Senate,"Senate Floor: HB 1131 PN 1186, Final Passage",50,0,0,0,50
1761295,1347607,2023-06-27,House,"House Judiciary: Adopt Amendment A01357",21,0,0,0,21
1761295,1347608,2023-06-27,House,"House Judiciary: Report Bill As Amended",12,9,0,0,21
1761295,1349687,2023-07-06,House,"House Floor: HB 1130 PN 1741, 2023 A1642, MOTION TO APPEAL RULING OF THE CHAIR",102,101,0,0,203
1761295,1349688,2023-07-06,House,"House Floor: HB 1130 PN 1741, 2023 A1631",203,0,0,0,203
1761295,1349689,2023-07-06,House,"House Floor: HB 1130 PN 1741, 2023 A1641",101,102,0,0,203
1761295,1349690,2023-07-06,House,"House Rules: Re-report Bill As Committed",18,15,0,0,33
1761295,1349858,2023-07-07,House,"House Floor: HB 1130 PN 1825, FINAL PASSAGE",102,101,0,0,203
1761295,1349859,2023-07-07,House,"House Appropriations: Re-report Bill As Committed",22,15,0,0,37
1761575,1321734,2023-05-10,Senate,"Senate Law And Justice: Reported as Committed",6,5,0,0,11
1761575,1453900,2024-06-05,Senate,"Senate Floor: SB 688 PN 710, Final Passage",26,24,0,0,50
1761575,1453901,2024-06-05,Senate,"Senate Appropriations: Re-Reported as Committed",15,9,0,0,24
1761575,1459846,2024-06-25,House,"House Liquor Control: Adopt Amendment A05122",14,11,0,0,25
1761575,1459847,2024-06-25,House,"House Liquor Control: Report Bill As Amended",14,11,0,0,25
1761575,1461002,2024-06-27,House,"House Floor: SB 688 PN 1775, 2023 A5302",201,1,0,1,203
1761575,1461249,2024-06-27,House,"House Appropriations: Re-report Bill As Committed",37,0,0,0,37
1761575,1462124,2024-07-01,House,"House Appropriations: Adopt Amendment A05348",37,0,0,0,37
1761575,1462125,2024-07-01,House,"House Appropriations: Re-report Bill As Amended",37,0,0,0,37
1761575,1462382,2024-07-02,House,"House Floor: SB 688 PN 1800, FINAL PASSAGE",163,38,0,2,203
1761575,1463016,2024-07-11,Senate,"Senate Floor: SB 688 PN 1800, Concur in House Amendments",32,17,0,1,50
1761575,1463017,2024-07-11,Senate,"Senate Rules And Executive Nominations: Re-Reported as Committed",13,4,0,0,17
1761615,1321726,2023-05-10,Senate,"Senate Environmental Resources And Energy: Reported as Committed",8,3,0,0,11
1761615,1356464,2023-10-24,Senate,"Senate Appropriations: Re-Reported as Committed",17,7,0,0,24
1761615,1357476,2023-11-13,Senate,"Senate Floor: SB 690 PN 714, Final Passage",32,18,0,0,50
1761615,1357477,2023-11-13,Senate,"Senate Floor: SB 690 PN 714, Final Passage-Reconsidered",33,17,0,0,50
1761630,1322553,2023-05-10,Senate,"Senate Transportation: Reported as Amended",9,5,0,0,14
1761630,1322554,2023-05-10,Senate,"Senate Transportation: Adopt Amendment A00495",14,0,0,0,14
1761648,1321713,2023-05-10,Senate,"Senate Environmental Resources And Energy: Reported as Committed",7,4,0,0,11
1761648,1338670,2023-06-05,Senate,"Senate Appropriations: Re-Reported as Committed",15,9,0,0,24
1761648,1339677,2023-06-06,Senate,"Senate Floor: SB 691 PN 715, 2023 A638, YAW Amendment No. A-0638",28,22,0,0,50
1761648,1340844,2023-06-07,Senate,"Senate Floor: SB 691 PN 854, Final Passage",28,22,0,0,50
1761712,1322565,2023-05-10,Senate,"Senate Environmental Resources And Energy: Reported as Committed",7,4,0,0,11
1761712,1356466,2023-10-24,Senate,"Senate Appropriations: Re-Reported as Committed",16,8,0,0,24
1761712,1357478,2023-11-13,Senate,"Senate Floor: SB 689 PN 713, Final Passage",31,19,0,0,50
1761903,1321058,2023-05-09,Senate,"Senate Agriculture And Rural Affairs: Reported as Committed",11,0,0,0,11
1761903,1345777,2023-06-21,Senate,"Senate Appropriations: Re-Reported as Committed",24,0,0,0,24
1761903,1346930,2023-06-22,Senate,"Senate Floor: SB 694 PN 722, Final Passage",48,0,0,2,50
1761903,1355234,2023-09-27,House,"House Agriculture And Rural Affairs: Adopt Amendment A02111",25,0,0,0,25
1761903,1355235,2023-09-27,House,"House Agriculture And Rural Affairs: Report Bill As Amended",25,0,0,0,25
1761903,1356125,2023-10-17,House,"House Floor: SB 694 PN 1114, FINAL PASSAGE",153,50,0,0,203
1761903,1356126,2023-10-17,House,"House Appropriations: Re-report Bill As Committed",37,0,0,0,37
1761903,1356380,2023-10-23,Senate,"Senate Floor: SB 694 PN 1114, Concur in House Amendments",45,5,0,0,50
1761903,1356381,2023-10-23,Senate,"Senate Rules And Executive Nominations: Re-Reported as Committed",16,1,0,0,17
1761966,1330664,2023-05-23,House,"House Consumer Protection, Technology And Utilities: Re-refer Bill To Another Committee",21,0,0,0,21
1761966,1339580,2023-06-06,House,"House Finance: Re-report Bill As Committed",12,9,0,0,21
1761966,1340823,2023-06-07,House,"House Floor: HB 1138 PN 1195, 2023 A815, MOTION TO APPEAL RULING OF THE CHAIR",102,101,0,0,203
1761966,1340824,2023-06-07,House,"House Rules: Re-report Bill As Committed",18,15,0,0,33
1761966,1342693,2023-06-12,House,"House Appropriations: Adopt Amendment A00544",37,0,0,0,37
1761966,1342694,2023-06-12,House,"House Appropriations: Re-report Bill As Amended",37,0,0,0,37
1761966,1343390,2023-06-13,House,"House Floor: HB 1138 PN 1535, FINAL PASSAGE",203,0,0,0,203
1761966,1347590,2023-06-27,Senate,"Senate Finance: Reported as Committed",11,0,0,0,11
1762136,1410083,2024-03-18,House,"House Commerce: Bring Up The Bill For Consideration",25,0,0,0,25
1762136,1410084,2024-03-18,House,"House Commerce: Report Bill As Committed",14,11,0,0,25
1762272,1346445,2023-06-22,House,"House Commerce: Adopt Amendment A01005",21,0,0,0,21
1762272,1346446,2023-06-22,House,"House Commerce: Bring Up The Bill For Consideration",21,0,0,0,21
1762272,1346447,2023-06-22,House,"House Commerce: Report Bill As Amended",12,9,0,0,21
1762272,1347990,2023-06-28,House,"House Rules: Re-report Bill As Committed",18,15,0,0,33
1762272,1348417,2023-06-28,House,"House Floor: HB 1139 PN 1689, 2023 A1509",203,0,0,0,203
1762272,1348608,2023-06-29,House,"House Appropriations: Re-report Bill As Committed",22,15,0,0,37
1762272,1348780,2023-06-29,House,"House Floor: HB 1139 PN 1773, FINAL PASSAGE",102,101,0,0,203
1762585,1332071,2023-05-23,House,"House Environmental Resources And Energy: Report Bill As Committed",21,0,0,0,21
1762585,1340653,2023-06-07,House,"House Floor: HR 104 PN 1207",172,31,0,0,203
1763038,1467560,2024-09-25,House,"House Judiciary: Adopt Amendment A05617",14,11,0,0,25
1763038,1467619,2024-09-25,House,"House Judiciary: Report Bill As Amended",14,11,0,0,25
1763129,1366382,2024-01-17,House,"House Judiciary: Adopt Amendment A03085",15,10,0,0,25
1763129,1366383,2024-01-17,House,"House Judiciary: Adopt Amendment A03136",14,11,0,0,25
1763129,1366384,2024-01-17,House,"House Judiciary: Report Bill As Amended",14,11,0,0,25
1763596,1330378,2023-05-23,House,"House Liquor Control: Report Bill As Amended",21,0,0,0,21
1763596,1330379,2023-05-23,House,"House Liquor Control: Adopt Amendment A00546",21,0,0,0,21
1763596,1343952,2023-06-14,House,"House Appropriations: Re-report Bill As Committed",37,0,0,0,37
1763596,1345391,2023-06-20,House,"House Floor: HB 1160 PN 1295, FINAL PASSAGE",202,1,0,0,203
1763596,1356130,2023-10-17,Senate,"Senate Law And Justice: Reported as Committed",11,0,0,0,11
1763596,1362276,2023-12-11,Senate,"Senate Appropriations: Re-Reported as Committed",24,0,0,0,24
1763596,1362376,2023-12-12,Senate,"Senate Floor: HB 1160 PN 1295, Final Passage",50,0,0,0,50
1763664,1329644,2023-05-22,House,"House Transportation: Report Bill As Committed",21,0,0,0,21
1763705,1343296,2023-06-13,House,"House Housing And Community Development: Adopt Amendment A00898",21,0,0,0,21
1763705,1343297,2023-06-13,House,"House Housing And Community Development: Report Bill As Amended",12,9,0,0,21
1763705,1343298,2023-06-13,House,"House Housing And Community Development: Adopt Amendment A00950",21,0,0,0,21
1763705,1343299,2023-06-13,House,"House Housing And Community Development: Adopt Amendment A00949",21,0,0,0,21
1763705,1343300,2023-06-13,House,"House Housing And Community Development: Adopt Amendment A00932",21,0,0,0,21
1763705,1347634,2023-06-27,House,"House Floor: HB 1163 PN 1562, 2023 A1461",139,64,0,0,203
1763705,1347635,2023-06-27,House,"House Floor: HB 1163 PN 1562, 2023 A1187",91,112,0,0,203
1763705,1347636,2023-06-27,House,"House Floor: HB 1163 PN 1562, 2023 A1188",88,115,0,0,203
1763705,1347637,2023-06-27,House,"House Floor: HB 1163 PN 1562, 2023 A1189",100,103,0,0,203
1763705,1347638,2023-06-27,House,"House Rules: Re-report Bill As Committed",18,14,1,0,33
1763705,1348005,2023-06-28,House,"House Appropriations: Re-report Bill As Committed",37,0,0,0,37
1763705,1348249,2023-06-28,House,"House Floor: HB 1163 PN 1756, FINAL PASSAGE",130,73,0,0,203
1763837,1330273,2023-05-23,House,"House Veterans Affairs And Emergency Preparedness: Re-report Resolution As Committed",21,0,0,0,21
1763837,1332405,2023-05-24,House,"House Floor: HR 107 PN 1211",201,0,0,0,201
1763914,1415308,2024-03-19,House,"House Environmental Resources And Energy: Adopt Amendment A03651",14,11,0,0,25
1763914,1415309,2024-03-19,House,"House Environmental Resources And Energy: Report Bill As Amended",14,11,0,0,25
1763914,1427871,2024-04-16,House,"House Floor: HB 1166 PN 2742, 2023 A4014",99,102,0,1,202
1763914,1427872,2024-04-16,House,"House Floor: HB 1166 PN 2742, 2023 A4029",102,99,0,1,202
1763914,1427873,2024-04-16,House,"House Floor: HB 1166 PN 2742, 2023 A4032",99,102,0,1,202
1763914,1435979,2024-04-29,House,"House Appropriations: Re-report Bill As Committed",22,15,0,0,37
1763914,1436684,2024-04-30,House,"House Floor: HB 1166 PN 2958, FINAL PASSAGE",102,98,0,2,202
1764106,1422773,2024-04-09,House,"House State Government: Adopt Amendment A03896",25,0,0,0,25
1764106,1422774,2024-04-09,House,"House State Government: Report Bill As Amended",14,11,0,0,25
1764106,1441104,2024-05-08,House,"House Floor: HB 1169 PN 2875, FINAL PASSAGE",102,98,0,2,202
1764106,1441106,2024-05-08,House,"House Appropriations: Re-report Bill As Committed",22,15,0,0,37
1764110,1460974,2024-06-26,House,"House Education: Report Bill As Committed",14,11,0,0,25
1764110,1461393,2024-06-28,House,"House Floor: HB 1168 PN 1233, 2023 A5303",100,102,0,1,203
1764110,1461394,2024-06-28,House,"House Rules: Re-report Bill As Committed",18,15,0,0,33
1764110,1461898,2024-07-01,House,"House Floor: HB 1168 PN 1233, FINAL PASSAGE",107,95,0,1,203
1764110,1461899,2024-07-01,House,"House Appropriations: Re-report Bill As Committed",22,15,0,0,37
1764116,1330341,2023-05-23,House,"House Tourism And Economic And Recreational Development: Report Bill As Committed",20,0,1,0,21
1764116,1332427,2023-05-24,House,"House Floor: HR 108 PN 1214",201,0,0,0,201
1764162,1330376,2023-05-23,House,"House Veterans Affairs And Emergency Preparedness: Report Resolution As Committed",21,0,0,0,21
1764162,1331874,2023-05-24,House,"House Floor: HR 109 PN 1212",201,0,0,0,201
1764205,1339477,2023-06-05,House,"House State Government: Report Bill As Amended",12,9,0,0,21
1764205,1339478,2023-06-05,House,"House State Government: Adopt Amendment A00704",12,9,0,0,21
1764241,1339536,2023-06-06,House,"House Agriculture And Rural Affairs: Report Bill As Committed",21,0,0,0,21
1764241,1344131,2023-06-14,House,"House Rules: Re-report Bill As Committed",33,0,0,0,33
1764241,1345695,2023-06-20,House,"House Floor: HB 1170 PN 1235, FINAL PASSAGE",203,0,0,0,203
1764241,1345696,2023-06-20,House,"House Appropriations: Re-report Bill As Committed",37,0,0,0,37
1764241,1356366,2023-10-23,Senate,"Senate Agriculture And Rural Affairs: Reported as Committed",11,0,0,0,11
1764241,1356443,2023-10-24,Senate,"Senate Appropriations: Re-Reported as Committed",24,0,0,0,24
1764241,1356523,2023-10-25,Senate,"Senate Floor: HB 1170 PN 1235, Final Passage",50,0,0,0,50
1764262,1343919,2023-06-14,House,"House Veterans Affairs And Emergency Preparedness: Report Bill As Committed",21,0,0,0,21
1764262,1346100,2023-06-21,House,"House Rules: Re-report Bill As Committed",33,0,0,0,33
1764262,1346485,2023-06-22,House,"House Floor: HB 1171 PN 1236, FINAL PASSAGE",203,0,0,0,203
1764262,1346486,2023-06-22,House,"House Appropriations: Re-report Bill As Committed",37,0,0,0,37
1764262,1348067,2023-06-28,Senate,"Senate Transportation: Reported as Committed",14,0,0,0,14
1764262,1354923,2023-09-19,Senate,"Senate Appropriations: Re-Reported as Committed",23,0,1,0,24
1764262,1355003,2023-09-20,Senate,"Senate Floor: HB 1171 PN 1236, Final Passage",47,0,0,3,50
1764333,1348101,2023-06-28,House,"House Tourism And Economic And Recreational Development: Adopt Amendment A01543",21,0,0,0,21
1764333,1348102,2023-06-28,House,"House Tourism And Economic And Recreational Development: Report Bill As Amended",21,0,0,0,21
1764333,1349678,2023-07-06,House,"House Rules: Re-report Bill As Committed",33,0,0,0,33
1764333,1349883,2023-07-07,House,"House Floor: HB 1173 PN 1767, FINAL PASSAGE",202,1,0,0,203
1764333,1349884,2023-07-07,House,"House Appropriations: Re-report Bill As Committed",22,15,0,0,37
1764363,1343368,2023-06-06,House,"House Environmental Resources And Energy: Re-refer Bill To Another Committee",21,0,0,0,21
1764363,1410038,2024-03-18,House,"House Commerce: Adopt Amendment A03158",25,0,0,0,25
1764363,1410039,2024-03-18,House,"House Commerce: Bring Up The Bill For Consideration",25,0,0,0,25
1764363,1410040,2024-03-18,House,"House Commerce: Report Bill As Amended",25,0,0,0,25
1764363,1436439,2024-04-30,House,"House Floor: HB 1172 PN 2730, 2023 A4071",98,102,0,2,202
1764363,1437339,2024-05-01,House,"House Floor: HB 1172 PN 2730, FINAL PASSAGE",138,63,0,1,202
1764363,1437340,2024-05-01,House,"House Appropriations: Re-report Bill As Committed",36,0,1,0,37
1764395,1436566,2024-04-30,House,"House Agriculture And Rural Affairs: Report Bill As Committed",25,0,0,0,25
1764423,1345323,2023-06-20,Senate,"Senate Health And Human Services: Reported as Amended",11,0,0,0,11
1764423,1345324,2023-06-20,Senate,"Senate Health And Human Services: Adopt Amendment A00732",11,0,0,0,11
1764423,1347755,2023-06-27,Senate,"Senate Appropriations: Re-Reported as Committed",24,0,0,0,24
1764423,1348061,2023-06-28,Senate,"Senate Floor: SB 683 PN 929, Final Passage",50,0,0,0,50
1764423,1362212,2023-12-11,House,"House Health: Report Bill As Committed",22,3,0,0,25
1764423,1362456,2023-12-12,House,"House Floor: SB 683 PN 929, 2023 A3182",202,1,0,0,203
1764423,1362457,2023-12-12,House,"House Floor: SB 683 PN 929, 2023 A3214",135,68,0,0,203
1764423,1362530,2023-12-13,House,"House Floor: SB 683 PN 1286, FINAL PASSAGE",166,37,0,0,203
1764423,1362531,2023-12-13,House,"House Appropriations: Re-report Bill As Committed",37,0,0,0,37
1764423,1362647,2023-12-13,Senate,"Senate Floor: SB 683 PN 1286, Concur in House Amendments",50,0,0,0,50
1764423,1362648,2023-12-13,Senate,"Senate Rules And Executive Nominations: Re-Reported as Committed",17,0,0,0,17
1764443,1456477,2024-06-11,Senate,"Senate Game And Fisheries: Reported as Committed",11,0,0,0,11
1764443,1462126,2024-07-01,Senate,"Senate Appropriations: Re-Reported as Committed",24,0,0,0,24
1764443,1462836,2024-07-09,Senate,"Senate Floor: SB 698 PN 1808, Final Passage",49,0,0,1,50
1764443,1467870,2024-10-01,House,"House Game And Fisheries: Report Bill As Committed",25,0,0,0,25
1764454,1357577,2023-11-14,Senate,"Senate State Government: Reported as Committed",11,0,0,0,11
1764454,1362274,2023-12-11,Senate,"Senate Floor: SB 686 PN 754, Final Passage",47,1,0,2,50
1764491,1456101,2024-06-11,House,"House Insurance: Adopt Amendment A04610",24,0,1,0,25
1764491,1456102,2024-06-11,House,"House Insurance: Report Bill As Amended",24,0,1,0,25
1764491,1458877,2024-06-24,House,"House Rules: Re-report Bill As Committed",33,0,0,0,33
1764491,1459786,2024-06-25,House,"House Floor: HB 1140 PN 3288, FINAL PASSAGE",133,69,0,1,203
1764491,1459787,2024-06-25,House,"House Appropriations: Re-report Bill As Committed",37,0,0,0,37
1764614,1446161,2024-05-21,House,"House Housing And Community Development: Report Bill As Amended",14,11,1,0,26
1764614,1446162,2024-05-21,House,"House Housing And Community Development: Adopt Amendment A04258",14,11,1,0,26
1765499,1339393,2023-06-06,Senate,"Senate Game And Fisheries: Reported as Amended A00818",11,0,0,0,11
1765499,1345430,2023-06-20,Senate,"Senate Floor: SB 709 PN 841, Final Passage",48,2,0,0,50
1765499,1357483,2023-11-14,House,"House Game And Fisheries: Report Bill As Committed",22,2,1,0,25
1765499,1426993,2024-04-15,House,"House Floor: SB 709 PN 841, FINAL PASSAGE",171,30,0,1,202
1765499,1426994,2024-04-15,House,"House Appropriations: Re-report Bill As Committed",37,0,0,0,37
1765616,1338578,2023-06-05,House,"House Aging And Older Adult Services: Report Bill As Committed",21,0,0,0,21
1765616,1343477,2023-06-13,House,"House Floor: HB 1184 PN 1246, FINAL PASSAGE",203,0,0,0,203
1765616,1343478,2023-06-13,House,"House Appropriations: Re-report Bill As Committed",37,0,0,0,37
1765668,1343903,2023-06-13,House,"House Housing And Community Development: Re-refer Bill To Another Committee",21,0,0,0,21
1765699,1362134,2023-12-08,House,"House Judiciary: Report Bill As Committed",25,0,0,0,25
1765699,1441194,2024-05-08,House,"House Floor: HR 113 PN 1262",108,92,0,2,202
1765828,1340764,2023-06-07,House,"House Judiciary: Adopt Amendment A00829",21,0,0,0,21
1765828,1340765,2023-06-07,House,"House Judiciary: Report Bill As Amended",12,9,0,0,21
1766112,1362143,2023-12-11,House,"House Transportation: Report Bill As Amended",15,10,0,0,25
1766112,1362144,2023-12-11,House,"House Transportation: Adopt Amendment A03153",24,1,0,0,25
1766124,1366193,2024-01-17,House,"House Judiciary: Report Bill As Committed",14,11,0,0,25
1766178,1357685,2023-11-15,House,"House Commerce: Adopt Amendment A02979",25,0,0,0,25
1766178,1357686,2023-11-15,House,"House Commerce: Bring Up The Bill For Consideration",25,0,0,0,25
1766178,1357687,2023-11-15,House,"House Commerce: Report Bill As Amended A02979",25,0,0,0,25
1766178,1362514,2023-12-13,House,"House Floor: HB 1201 PN 2315, 2023 A3094",201,2,0,0,203
1766178,1410142,2024-03-18,House,"House Floor: HB 1201 PN 2442, FINAL PASSAGE",139,62,0,1,202
1766178,1410143,2024-03-18,House,"House Appropriations: Re-report Bill As Committed",37,0,0,0,37
1766178,1460179,2024-06-26,Senate,"Senate Communications And Technology: Reported as Amended",11,0,0,0,11
1766178,1460180,2024-06-26,Senate,"Senate Communications And Technology: Adopt Amendment A05190",11,0,0,0,11
1766285,1339037,2023-06-05,House,"House State Government: Report Bill As Committed",12,9,0,0,21
1766285,1347596,2023-06-27,House,"House Floor: HR 114 PN 1263",123,79,0,1,203
1766353,1348140,2023-06-28,House,"House State Government: Re-refer Bill To Another Committee",12,9,0,0,21
1766353,1378326,2024-02-06,House,"House Tourism And Economic And Recreational Development: Report Bill As Committed",25,0,0,0,25
1766353,1415062,2024-03-25,House,"House Floor: HB 1030 PN 1265, 2023 A3737, MOTION TO SUSPEND RULES",96,105,0,1,202
1766353,1415194,2024-03-26,House,"House Appropriations: Re-report Bill As Committed",36,1,0,0,37
1766353,1415914,2024-03-26,House,"House Floor: HB 1030 PN 1265, FINAL PASSAGE",130,71,0,1,202
1766469,1340683,2023-06-07,House,"House Children And Youth: Bring Up The Bill For Consideration",20,0,1,0,21
1766469,1340684,2023-06-07,House,"House Children And Youth: Report Bill As Committed",19,1,1,0,21
1766469,1346066,2023-06-21,House,"House Rules: Re-report Bill As Committed",33,0,0,0,33
1766469,1347410,2023-06-26,House,"House Appropriations: Re-report Bill As Committed",37,0,0,0,37
1766469,1347553,2023-06-26,House,"House Floor: HB 1020 PN 1264, FINAL PASSAGE",151,52,0,0,203
1766484,1332080,2023-05-24,House,"House Housing And Community Development: Bring Up The Bill For Consideration",21,0,0,0,21
1766484,1343953,2023-06-14,House,"House Appropriations: Re-report Bill As Committed",37,0,0,0,37
1766484,1345423,2023-06-20,House,"House Floor: HB 1207 PN 1277, FINAL PASSAGE",147,56,0,0,203
1766484,1424038,2024-04-10,Senate,"Senate Urban Affairs And Housing: Reported as Committed",10,1,0,0,11
1766498,1343946,2023-06-14,House,"House Health: Report Bill As Committed",21,0,0,0,21
1766498,1346013,2023-06-21,House,"House Rules: Re-report Bill As Committed",33,0,0,0,33
1766498,1346785,2023-06-22,House,"House Floor: HB 1209 PN 1279, FINAL PASSAGE",203,0,0,0,203
1766498,1346786,2023-06-22,House,"House Appropriations: Re-report Bill As Committed",37,0,0,0,37
1766498,1352415,2023-08-30,Senate,"Senate Appropriations: Reported as Committed",23,0,1,0,24
1766498,1354969,2023-09-19,Senate,"Senate Floor: HB 1209 PN 1279, Final Passage",46,0,0,4,50
1766570,1329679,2023-05-22,House,"House Health: Report Bill As Committed",21,0,0,0,21
1766570,1332872,2023-05-24,House,"House Floor: HR 115 PN 1280",201,0,0,0,201
1767024,1340724,2023-06-07,House,"House Judiciary: Report Bill As Committed",12,9,0,0,21
1767024,1345254,2023-06-20,House,"House Floor: HR 117 PN 1286",103,100,0,0,203
1767055,1343965,2023-06-14,House,"House Judiciary: Report Bill As Committed",21,0,0,0,21
1767055,1348605,2023-06-29,House,"House Rules: Re-report Bill As Committed",33,0,0,0,33
1767055,1349720,2023-07-06,House,"House Floor: HB 1210 PN 1283, FINAL PASSAGE",130,73,0,0,203
1767055,1349721,2023-07-06,House,"House Appropriations: Re-report Bill As Committed",37,0,0,0,37
1767055,1468725,2024-10-21,Senate,"Senate Judiciary: Reported as Committed",14,0,0,0,14
1767072,1329667,2023-05-22,House,"House Health: Report Bill As Committed",21,0,0,0,21
1767099,1344601,2023-06-14,House,"House Local Government: Report Bill As Amended",12,9,0,0,21
1767099,1344602,2023-06-14,House,"House Local Government: Adopt Amendment A00916",21,0,0,0,21
1767099,1344603,2023-06-14,House,"House Local Government: Adopt Amendment A01015",21,0,0,0,21
1767099,1348243,2023-06-28,House,"House Rules: Re-report Bill As Committed",18,15,0,0,33
1767099,1348790,2023-06-29,House,"House Floor: HB 1216 PN 1595, FINAL PASSAGE",102,101,0,0,203
1767099,1348791,2023-06-29,House,"House Appropriations: Re-report Bill As Committed",22,15,0,0,37
1767202,1362426,2023-12-12,Senate,"Senate Community, Economic And Recreational Development: Reported as Amended",13,1,0,0,14
1767202,1362427,2023-12-12,Senate,"Senate Community, Economic And Recreational Development: Adopt Amendment A03254",14,0,0,0,14
1767202,1421767,2024-04-08,Senate,"Senate Appropriations: Re-Reported as Committed",23,1,0,0,24
1767202,1467315,2024-09-16,Senate,"Senate Floor: SB 667 PN 1279, Final Passage",47,1,0,2,50
1767202,1468004,2024-10-01,House,"House Commerce: Report Bill As Committed",25,0,0,0,25
1767253,1348036,2023-06-28,Senate,"Senate Environmental Resources And Energy: Reported as Amended",7,4,0,0,11
1767253,1348037,2023-06-28,Senate,"Senate Environmental Resources And Energy: Adopt Amendment A01481",9,2,0,0,11
1767253,1349028,2023-06-30,Senate,"Senate Floor: SR 116 PN 986",28,22,0,0,50
1767263,1342593,2023-06-06,House,"House Education: Report Bill As Committed",12,9,0,0,21
1767263,1346438,2023-06-22,House,"House Floor: HR 121 PN 1338",106,97,0,0,203
1767298,1410858,2024-03-19,House,"House State Government: Report Bill As Committed",25,0,0,0,25
1767298,1427059,2024-04-15,House,"House Floor: HB 1220 PN 1311, 2023 A3959",98,103,0,1,202
1767298,1427060,2024-04-15,House,"House Floor: HB 1220 PN 1311, 2023 A3961",201,0,0,1,202
1767298,1427746,2024-04-16,House,"House Floor: HB 1220 PN 2940, FINAL PASSAGE",190,11,0,1,202
1767298,1427747,2024-04-16,House,"House Appropriations: Re-report Bill As Committed",37,0,0,0,37
1767311,1348131,2023-06-28,House,"House Human Services: Report Bill As Amended",12,9,0,0,21
1767311,1348132,2023-06-28,House,"House Human Services: Report Bill As Amended",12,9,0,0,21
1767311,1349675,2023-07-06,House,"House Rules: Re-report Bill As Committed",18,15,0,0,33
1767311,1349725,2023-07-06,House,"House Floor: HB 1218 PN 1766, 2023 A1596",101,102,0,0,203
1767311,1349873,2023-07-07,House,"House Floor: HB 1218 PN 1766, FINAL PASSAGE",109,94,0,0,203
1767311,1349874,2023-07-07,House,"House Appropriations: Re-report Bill As Committed",22,15,0,0,37
1767314,1343798,2023-06-06,House,"House Environmental Resources And Energy: Report Bill As Committed",12,9,0,0,21
1767314,1343799,2023-06-13,House,"House Floor: HR 119 PN 1337",102,101,0,0,203
1767337,1347376,2023-06-22,House,"House Finance: Adopt Amendment A01277",21,0,0,0,21
1767337,1347377,2023-06-22,House,"House Finance: Re-report Bill As Amended",21,0,0,0,21
1767337,1347378,2023-06-26,House,"House Finance: Re-report Bill As Amended",21,0,0,0,21
1767337,1347379,2023-06-26,House,"House Finance: Re-report Bill As Amended",21,0,0,0,21
1767337,1355458,2023-10-02,House,"House Rules: Re-report Bill As Committed",33,0,0,0,33
1767337,1355460,2023-10-02,House,"House Floor: HB 1219 PN 1694, 2023 A2152",150,53,0,0,203
1767337,1355461,2023-10-02,House,"House Floor: HB 1219 PN 1694, 2023 A2153",166,37,0,0,203
1767337,1355572,2023-10-03,House,"House Floor: HB 1219 PN 2089, FINAL PASSAGE",102,101,0,0,203
1767337,1355777,2023-10-03,House,"House Appropriations: Re-report Bill As Amended",22,15,0,0,37
1767337,1355817,2023-10-03,House,"House Appropriations: Adopt Amendment A02359",22,15,0,0,37
1767341,1357739,2023-11-15,House,"House Veterans Affairs And Emergency Preparedness: Report Bill As Committed",25,0,0,0,25
1767489,1339076,2023-06-06,House,"House Health: Report Bill As Committed",21,0,0,0,21
1767489,1348709,2023-06-29,House,"House Floor: HR 124 PN 1341",201,1,0,1,203
1767498,1344642,2023-06-14,House,"House Local Government: Report Bill As Committed",21,0,0,0,21
1767500,1344568,2023-06-14,House,"House Local Government: Report Bill As Committed",21,0,0,0,21
1767500,1347991,2023-06-28,House,"House Rules: Re-report Bill As Committed",33,0,0,0,33
1767500,1348606,2023-06-29,House,"House Appropriations: Re-report Bill As Committed",37,0,0,0,37
1767500,1348789,2023-06-29,House,"House Floor: HB 1234 PN 1325, FINAL PASSAGE",203,0,0,0,203
1767500,1362349,2023-12-12,Senate,"Senate Local Government: Reported as Committed",11,0,0,0,11
1767500,1410273,2024-03-18,Senate,"Senate Appropriations: Re-Reported as Committed",23,0,1,0,24
1767500,1411790,2024-03-20,Senate,"Senate Floor: HB 1234 PN 1325, Final Passage",49,0,0,1,50
1767507,1344585,2023-06-14,House,"House Local Government: Report Bill As Committed",21,0,0,0,21
1767507,1347588,2023-06-27,House,"House Rules: Re-report Bill As Committed",32,0,1,0,33
1767507,1347847,2023-06-27,House,"House Floor: HB 1231 PN 1322, 2023 A1443",101,102,0,0,203
1767507,1348247,2023-06-28,House,"House Floor: HB 1231 PN 1322, FINAL PASSAGE",128,75,0,0,203
1767507,1348248,2023-06-28,House,"House Appropriations: Re-report Bill As Committed",37,0,0,0,37
1767507,1362328,2023-12-12,Senate,"Senate Local Government: Reported as Committed",11,0,0,0,11
1767507,1468828,2024-10-22,Senate,"Senate Appropriations: Re-Reported as Committed",24,0,0,0,24
1767521,1339753,2023-06-06,House,"House Health: Report Bill As Committed",21,0,0,0,21
1767521,1343802,2023-06-13,House,"House Floor: HR 123 PN 1340",202,1,0,0,203
1767535,1344592,2023-06-14,House,"House Local Government: Report Bill As Committed",21,0,0,0,21
1767535,1355467,2023-10-02,House,"House Floor: HB 1232 PN 1323, FINAL PASSAGE",188,15,0,0,203
1767535,1355468,2023-10-02,House,"House Appropriations: Re-report Bill As Committed",37,0,0,0,37
1767535,1362408,2023-12-12,Senate,"Senate Local Government: Reported as Committed",11,0,0,0,11
1767602,1355998,2023-10-16,House,"House Transportation: Report Bill As Amended",25,0,0,0,25
1767602,1355999,2023-10-16,House,"House Transportation: Adopt Amendment A02512",25,0,0,0,25
1767602,1356738,2023-10-31,House,"House Appropriations: Re-report Bill As Committed",37,0,0,0,37
1767602,1357460,2023-11-13,House,"House Floor: HB 1243 PN 2127, FINAL PASSAGE",203,0,0,0,203
1767602,1362458,2023-12-12,Senate,"Senate Transportation: Reported as Committed",14,0,0,0,14
1767642,1355710,2023-10-04,House,"House Finance: Report Bill As Committed",25,0,0,0,25
1767815,1340482,2023-06-07,House,"House Children And Youth: Report Bill As Committed",21,0,0,0,21
1767815,1349853,2023-07-07,House,"House Floor: HR 126 PN 1353",202,1,0,0,203
1767821,1339714,2023-06-06,House,"House Finance: Re-report Bill As Committed",12,9,0,0,21
1767821,1343940,2023-06-14,House,"House Floor: HB 1249 PN 1348, 2023 A847",99,104,0,0,203
1767821,1343941,2023-06-14,House,"House Floor: HB 1249 PN 1348, 2023 A814, MOTION TO APPEAL RULING OF THE CHAIR",102,101,0,0,203
1767821,1343942,2023-06-14,House,"House Floor: HB 1249 PN 1348, 2023 A976",101,102,0,0,203
1767821,1343943,2023-06-14,House,"House Rules: Re-report Bill As Committed",18,15,0,0,33
1767821,1344122,2023-06-14,House,"House Floor: HB 1249 PN 1348, MOTION TO TABLE AMENDMENTS",102,101,0,0,203
1767821,1345261,2023-06-20,House,"House Appropriations: Re-report Bill As Committed",22,15,0,0,37
1767821,1345490,2023-06-20,House,"House Floor: HB 1249 PN 1348, FINAL PASSAGE",137,66,0,0,203
1767831,1384506,2024-02-14,House,"House Judiciary: Report Bill As Committed",15,10,0,0,25
1767874,1347174,2023-06-22,House,"House Liquor Control: Adopt Amendment A01292",21,0,0,0,21
1767874,1347175,2023-06-22,House,"House Liquor Control: Report Bill As Amended",15,6,0,0,21
1767874,1348222,2023-06-28,House,"House Rules: Re-report Bill As Committed",18,15,0,0,33
1767883,1340602,2023-06-07,House,"House Professional Licensure: Report Bill As Committed",21,0,0,0,21
1767883,1343973,2023-06-14,House,"House Rules: Re-report Bill As Committed",33,0,0,0,33
1767883,1345386,2023-06-20,House,"House Floor: HB 1246 PN 1415, FINAL PASSAGE",203,0,0,0,203
1767883,1345387,2023-06-20,House,"House Appropriations: Re-report Bill As Committed",37,0,0,0,37
1767883,1356424,2023-10-24,Senate,"Senate Environmental Resources And Energy: Reported as Committed",11,0,0,0,11
1767883,1375743,2024-02-05,Senate,"Senate Appropriations: Re-Reported as Committed",23,0,1,0,24
1767883,1453925,2024-06-05,Senate,"Senate Floor: HB 1246 PN 1415, Final Passage",50,0,0,0,50
1767888,1340793,2023-06-07,House,"House Judiciary: Report Bill As Committed",12,9,0,0,21
1767896,1355244,2023-09-26,House,"House Veterans Affairs And Emergency Preparedness: Adopt Amendment A02080",25,0,0,0,25
1767896,1355245,2023-09-26,House,"House Veterans Affairs And Emergency Preparedness: Report Bill As Amended",25,0,0,0,25
1767896,1356824,2023-10-31,House,"House Floor: HR 125 PN 2038",201,1,0,1,203
1767971,1348098,2023-06-28,House,"House Education: Adopt Amendment A01538",21,0,0,0,21
1767971,1348099,2023-06-28,House,"House Education: Report Bill As Amended",21,0,0,0,21
1767971,1355563,2023-10-03,House,"House Rules: Re-report Bill As Committed",33,0,0,0,33
1767971,1355719,2023-10-04,House,"House Appropriations: Re-report Bill As Committed",37,0,0,0,37
1767971,1355781,2023-10-04,House,"House Floor: HB 1258 PN 1768, FINAL PASSAGE",202,1,0,0,203
1767971,1356410,2023-10-24,Senate,"Senate Education: Reported as Committed",10,0,1,0,11
1767971,1362375,2023-12-12,Senate,"Senate Appropriations: Re-Reported as Committed",24,0,0,0,24
1767971,1362571,2023-12-13,House,"House Floor: HB 1258 PN 2434, CONCURRENCE",203,0,0,0,203
1767971,1362572,2023-12-13,House,"House Rules: Re-report Bill As Committed",33,0,0,0,33
1767971,1362661,2023-12-13,Senate,"Senate Floor: HB 1258 PN 2434, Final Passage",50,0,0,0,50
1767995,1339388,2023-06-06,House,"House Finance: Re-report Bill As Committed",12,9,0,0,21
1767995,1340719,2023-06-07,House,"House Floor: HB 1259 PN 1369, 2023 A788",112,91,0,0,203
1767995,1340720,2023-06-07,House,"House Floor: HB 1259 PN 1369, 2023 A858",184,19,0,0,203
1767995,1340721,2023-06-07,House,"House Floor: HB 1259 PN 1369, 2023 A859",118,85,0,0,203
1767995,1340722,2023-06-07,House,"House Rules: Re-report Bill As Committed",18,15,0,0,33
1767995,1342748,2023-06-12,House,"House Floor: HB 1259 PN 1480, FINAL PASSAGE",141,62,0,0,203
1767995,1342749,2023-06-12,House,"House Appropriations: Re-report Bill As Committed",22,15,0,0,37
1768384,1339363,2023-06-06,House,"House Finance: Re-report Bill As Committed",21,0,0,0,21
1768384,1340571,2023-06-07,House,"House Rules: Re-report Bill As Committed",33,0,0,0,33
1768384,1342822,2023-06-12,House,"House Floor: HB 1267 PN 1376, FINAL PASSAGE",203,0,0,0,203
1768384,1342823,2023-06-12,House,"House Appropriations: Re-report Bill As Committed",37,0,0,0,37
1768415,1340615,2023-06-07,House,"House Judiciary: Adopt Amendment A00836",21,0,0,0,21
1768415,1340616,2023-06-07,House,"House Judiciary: Report Bill As Amended",12,9,0,0,21
1768516,1355702,2023-10-03,House,"House State Government: Report Bill As Committed",24,1,0,0,25
1768516,1355767,2023-10-04,House,"House Floor: HR 130 PN 1380",202,1,0,0,203
1768569,1452848,2024-06-03,House,"House State Government: Re-report Bill As Committed",25,0,0,0,25
1768592,1338241,2023-06-05,House,"House Aging And Older Adult Services: Adopt Amendment A00729",21,0,0,0,21
1768592,1338242,2023-06-05,House,"House Aging And Older Adult Services: Report Bill As Amended",21,0,0,0,21
1768592,1345846,2023-06-21,House,"House Floor: HB 1300 PN 1446, FINAL PASSAGE",191,12,0,0,203
1768592,1345847,2023-06-21,House,"House Appropriations: Re-report Bill As Committed",37,0,0,0,37
1768592,1347682,2023-06-27,Senate,"Senate Aging And Youth: Reported as Committed",11,0,0,0,11
1768592,1352429,2023-08-30,Senate,"Senate Floor: HB 1300 PN 1943, Motion to Suspend Rule 12",39,8,0,3,50
1768592,1352430,2023-08-30,Senate,"Senate Floor: HB 1300 PN 1943, Final Passage",29,18,0,3,50
1768592,1352431,2023-08-30,Senate,"Senate Appropriations: Motion to Table",8,15,1,0,24
1768592,1352432,2023-08-30,Senate,"Senate Appropriations: Re-Reported as Amended",15,8,1,0,24
1768592,1352433,2023-08-30,Senate,"Senate Appropriations: Adopt Amendment A01922",15,8,1,0,24
1768592,1352434,2023-08-30,Senate,"Senate Appropriations: Motion to Table Amendment A01916 to House Bill 1300 A01916",15,8,1,0,24
1768592,1352435,2023-08-30,Senate,"Senate Appropriations: Motion to Table Amendment A01918 to House Bill 1300 A01918",15,8,1,0,24
1768592,1352436,2023-08-30,Senate,"Senate Appropriations: Motion to Table Amendment A01924 to House Bill 1300 A01924",15,8,1,0,24
1768592,1352437,2023-08-30,Senate,"Senate Appropriations: Motion to Table Amendment A01925 to House Bill 1300 A01925",15,8,1,0,24
1768592,1355730,2023-10-04,House,"House Rules: Adopt Amendment A02346",15,18,0,0,33
1768592,1355731,2023-10-04,House,"House Rules: Adopt Amendment A02297",20,13,0,0,33
1768592,1355732,2023-10-04,House,"House Rules: Adopt Amendment A02272",15,18,0,0,33
1768592,1355733,2023-10-04,House,"House Rules: Adopt Amendment A02383",18,15,0,0,33
1768592,1355734,2023-10-04,House,"House Rules: Adopt Amendment A02050",15,18,0,0,33
1768592,1355735,2023-10-04,House,"House Rules: Re-report Bill As Amended",18,15,0,0,33
1768592,1355789,2023-10-04,House,"House Floor: HB 1300 PN 2107, 2023 A2431, MOTION TO SUSPEND RULES",101,102,0,0,203
1768592,1355790,2023-10-04,House,"House Floor: HB 1300 PN 2107, 2023 A2435, MOTION TO SUSPEND RULES",101,102,0,0,203
1768592,1355791,2023-10-04,House,"House Floor: HB 1300 PN 2107, 2023 A2437, MOTION TO SUSPEND RULES",101,102,0,0,203
1768592,1355792,2023-10-04,House,"House Floor: HB 1300 PN 2107, 2023 A2448, MOTION TO SUSPEND RULES",101,102,0,0,203
1768592,1355793,2023-10-04,House,"House Floor: HB 1300 PN 2107, 2023 A2449, MOTION TO SUSPEND RULES",101,102,0,0,203
1768592,1355794,2023-10-04,House,"House Floor: HB 1300 PN 2107, CONCURRENCE",121,82,0,0,203
1768592,1362507,2023-12-13,Senate,"Senate Rules And Executive Nominations: Re-Reported as Amended",17,0,0,0,17
1768592,1362508,2023-12-13,Senate,"Senate Rules And Executive Nominations: Adopt Amendment A03358",17,0,0,0,17
1768592,1362509,2023-12-13,Senate,"Senate Rules And Executive Nominations: Motion to Table Amendment A03350",11,6,0,0,17
1768592,1362631,2023-12-13,House,"House Floor: HB 1300 PN 2441, CONCURRENCE",154,49,0,0,203
1768592,1362632,2023-12-13,Senate,"Senate Floor: HB 1300 PN 2441, Concur in House Amendments to Senate Amendments as Amended",45,5,0,0,50
1768592,1362633,2023-12-13,House,"House Rules: Re-report Bill As Committed",33,0,0,0,33
1768847,1345661,2023-06-20,Senate,"Senate Health And Human Services: Reported as Amended",11,0,0,0,11
1768847,1345662,2023-06-20,Senate,"Senate Health And Human Services: Adopt Amendment A01119",11,0,0,0,11
1768847,1354879,2023-09-18,Senate,"Senate Floor: SB 712 PN 930, Final Passage",45,0,0,5,50
1768847,1354880,2023-09-18,Senate,"Senate Appropriations: Re-Reported as Committed",22,0,2,0,24
1768863,1343419,2023-06-06,House,"House Environmental Resources And Energy: Report Bill As Committed",12,9,0,0,21
1768863,1348636,2023-06-29,House,"House Floor: HR 131 PN 1402, 2023 A1563",203,0,0,0,203
1768863,1348904,2023-06-29,House,"House Floor: HR 131 PN 1791",102,101,0,0,203
1769215,1348033,2023-06-28,House,"House Judiciary: Adopt Amendment A01513",12,9,0,0,21
1769215,1348034,2023-06-28,House,"House Judiciary: Report Bill As Amended",12,9,0,0,21
1769215,1355196,2023-09-26,House,"House Floor: HB 1278 PN 1764, 2023 A2085",102,100,0,0,202
1769215,1355197,2023-09-26,House,"House Floor: HB 1278 PN 1764, 2023 A1835",201,1,0,0,202
1769215,1355277,2023-09-27,House,"House Appropriations: Re-report Bill As Committed",37,0,0,0,37
1769215,1356079,2023-10-16,House,"House Floor: HB 1278 PN 2037, FINAL PASSAGE",110,93,0,0,203
1769215,1357597,2023-11-14,Senate,"Senate Judiciary: Reported as Amended",9,5,0,0,14
1769215,1357598,2023-11-14,Senate,"Senate Judiciary: Adopt Amendment A02671",9,5,0,0,14
1769215,1362150,2023-12-11,Senate,"Senate Appropriations: Re-Reported as Committed",20,4,0,0,24
1769215,1362273,2023-12-11,Senate,"Senate Floor: HB 1278 PN 2303, Final Passage",40,8,0,2,50
1769215,1362336,2023-12-12,House,"House Rules: Re-report Bill As Committed",18,15,0,0,33
1769215,1362462,2023-12-12,House,"House Floor: HB 1278 PN 2303, CONCURRENCE",181,22,0,0,203
1769223,1339471,2023-06-06,House,"House Finance: Report Bill As Committed",12,9,0,0,21
1769223,1340582,2023-06-07,House,"House Rules: Re-report Bill As Committed",18,15,0,0,33
1769223,1342937,2023-06-12,House,"House Floor: HB 1272 PN 1389, FINAL PASSAGE",122,81,0,0,203
1769223,1342938,2023-06-12,House,"House Appropriations: Re-report Bill As Committed",22,15,0,0,37
1769280,1345547,2023-06-20,House,"House Agriculture And Rural Affairs: Report Bill As Committed",20,0,1,0,21
1769280,1346425,2023-06-22,House,"House Floor: HR 132 PN 1403",202,1,0,0,203
1769355,1343974,2023-06-14,House,"House Judiciary: Report Bill As Committed",21,0,0,0,21
1769355,1346123,2023-06-21,House,"House Rules: Re-report Bill As Committed",33,0,0,0,33
1769355,1347392,2023-06-26,House,"House Appropriations: Re-report Bill As Committed",37,0,0,0,37
1769355,1347477,2023-06-26,House,"House Floor: HB 1280 PN 1396, FINAL PASSAGE",203,0,0,0,203
1769355,1362221,2023-12-11,Senate,"Senate Law And Justice: Reported as Committed",11,0,0,0,11
1769402,1343370,2023-06-06,House,"House Environmental Resources And Energy: Report Bill As Committed",12,9,0,0,21
1769414,1338240,2023-06-05,House,"House Transportation: Report Bill As Committed",21,0,0,0,21
1769414,1344018,2023-06-14,House,"House Appropriations: Re-report Bill As Committed",37,0,0,0,37
1769414,1345348,2023-06-20,House,"House Floor: HB 1283 PN 1399, FINAL PASSAGE",198,5,0,0,203
1769414,1468486,2024-10-09,Senate,"Senate Transportation: Reported as Committed",14,0,0,0,14
1769428,1342496,2023-06-12,House,"House Transportation: Report Bill As Amended",21,0,0,0,21
1769428,1342497,2023-06-12,House,"House Transportation: Adopt Amendment A00917",21,0,0,0,21
1769428,1345957,2023-06-21,House,"House Rules: Re-report Bill As Committed",33,0,0,0,33
1769428,1346412,2023-06-22,House,"House Floor: HB 1284 PN 1531, 2023 A1193",203,0,0,0,203
1769428,1346413,2023-06-22,House,"House Floor: HB 1284 PN 1531, 2023 A1195",203,0,0,0,203
1769428,1347411,2023-06-26,House,"House Appropriations: Re-report Bill As Committed",37,0,0,0,37
1769428,1347552,2023-06-26,House,"House Floor: HB 1284 PN 1678, FINAL PASSAGE",141,62,0,0,203
1769428,1356400,2023-10-24,Senate,"Senate Transportation: Reported as Amended",13,1,0,0,14
1769428,1356401,2023-10-24,Senate,"Senate Transportation: Adopt Amendment A02636",8,6,0,0,14
1769428,1362393,2023-12-12,Senate,"Senate Transportation: Adopt Amendment A03319",14,0,0,0,14
1769428,1362394,2023-12-12,Senate,"Senate Transportation: Re-Reported as Amended",14,0,0,0,14
1769428,1362605,2023-12-13,House,"House Floor: HB 1284 PN 2431, CONCURRENCE",121,82,0,0,203
1769428,1362606,2023-12-13,Senate,"Senate Floor: HB 1284 PN 2431, Final Passage",47,3,0,0,50
1769428,1362607,2023-12-13,Senate,"Senate Appropriations: Re-Reported as Committed",24,0,0,0,24
1769428,1362608,2023-12-13,House,"House Rules: Re-report Bill As Committed",33,0,0,0,33
1769472,1347686,2023-06-27,Senate,"Senate Transportation: Reported as Amended",14,0,0,0,14
1769472,1347687,2023-06-27,Senate,"Senate Transportation: Adopt Amendment A01458",14,0,0,0,14
1769488,1345814,2023-06-21,House,"House Judiciary: Adopt Amendment A01117",21,0,0,0,21
1769488,1345815,2023-06-21,House,"House Judiciary: Report Bill As Amended",12,9,0,0,21
1769488,1347591,2023-06-27,House,"House Rules: Re-report Bill As Committed",32,0,1,0,33
1769488,1347770,2023-06-27,House,"House Floor: HB 1289 PN 1651, 2023 A1355",199,4,0,0,203
1769488,1348083,2023-06-28,House,"House Appropriations: Re-report Bill As Committed",37,0,0,0,37
1769488,1348245,2023-06-28,House,"House Floor: HB 1289 PN 1757, FINAL PASSAGE",200,3,0,0,203
1769488,1362285,2023-12-11,Senate,"Senate Judiciary: Reported as Committed",13,0,1,0,14
1769488,1362601,2023-12-13,Senate,"Senate Floor: HB 1289 PN 1757, Final Passage",50,0,0,0,50
1769492,1339046,2023-06-06,Senate,"Senate Agriculture And Rural Affairs: Reported as Amended A00817",11,0,0,0,11
1769492,1345170,2023-06-19,Senate,"Senate Floor: SB 746 PN 835, 2023 A1140, VOGEL Amendment No. A-1140",47,3,0,0,50
1769492,1345171,2023-06-19,Senate,"Senate Appropriations: Re-Reported as Committed",24,0,0,0,24
1769492,1345454,2023-06-20,Senate,"Senate Floor: SB 746 PN 915, Final Passage",43,7,0,0,50
1769492,1346067,2023-06-21,House,"House Agriculture And Rural Affairs: Report Bill As Committed",17,3,1,0,21
1769492,1347742,2023-06-27,House,"House Floor: SB 746 PN 915, 2023 A1309",81,122,0,0,203
1769492,1347743,2023-06-27,House,"House Floor: SB 746 PN 915, 2023 A1442",99,104,0,0,203
1769492,1347744,2023-06-27,House,"House Floor: SB 746 PN 915, 2023 A1444",99,104,0,0,203
1769492,1347745,2023-06-27,House,"House Floor: SB 746 PN 915, 2023 A1459",99,104,0,0,203
1769492,1356239,2023-10-18,House,"House Floor: SB 746 PN 915, FINAL PASSAGE",143,60,0,0,203
1769492,1356240,2023-10-18,House,"House Appropriations: Re-report Bill As Committed",37,0,0,0,37
1769602,1461913,2024-07-01,House,"House Education: Report Bill As Committed",25,0,0,0,25
1769602,1462899,2024-07-10,House,"House Floor: HB 1293 PN 1410, 2023 A5477, MOTION TO APPEAL RULING OF THE CHAIR",102,100,0,1,203
1769602,1462900,2024-07-10,House,"House Floor: HB 1293 PN 1410, 2023 A5426",202,0,0,1,203
1769602,1462901,2024-07-10,House,"House Rules: Re-report Bill As Committed",33,0,0,0,33
1769602,1462969,2024-07-11,House,"House Floor: HB 1293 PN 3502, FINAL PASSAGE",196,6,0,1,203
1769602,1462970,2024-07-11,House,"House Appropriations: Re-report Bill As Committed",37,0,0,0,37
1769613,1348628,2023-06-29,House,"House Transportation: Report Bill As Amended",21,0,0,0,21
1769613,1348787,2023-06-29,House,"House Transportation: Adopt Amendment A01562",21,0,0,0,21
1769613,1355214,2023-09-26,House,"House Floor: HB 1291 PN 1788, 2023 A2088, MOTION TO SUSPEND RULES",101,101,0,0,202
1769613,1355215,2023-09-26,House,"House Floor: HB 1291 PN 1788, 2023 A2119, MOTION TO SUSPEND RULES",101,101,0,0,202
1769613,1355279,2023-09-27,House,"House Floor: HB 1291 PN 1788, FINAL PASSAGE",161,41,0,0,202
1769613,1355280,2023-09-27,House,"House Appropriations: Re-report Bill As Committed",37,0,0,0,37
1769646,1340692,2023-06-07,Senate,"Senate Finance: Reported as Committed",8,3,0,0,11
1769646,1452588,2024-06-03,Senate,"Senate Appropriations: Adopt Amendment A04598",24,0,0,0,24
1769646,1452589,2024-06-03,Senate,"Senate Appropriations: Re-Reported as Amended",20,4,0,0,24
1769646,1453262,2024-06-04,Senate,"Senate Floor: SB 742 PN 1671, Final Passage",37,13,0,0,50
1769698,1347661,2023-06-27,House,"House Judiciary: Adopt Amendment A12345",21,0,0,0,21
1769698,1347662,2023-06-27,House,"House Judiciary: Report Bill As Amended",21,0,0,0,21
1769698,1348035,2023-06-28,House,"House Rules: Re-report Bill As Committed",33,0,0,0,33
1769701,1339043,2023-06-06,Senate,"Senate Local Government: Reported as Committed",11,0,0,0,11
1769701,1354887,2023-09-18,Senate,"Senate Appropriations: Re-Reported as Committed",22,0,2,0,24
1769701,1355486,2023-10-02,Senate,"Senate Floor: SB 754 PN 799, Final Passage",49,0,0,1,50
1769706,1355268,2023-09-27,House,"House Health: Report Bill As Committed",25,0,0,0,25
1769713,1340873,2023-06-07,House,"House Professional Licensure: Adopt Amendment A00839",21,0,0,0,21
1769713,1340874,2023-06-07,House,"House Professional Licensure: Report Bill As Amended",21,0,0,0,21
1769713,1344089,2023-06-14,House,"House Floor: HB 1295 PN 1469, 2023 A892",203,0,0,0,203
1769713,1344090,2023-06-14,House,"House Rules: Re-report Bill As Committed",33,0,0,0,33
1769713,1345327,2023-06-20,House,"House Floor: HB 1295 PN 1597, FINAL PASSAGE",177,26,0,0,203
1769713,1345328,2023-06-20,House,"House Appropriations: Re-report Bill As Committed",37,0,0,0,37
1769713,1362495,2023-12-13,Senate,"Senate Consumer Protection And Professional Licensure: Reported as Committed",14,0,0,0,14
1769713,1410262,2024-03-18,Senate,"Senate Appropriations: Re-Reported as Committed",23,0,1,0,24
1769713,1421955,2024-04-08,Senate,"Senate Floor: HB 1295 PN 1597, Final Passage",48,0,0,2,50
1769716,1356312,2023-10-18,House,"House Local Government: Report Bill As Committed",25,0,0,0,25
1769729,1340650,2023-06-07,Senate,"Senate Labor And Industry: Reported as Committed",11,0,0,0,11
1769729,1347431,2023-06-26,Senate,"Senate Appropriations: Re-Reported as Committed",24,0,0,0,24
1769729,1348232,2023-06-28,Senate,"Senate Floor: SB 756 PN 797, Final Passage",49,1,0,0,50
1769733,1355242,2023-09-26,House,"House Veterans Affairs And Emergency Preparedness: Report Bill As Committed",25,0,0,0,25
1769733,1357715,2023-11-15,House,"House Floor: HR 138 PN 1424",202,1,0,0,203
1769737,1355203,2023-09-26,House,"House Human Services: Report Bill As Committed",25,0,0,0,25
1769741,1343641,2023-06-13,House,"House Housing And Community Development: Report Bill As Committed",21,0,0,0,21
1769741,1347565,2023-06-26,House,"House Floor: HR 139 PN 1425",166,37,0,0,203
1769748,1339055,2023-06-06,Senate,"Senate Local Government: Reported as Committed",11,0,0,0,11
1769748,1354877,2023-09-18,Senate,"Senate Appropriations: Re-Reported as Committed",22,0,2,0,24
1769748,1355483,2023-10-02,Senate,"Senate Floor: SB 749 PN 798, Final Passage",49,0,0,1,50
1769748,1449395,2024-05-22,House,"House Local Government: Report Bill As Committed",25,0,0,0,25
1769751,1339045,2023-06-06,Senate,"Senate Local Government: Reported as Committed",11,0,0,0,11
1769751,1345776,2023-06-21,Senate,"Senate Appropriations: Re-Reported as Committed",24,0,0,0,24
1769751,1346916,2023-06-22,Senate,"Senate Floor: SB 753 PN 800, Final Passage",48,0,0,2,50
1769751,1356290,2023-10-18,House,"House Local Government: Bring Up The Bill For Consideration",25,0,0,0,25
1769751,1410122,2024-03-18,House,"House Floor: SB 753 PN 800, FINAL PASSAGE",135,66,0,1,202
1769751,1410123,2024-03-18,House,"House Appropriations: Re-report Bill As Committed",37,0,0,0,37
1769757,1347663,2023-06-27,House,"House Judiciary: Report Bill As Committed",21,0,0,0,21
1769757,1348196,2023-06-28,House,"House Rules: Re-report Bill As Committed",33,0,0,0,33
1769757,1348678,2023-06-29,House,"House Floor: HB 1296 PN 1416, FINAL PASSAGE",154,49,0,0,203
1769757,1348679,2023-06-29,House,"House Appropriations: Re-report Bill As Committed",37,0,0,0,37
1769766,1342501,2023-06-06,House,"House Education: Report Bill As Amended",21,0,0,0,21
1769776,1339097,2023-06-05,House,"House State Government: Report Bill As Committed",12,9,0,0,21
1769776,1343157,2023-06-12,House,"House Floor: HR 133 PN 1414",159,44,0,0,203
1769834,1347680,2023-06-27,Senate,"Senate Banking And Insurance: Reported as Amended",13,0,1,0,14
1769834,1347681,2023-06-27,Senate,"Senate Banking And Insurance: Adopt Amendment A01268",13,0,1,0,14
1769834,1440175,2024-05-07,Senate,"Senate Floor: SB 739 PN 981, 2023 A4347, VOGEL Amendment No. A-4347",50,0,0,0,50
1769834,1440176,2024-05-07,Senate,"Senate Appropriations: Re-Reported as Committed",24,0,0,0,24
1769834,1440922,2024-05-08,Senate,"Senate Floor: SB 739 PN 1590, Final Passage",47,1,0,2,50
1769834,1445593,2024-05-21,House,"House Health: Re-refer Bill To Another Committee",25,0,0,0,25
1769834,1452857,2024-06-03,House,"House Insurance: Adopt Amendment A04588",25,0,0,0,25
1769834,1452858,2024-06-03,House,"House Insurance: Report Bill As Amended",25,0,0,0,25
1769834,1458896,2024-06-24,House,"House Appropriations: Re-report Bill As Committed",37,0,0,0,37
1769834,1459075,2024-06-24,House,"House Floor: SB 739 PN 1670, FINAL PASSAGE",194,8,0,1,203
1769834,1459850,2024-06-25,Senate,"Senate Rules And Executive Nominations: Re-Reported as Committed",17,0,0,0,17
1769834,1460442,2024-06-26,Senate,"Senate Floor: SB 739 PN 1670, Concur in House Amendments",49,1,0,0,50
1769839,1355564,2023-10-03,Senate,"Senate Health And Human Services: Reported as Amended",11,0,0,0,11
1769839,1355565,2023-10-03,Senate,"Senate Health And Human Services: Adopt Amendment A02270",11,0,0,0,11
1769839,1362390,2023-12-12,Senate,"Senate Floor: SB 721 PN 1147, Final Passage",50,0,0,0,50
1769839,1362391,2023-12-12,Senate,"Senate Appropriations: Re-Reported as Committed",24,0,0,0,24
1769839,1436428,2024-04-30,House,"House Health: Report Bill As Committed",17,8,0,0,25
1769839,1444908,2024-04-29,House,"House Human Services: Re-refer Bill To Another Committee",25,0,0,0,25
1769839,1445691,2024-05-21,House,"House Appropriations: Re-report Bill As Committed",37,0,0,0,37
1769839,1446158,2024-05-21,House,"House Floor: SB 721 PN 1147, FINAL PASSAGE",119,83,0,1,203
1769853,1354924,2023-09-19,Senate,"Senate State Government: Reported as Committed",10,0,1,0,11
1769856,1339831,2023-06-06,Senate,"Senate Health And Human Services: Reported as Committed",10,0,1,0,11
1769856,1347980,2023-06-27,Senate,"Senate Floor: SR 120 PN 805",49,0,0,1,50
1769862,1344582,2023-06-14,House,"House Local Government: Re-report Bill As Committed",21,0,0,0,21
1769862,1348252,2023-06-28,House,"House Rules: Re-report Bill As Committed",33,0,0,0,33
1769868,1346007,2023-06-21,Senate,"Senate Law And Justice: Reported as Committed",11,0,0,0,11
1769881,1355273,2023-09-27,House,"House Health: Report Bill As Committed",25,0,0,0,25
1769881,1357767,2023-11-15,House,"House Floor: HR 141 PN 1432",202,1,0,0,203
1769921,1340442,2023-06-07,House,"House Human Services: Report Bill As Committed",14,7,0,0,21
1769921,1343387,2023-06-13,House,"House Rules: Re-report Bill As Committed",18,15,0,0,33
1769921,1343959,2023-06-14,House,"House Appropriations: Re-report Bill As Committed",24,13,0,0,37
1769921,1344114,2023-06-14,House,"House Floor: HB 1305 PN 1427, FINAL PASSAGE",113,90,0,0,203
1769931,1340634,2023-06-07,House,"House Veterans Affairs And Emergency Preparedness: Postpone Consideration",9,12,0,0,21
1769931,1340635,2023-06-07,House,"House Veterans Affairs And Emergency Preparedness: Report Bill As Committed",13,8,0,0,21
1769931,1343301,2023-06-13,House,"House Rules: Re-report Bill As Committed",18,15,0,0,33
1769931,1343951,2023-06-14,House,"House Appropriations: Re-report Bill As Committed",24,13,0,0,37
1769931,1344085,2023-06-14,House,"House Floor: HB 1304 PN 1426, FINAL PASSAGE",121,82,0,0,203
1769931,1357436,2023-11-13,Senate,"Senate Veterans Affairs And Emergency Preparedness: Reported as Amended",11,0,0,0,11
1769931,1357437,2023-11-13,Senate,"Senate Veterans Affairs And Emergency Preparedness: Adopt Amendment A02924",7,4,0,0,11
1769931,1468394,2024-10-08,Senate,"Senate Veterans Affairs And Emergency Preparedness: Reported as Amended",11,0,0,0,11
1769931,1468395,2024-10-08,Senate,"Senate Veterans Affairs And Emergency Preparedness: Adopt Amendment A05659",11,0,0,0,11
1769931,1468838,2024-10-22,Senate,"Senate Appropriations: Re-Reported as Committed",24,0,0,0,24
1770010,1340750,2023-06-07,Senate,"Senate Finance: Reported as Committed",11,0,0,0,11
1770010,1352424,2023-08-30,Senate,"Senate Floor: SB 757 PN 1058, Motion to Suspend Rule 12",30,17,0,3,50
1770010,1352425,2023-08-30,Senate,"Senate Floor: SB 757 PN 1058, Final Passage",28,19,0,3,50
1770010,1352426,2023-08-30,Senate,"Senate Appropriations: Motion to Table Amendment A01926 to Amendment A01921 to Senate Bill 757 A01926",15,8,1,0,24
1770010,1352427,2023-08-30,Senate,"Senate Appropriations: Adopt Amendment A01921",15,8,1,0,24
1770010,1352428,2023-08-30,Senate,"Senate Appropriations: Re-Reported as Amended",15,8,1,0,24
1770046,1340435,2023-06-07,Senate,"Senate Finance: Reported as Committed",11,0,0,0,11
1770083,1343470,2023-06-13,House,"House Housing And Community Development: Report Bill As Amended",21,0,0,0,21
1770083,1343471,2023-06-13,House,"House Housing And Community Development: Adopt Amendment A00886",21,0,0,0,21
1770083,1347463,2023-06-26,House,"House Floor: HB 1316 PN 1563, 2023 A1307",101,102,0,0,203
1770083,1347464,2023-06-26,House,"House Rules: Re-report Bill As Committed",33,0,0,0,33
1770083,1347763,2023-06-27,House,"House Floor: HB 1316 PN 1563, FINAL PASSAGE",128,75,0,0,203
1770083,1347764,2023-06-27,House,"House Appropriations: Re-report Bill As Committed",23,14,0,0,37
1770128,1345172,2023-06-19,Senate,"Senate Education: Reported as Committed",7,4,0,0,11
1770128,1347765,2023-06-27,Senate,"Senate Appropriations: Re-Reported as Committed",24,0,0,0,24
1770128,1348068,2023-06-28,Senate,"Senate Floor: SB 750 PN 972, Final Passage",46,4,0,0,50
1770164,1340545,2023-06-07,Senate,"Senate Transportation: Reported as Committed",14,0,0,0,14
1770164,1345204,2023-06-19,Senate,"Senate Floor: SB 770 PN 828, Motion to agree to the bill on second consideration",50,0,0,0,50
1770164,1345481,2023-06-20,Senate,"Senate Floor: SB 770 PN 828, Final Passage",50,0,0,0,50
1770280,1355329,2023-09-27,House,"House Health: Report Bill As Amended",22,3,0,0,25
1770280,1355330,2023-09-27,House,"House Health: Adopt Amendment A02054",24,1,0,0,25
1770300,1347384,2023-06-26,House,"House Veterans Affairs And Emergency Preparedness: Report Bill As Committed",21,0,0,0,21
1770306,1343910,2023-06-14,House,"House Veterans Affairs And Emergency Preparedness: Re-refer Bill To Another Committee",21,0,0,0,21
1770340,1345929,2023-06-21,Senate,"Senate Local Government: Reported as Committed",11,0,0,0,11
1770340,1347768,2023-06-27,Senate,"Senate Appropriations: Re-Reported as Committed",24,0,0,0,24
1770340,1348080,2023-06-28,Senate,"Senate Floor: SB 740 PN 856, Final Passage",50,0,0,0,50
1770340,1357815,2023-11-15,House,"House Local Government: Report Bill As Committed",24,0,1,0,25
1770340,1412330,2024-03-20,House,"House Floor: SB 740 PN 856, FINAL PASSAGE",199,2,0,1,202
1770340,1412331,2024-03-20,House,"House Appropriations: Re-report Bill As Committed",37,0,0,0,37
1770347,1356394,2023-10-24,Senate,"Senate Health And Human Services: Reported as Committed",10,1,0,0,11
1770354,1347665,2023-06-27,Senate,"Senate Judiciary: Reported as Amended",14,0,0,0,14
1770354,1347666,2023-06-27,Senate,"Senate Judiciary: Adopt Amendment A01497",14,0,0,0,14
1770354,1348116,2023-06-28,Senate,"Senate Appropriations: Re-Reported as Committed",24,0,0,0,24
1770354,1348929,2023-06-29,Senate,"Senate Floor: SB 44 PN 976, Final Passage",50,0,0,0,50
1770354,1362135,2023-12-08,House,"House Judiciary: Report Bill As Amended",25,0,0,0,25
1770354,1362136,2023-12-08,House,"House Judiciary: Adopt Amendment A03103",25,0,0,0,25
1770354,1362567,2023-12-13,House,"House Floor: SB 44 PN 1264, FINAL PASSAGE",203,0,0,0,203
1770354,1362568,2023-12-13,House,"House Appropriations: Re-report Bill As Committed",37,0,0,0,37
1770354,1362667,2023-12-13,Senate,"Senate Floor: SB 44 PN 1264, Concur in House Amendments",50,0,0,0,50
1770354,1362668,2023-12-13,Senate,"Senate Rules And Executive Nominations: Re-Reported as Committed",17,0,0,0,17
1770365,1355856,2023-10-03,House,"House Professional Licensure: Re-refer Bill To Another Committee",25,0,0,0,25
1770379,1343279,2023-06-13,House,"House Education: Adopt Amendment A00924",21,0,0,0,21
1770379,1343280,2023-06-13,House,"House Education: Report Bill As Amended A00924",21,0,0,0,21
1770379,1345994,2023-06-21,House,"House Floor: HB 1331 PN 1548, 2023 A1120",203,0,0,0,203
1770379,1345995,2023-06-21,House,"House Rules: Re-report Bill As Committed",33,0,0,0,33
1770379,1346771,2023-06-22,House,"House Floor: HB 1331 PN 1653, FINAL PASSAGE",141,62,0,0,203
1770379,1346772,2023-06-22,House,"House Appropriations: Re-report Bill As Committed",37,0,0,0,37
1770385,1345839,2023-06-21,Senate,"Senate Local Government: Reported as Amended",11,0,0,0,11
1770385,1345840,2023-06-21,Senate,"Senate Local Government: Adopt Amendment A01092",11,0,0,0,11
1770563,1343493,2023-06-13,House,"House Labor And Industry: Report Bill As Committed",21,0,0,0,21
1770563,1347387,2023-06-26,House,"House Rules: Re-report Bill As Committed",33,0,0,0,33
1770563,1347468,2023-06-26,House,"House Floor: HB 1333 PN 1476, 2023 A1069",203,0,0,0,203
1770563,1347469,2023-06-26,House,"House Floor: HB 1333 PN 1476, 2023 A1274",101,102,0,0,203
1770563,1347470,2023-06-26,House,"House Floor: HB 1333 PN 1476, 2023 A1275",101,102,0,0,203
1770563,1347613,2023-06-27,House,"House Appropriations: Re-report Bill As Committed",22,15,0,0,37
1770563,1347760,2023-06-27,House,"House Floor: HB 1333 PN 1721, FINAL PASSAGE",163,40,0,0,203
1770563,1454025,2024-06-05,Senate,"Senate Labor And Industry: Reported as Committed",11,0,0,0,11
1770563,1455697,2024-06-10,Senate,"Senate Appropriations: Re-Reported as Committed",24,0,0,0,24
1770563,1456236,2024-06-11,Senate,"Senate Rules And Executive Nominations: Re-Reported as Amended",17,0,0,0,17
1770563,1456237,2024-06-11,Senate,"Senate Rules And Executive Nominations: Adopt Amendment A04771",17,0,0,0,17
1770563,1456729,2024-06-12,Senate,"Senate Floor: HB 1333 PN 3295, Final Passage",47,1,0,2,50
1770563,1458895,2024-06-24,House,"House Rules: Re-report Bill As Committed",33,0,0,0,33
1770563,1459442,2024-06-24,House,"House Floor: HB 1333 PN 3295, CONCURRENCE",154,48,0,1,203
1770587,1348261,2023-06-28,House,"House State Government: Report Bill As Amended",21,0,0,0,21
1770587,1348262,2023-06-28,House,"House State Government: Adopt Amendment A01457",21,0,0,0,21
1770648,1345209,2023-06-20,House,"House Transportation: Adopt Amendment A01098",21,0,0,0,21
1770648,1345210,2023-06-20,House,"House Transportation: Report Bill As Amended",21,0,0,0,21
1770648,1355465,2023-10-02,House,"House Floor: HB 1338 PN 1614, FINAL PASSAGE",160,43,0,0,203
1770648,1355466,2023-10-02,House,"House Appropriations: Re-report Bill As Committed",37,0,0,0,37
1770648,1462129,2024-07-01,Senate,"Senate Transportation: Reported as Committed",13,1,0,0,14
1770718,1343964,2023-06-14,House,"House Health: Report Bill As Committed",21,0,0,0,21
1770718,1348740,2023-06-29,House,"House Floor: HB 1351 PN 1493, 2023 A1555",203,0,0,0,203
1770718,1348741,2023-06-29,House,"House Rules: Re-report Bill As Committed",33,0,0,0,33
1770718,1349713,2023-07-06,House,"House Floor: HB 1351 PN 1802, FINAL PASSAGE",193,10,0,0,203
1770718,1349714,2023-07-06,House,"House Appropriations: Re-report Bill As Committed",37,0,0,0,37
1770718,1355585,2023-10-03,Senate,"Senate Health And Human Services: Reported as Committed",11,0,0,0,11
1770718,1356068,2023-10-16,Senate,"Senate Rules And Executive Nominations: Re-Reported as Amended",16,0,1,0,17
1770718,1356069,2023-10-16,Senate,"Senate Rules And Executive Nominations: Adopt Amendment A02562",16,0,1,0,17
1770718,1356158,2023-10-17,Senate,"Senate Floor: HB 1351 PN 2159, Final Passage",49,0,0,1,50
1770718,1356159,2023-10-17,Senate,"Senate Appropriations: Re-Reported as Committed",23,0,1,0,24
1770718,1356242,2023-10-18,House,"House Floor: HB 1351 PN 2159, CONCURRENCE",199,4,0,0,203
1770718,1356243,2023-10-18,House,"House Rules: Re-report Bill As Committed",33,0,0,0,33
1770775,1356790,2023-10-31,House,"House Housing And Community Development: Report Bill As Amended",25,0,0,0,25
1770775,1356791,2023-10-31,House,"House Housing And Community Development: Adopt Amendment A02558",25,0,0,0,25
1770821,1355272,2023-09-27,House,"House Health: Report Bill As Committed",25,0,0,0,25
1770821,1355747,2023-10-04,House,"House Floor: HR 144 PN 1509",202,1,0,0,203
1770833,1343450,2023-06-13,House,"House Labor And Industry: Adopt Amendment A00926",9,12,0,0,21
1770833,1343451,2023-06-13,House,"House Labor And Industry: Adopt Amendment A00927",9,12,0,0,21
1770833,1343452,2023-06-13,House,"House Labor And Industry: Report Bill As Committed",21,0,0,0,21
1770833,1347589,2023-06-27,House,"House Rules: Re-report Bill As Committed",32,0,1,0,33
1770833,1348240,2023-06-28,House,"House Floor: HB 1354 PN 1495, FINAL PASSAGE",180,23,0,0,203
1770833,1348241,2023-06-28,House,"House Appropriations: Re-report Bill As Committed",37,0,0,0,37
1770833,1355755,2023-10-04,Senate,"Senate Labor And Industry: Reported as Committed",11,0,0,0,11
1770968,1455674,2024-06-10,House,"House Transportation: Report Bill As Committed",25,0,0,0,25
1771003,1346001,2023-06-21,Senate,"Senate Law And Justice: Reported as Committed",11,0,0,0,11
1771003,1354883,2023-09-18,Senate,"Senate Appropriations: Re-Reported as Committed",20,2,2,0,24
1771003,1354932,2023-09-19,Senate,"Senate Floor: SB 773 PN 860, 2023 A2014, GEBHARD Amendment No. A-2014",46,0,0,4,50
1771003,1355016,2023-09-20,Senate,"Senate Floor: SB 773 PN 1105, Final Passage",44,3,0,3,50
1771003,1356662,2023-10-30,House,"House Health: Adopt Amendment A02792",20,5,0,0,25
1771003,1356663,2023-10-30,House,"House Health: Report Bill As Amended",20,5,0,0,25
1771003,1357567,2023-11-14,House,"House Floor: SB 773 PN 1191, 2023 A2829",101,102,0,0,203
1771003,1357568,2023-11-14,House,"House Floor: SB 773 PN 1191, 2023 A2830",101,102,0,0,203
1771003,1357569,2023-11-14,House,"House Floor: SB 773 PN 1191, 2023 A2914",103,100,0,0,203
1771003,1357692,2023-11-15,House,"House Appropriations: Re-report Bill As Committed",37,0,0,0,37
1771003,1357751,2023-11-15,House,"House Floor: SB 773 PN 1229, FINAL PASSAGE",114,89,0,0,203
1771003,1362335,2023-12-12,Senate,"Senate Rules And Executive Nominations: Re-Reported as Committed",15,2,0,0,17
1771003,1362448,2023-12-12,Senate,"Senate Floor: SB 773 PN 1229, Concur in House Amendments",44,6,0,0,50
1771035,1440318,2024-05-07,House,"House Education: Adopt Amendment A04271",15,10,0,0,25
1771035,1440319,2024-05-07,House,"House Education: Report Bill As Amended",15,10,0,0,25
1771035,1452840,2024-06-03,House,"House Floor: HB 1367 PN 3071, 2023 A4430",102,100,0,1,203
1771035,1452841,2024-06-03,House,"House Floor: HB 1367 PN 3071, 2023 A4540",101,101,0,1,203
1771035,1452842,2024-06-03,House,"House Floor: HB 1367 PN 3071, 2023 A4547",101,101,0,1,203
1771035,1453137,2024-06-04,House,"House Appropriations: Re-report Bill As Committed",22,15,0,0,37
1771035,1453580,2024-06-04,House,"House Floor: HB 1367 PN 3211, FINAL PASSAGE",102,100,0,1,203
1771120,1348011,2023-06-28,House,"House Judiciary: Report Bill As Committed",12,9,0,0,21
1771120,1414837,2024-03-25,House,"House Floor: HB 1371 PN 1525, 2023 A3769",102,99,0,1,202
1771120,1414838,2024-03-25,House,"House Rules: Re-report Bill As Committed",18,15,0,0,33
1771120,1415617,2024-03-26,House,"House Appropriations: Re-report Bill As Committed",22,15,0,0,37
1771240,1345462,2023-06-20,House,"House State Government: Report Bill As Committed",12,9,0,0,21
1771240,1348254,2023-06-28,House,"House Floor: HR 149 PN 1547",202,1,0,0,203
1771241,1347401,2023-06-26,House,"House Veterans Affairs And Emergency Preparedness: Report Bill As Committed",21,0,0,0,21
1771241,1349864,2023-07-07,House,"House Floor: HR 147 PN 1545",203,0,0,0,203
1771243,1467633,2024-09-25,House,"House Local Government: Report Bill As Committed",21,4,0,0,25
1771243,1467634,2024-09-25,House,"House Local Government: Adopt Amendment A05652",11,14,0,0,25
1771243,1468259,2024-10-07,House,"House Floor: HB 1379 PN 1539, 2023 A5727",202,0,0,1,203
1771243,1468260,2024-10-07,House,"House Floor: HB 1379 PN 1539, 2023 A5600",135,67,0,1,203
1771243,1468261,2024-10-07,House,"House Floor: HB 1379 PN 1539, MOTION TO TABLE AMENDMENTS",102,100,0,1,203
1771243,1468380,2024-10-08,House,"House Appropriations: Re-report Bill As Committed",25,12,0,0,37
1771243,1468783,2024-10-21,House,"House Appropriations: Adopt Amendment A05938",22,15,0,0,37
1771243,1468784,2024-10-21,House,"House Appropriations: Re-report Bill As Amended",25,12,0,0,37
1771243,1468830,2024-10-22,House,"House Floor: HB 1379 PN 3780, FINAL PASSAGE",135,67,0,1,203
1771244,1343375,2023-06-13,House,"House Labor And Industry: Report Bill As Committed",12,9,0,0,21
1771244,1343914,2023-06-14,House,"House Rules: Re-report Bill As Committed",18,15,0,0,33
1771244,1344001,2023-06-14,House,"House Floor: HB 1500 PN 1534, 2023 A975",101,102,0,0,203
1771244,1344002,2023-06-14,House,"House Floor: HB 1500 PN 1534, 2023 A977",100,103,0,0,203
1771244,1344003,2023-06-14,House,"House Floor: HB 1500 PN 1534, 2023 A980",101,102,0,0,203
1771244,1344004,2023-06-14,House,"House Floor: HB 1500 PN 1534, 2023 A987",100,103,0,0,203
1771244,1344005,2023-06-14,House,"House Floor: HB 1500 PN 1534, 2023 A989",92,111,0,0,203
1771244,1344006,2023-06-14,House,"House Floor: HB 1500 PN 1534, 2023 A991",101,102,0,0,203
1771244,1344007,2023-06-14,House,"House Floor: HB 1500 PN 1534, 2023 A992",98,105,0,0,203
1771244,1344008,2023-06-14,House,"House Floor: HB 1500 PN 1534, 2023 A1004",89,114,0,0,203
1771244,1344009,2023-06-14,House,"House Floor: HB 1500 PN 1534, 2023 A1022",42,161,0,0,203
1771244,1344010,2023-06-14,House,"House Floor: HB 1500 PN 1534, 2023 A1029, MOTION TO SUSPEND RULES",101,102,0,0,203
1771244,1345319,2023-06-20,House,"House Appropriations: Adopt Amendment A01027",22,15,0,0,37
1771244,1345320,2023-06-20,House,"House Appropriations: Re-report Bill As Amended",22,15,0,0,37
1771244,1345479,2023-06-20,House,"House Floor: HB 1500 PN 1615, FINAL PASSAGE",103,100,0,0,203
1771245,1345223,2023-06-20,House,"House Agriculture And Rural Affairs: Report Bill As Committed",20,0,1,0,21
1771245,1349681,2023-07-06,House,"House Floor: HR 148 PN 1546",202,1,0,0,203
1771246,1355513,2023-10-03,House,"House Consumer Protection, Technology And Utilities: Report Bill As Committed",25,0,0,0,25
1771246,1356070,2023-10-16,House,"House Floor: HB 1378 PN 1538, FINAL PASSAGE",193,10,0,0,203
1771246,1356071,2023-10-16,House,"House Appropriations: Re-report Bill As Committed",37,0,0,0,37
1771248,1355252,2023-09-27,House,"House Judiciary: Adopt Amendment A02090",24,0,1,0,25
1771248,1355253,2023-09-27,House,"House Judiciary: Report Bill As Amended",14,11,0,0,25
1771379,1345950,2023-06-21,Senate,"Senate Local Government: Reported as Committed",11,0,0,0,11
1771379,1347766,2023-06-27,Senate,"Senate Appropriations: Re-Reported as Committed",24,0,0,0,24
1771379,1349026,2023-06-30,Senate,"Senate Floor: SB 765 PN 863, Final Passage",50,0,0,0,50
1771379,1461171,2024-06-26,House,"House Local Government: Report Bill As Committed",25,0,0,0,25
1771379,1468152,2024-10-07,House,"House Appropriations: Re-report Bill As Committed",37,0,0,0,37
1771379,1468269,2024-10-07,House,"House Floor: SB 765 PN 863, FINAL PASSAGE",119,83,0,1,203
1771385,1388505,2024-02-20,House,"House Housing And Community Development: Report Bill As Amended",25,0,0,0,25
1771385,1388506,2024-02-20,House,"House Housing And Community Development: Adopt Amendment A03445",25,0,0,0,25
1771390,1356185,2023-10-18,House,"House Judiciary: Report Bill As Committed",25,0,0,0,25
1771390,1410963,2024-03-19,House,"House Floor: HB 1399 PN 1567, 2023 A3469, MOTION TO APPEAL RULING OF THE CHAIR",102,99,0,1,202
1771390,1410964,2024-03-19,House,"House Floor: HB 1399 PN 1567, 2023 A3476, MOTION TO APPEAL RULING OF THE CHAIR",102,99,0,1,202
1771390,1412198,2024-03-20,House,"House Floor: HB 1399 PN 1567, FINAL PASSAGE",201,0,0,1,202
1771390,1412199,2024-03-20,House,"House Appropriations: Re-report Bill As Committed",37,0,0,0,37
1771393,1345215,2023-06-20,House,"House State Government: Report Bill As Committed",12,9,0,0,21
1771393,1348607,2023-06-29,House,"House Rules: Re-report Bill As Committed",18,15,0,0,33
1771393,1349699,2023-07-06,House,"House Floor: HB 1394 PN 1556, 2023 A1311",101,102,0,0,203
1771393,1349700,2023-07-06,House,"House Floor: HB 1394 PN 1556, 2023 A1424",102,101,0,0,203
1771393,1349701,2023-07-06,House,"House Floor: HB 1394 PN 1556, 2023 A1431",102,101,0,0,203
1771393,1349702,2023-07-06,House,"House Floor: HB 1394 PN 1556, 2023 A1432",101,102,0,0,203
1771393,1349703,2023-07-06,House,"House Floor: HB 1394 PN 1556, 2023 A1448",102,101,0,0,203
1771393,1349704,2023-07-06,House,"House Floor: HB 1394 PN 1556, 2023 A1676",102,101,0,0,203
1771393,1349860,2023-07-07,House,"House Floor: HB 1394 PN 1827, FINAL PASSAGE",182,21,0,0,203
1771393,1349861,2023-07-07,House,"House Appropriations: Re-report Bill As Committed",22,15,0,0,37
1771408,1446165,2024-05-21,House,"House Housing And Community Development: Report Bill As Amended",25,0,1,0,26
1771408,1446166,2024-05-21,House,"House Housing And Community Development: Adopt Amendment A04444",25,0,1,0,26
1771415,1345231,2023-06-20,House,"House Agriculture And Rural Affairs: Report Bill As Committed",20,0,1,0,21
1771415,1348522,2023-06-28,House,"House Floor: HR 151 PN 1561",202,1,0,0,203
1771426,1357424,2023-11-13,House,"House Judiciary: Report Bill As Committed",14,11,0,0,25
1771426,1362280,2023-12-11,House,"House Floor: HB 1410 PN 1578, 2023 A2970",101,102,0,0,203
1771426,1362281,2023-12-11,House,"House Floor: HB 1410 PN 1578, 2023 A2971",101,102,0,0,203
1771426,1362282,2023-12-11,House,"House Floor: HB 1410 PN 1578, 2023 A2972",101,102,0,0,203
1771426,1362283,2023-12-11,House,"House Floor: HB 1410 PN 1578, MOTION TO TABLE AMENDMENTS",102,101,0,0,203
1771426,1362389,2023-12-12,House,"House Appropriations: Re-report Bill As Committed",22,15,0,0,37
1771431,1461120,2024-06-27,House,"House Appropriations: Re-report Bill As Committed",37,0,0,0,37
1771437,1343987,2023-06-14,House,"House Health: Report Bill As Committed",21,0,0,0,21
1771437,1345940,2023-06-21,House,"House Rules: Re-report Bill As Committed",33,0,0,0,33
1771437,1346635,2023-06-22,House,"House Floor: HB 1407 PN 1572, FINAL PASSAGE",202,1,0,0,203
1771437,1346636,2023-06-22,House,"House Appropriations: Re-report Bill As Committed",37,0,0,0,37
1771437,1352396,2023-08-30,Senate,"Senate Appropriations: Reported as Committed",23,0,1,0,24
1771437,1354943,2023-09-19,Senate,"Senate Floor: HB 1407 PN 1572, Final Passage",46,0,0,4,50
1771443,1348057,2023-06-28,House,"House Game And Fisheries: Report Bill As Committed",21,0,0,0,21
1771443,1355238,2023-09-27,House,"House Appropriations: Re-report Bill As Committed",24,13,0,0,37
1771443,1355305,2023-09-27,House,"House Floor: HB 1409 PN 1577, FINAL PASSAGE",154,48,0,0,202
1771443,1412347,2024-03-20,Senate,"Senate Game And Fisheries: Reported as Committed",10,1,0,0,11
1771443,1467319,2024-09-16,Senate,"Senate Appropriations: Re-Reported as Committed",22,1,1,0,24
1771443,1468865,2024-10-22,Senate,"Senate Floor: HB 1409 PN 1577, Final Passage",49,1,0,0,50
1771443,1468866,2024-10-22,Senate,"Senate Floor: HB 1409 PN 1577, Final Passage-Reconsidered",47,3,0,0,50
1771447,1348073,2023-06-28,House,"House State Government: Report Bill As Committed",12,9,0,0,21
1771447,1348074,2023-06-28,House,"House State Government: Adopt Amendment A01486",9,12,0,0,21
1771448,1345208,2023-06-20,House,"House State Government: Report Bill As Committed",12,9,0,0,21
1771448,1346422,2023-06-22,House,"House Floor: HR 152 PN 1587",182,21,0,0,203
1771566,1345943,2023-06-21,Senate,"Senate Local Government: Reported as Committed",11,0,0,0,11
1771566,1347751,2023-06-27,Senate,"Senate Appropriations: Re-Reported as Committed",24,0,0,0,24
1771566,1349030,2023-06-30,Senate,"Senate Floor: SB 775 PN 874, Final Passage",50,0,0,0,50
1771568,1354904,2023-09-19,Senate,"Senate Communications And Technology: Reported as Committed",11,0,0,0,11
1771568,1376034,2024-02-05,Senate,"Senate Appropriations: Re-Reported as Amended",23,0,1,0,24
1771568,1376035,2024-02-05,Senate,"Senate Appropriations: Adopt Amendment A03073",23,0,1,0,24
1771568,1377168,2024-02-06,Senate,"Senate Floor: SB 745 PN 1357, Final Passage",48,0,0,2,50
1771572,1424035,2024-04-10,Senate,"Senate Labor And Industry: Reported as Committed",11,0,0,0,11
1771572,1455700,2024-06-10,Senate,"Senate Appropriations: Re-Reported as Committed",24,0,0,0,24
1771572,1456606,2024-06-12,Senate,"Senate Floor: SB 761 PN 864, Final Passage",48,0,0,2,50
1771573,1459861,2024-06-25,Senate,"Senate State Government: Reported as Committed",11,0,0,0,11
1771573,1460214,2024-06-26,Senate,"Senate Appropriations: Re-Reported as Committed",23,0,1,0,24
1771573,1468868,2024-10-22,Senate,"Senate Floor: SB 766 PN 867, Final Passage",50,0,0,0,50
1771575,1345937,2023-06-21,Senate,"Senate Local Government: Reported as Committed",11,0,0,0,11
1771575,1347752,2023-06-27,Senate,"Senate Appropriations: Re-Reported as Committed",24,0,0,0,24
1771575,1349033,2023-06-30,Senate,"Senate Floor: SB 784 PN 880, Final Passage",50,0,0,0,50
1771575,1356311,2023-10-18,House,"House Local Government: Report Bill As Committed",25,0,0,0,25
1771577,1354906,2023-09-19,Senate,"Senate Communications And Technology: Reported as Amended",11,0,0,0,11
1771577,1354907,2023-09-19,Senate,"Senate Communications And Technology: Adopt Amendment A02016",11,0,0,0,11
1771588,1348087,2023-06-28,House,"House State Government: Report Bill As Committed",12,9,0,0,21
1771588,1348088,2023-06-28,House,"House State Government: Adopt Amendment A01488",9,12,0,0,21
1771588,1357448,2023-11-13,House,"House Floor: HB 1416 PN 1584, 2023 A1960, MOTION TO APPEAL RULING OF THE CHAIR",102,101,0,0,203
1771588,1357449,2023-11-13,House,"House Floor: HB 1416 PN 1584, 2023 A1773, MOTION TO APPEAL RULING OF THE CHAIR",102,101,0,0,203
1771588,1357450,2023-11-13,House,"House Floor: HB 1416 PN 1584, 2023 A1750",101,102,0,0,203
1771588,1357451,2023-11-13,House,"House Floor: HB 1416 PN 1584, 2023 A1769",101,102,0,0,203
1771588,1357452,2023-11-13,House,"House Floor: HB 1416 PN 1584, 2023 A1791",101,102,0,0,203
1771588,1357453,2023-11-13,House,"House Floor: HB 1416 PN 1584, 2023 A1821",95,108,0,0,203
1771588,1357454,2023-11-13,House,"House Floor: HB 1416 PN 1584, 2023 A2645",101,102,0,0,203
1771588,1357455,2023-11-13,House,"House Floor: HB 1416 PN 1584, MOTION TO RECOMMIT TO STATE GOVERNMENT",98,105,0,0,203
1771588,1357456,2023-11-13,House,"House Rules: Re-report Bill As Committed",18,15,0,0,33
1771588,1357570,2023-11-14,House,"House Floor: HB 1416 PN 1584, FINAL PASSAGE",140,63,0,0,203
1771588,1357571,2023-11-14,House,"House Appropriations: Re-report Bill As Committed",24,13,0,0,37
1771589,1346921,2023-06-22,House,"House Commerce: Report Bill As Committed",21,0,0,0,21
1771589,1346922,2023-06-22,House,"House Commerce: Bring Up The Bill For Consideration",21,0,0,0,21
1771589,1347994,2023-06-28,House,"House Rules: Re-report Bill As Committed",33,0,0,0,33
1771589,1348611,2023-06-29,House,"House Appropriations: Re-report Bill As Committed",37,0,0,0,37
1771589,1348783,2023-06-29,House,"House Floor: HB 1419 PN 1598, FINAL PASSAGE",203,0,0,0,203
1771589,1357566,2023-11-14,Senate,"Senate State Government: Reported as Committed",11,0,0,0,11
1771589,1436095,2024-04-29,Senate,"Senate Appropriations: Re-Reported as Committed",24,0,0,0,24
1771589,1440383,2024-05-07,Senate,"Senate Floor: HB 1419 PN 1598, Final Passage",50,0,0,0,50
1771590,1345801,2023-06-21,Senate,"Senate Local Government: Reported as Committed",11,0,0,0,11
1771590,1347728,2023-06-27,Senate,"Senate Appropriations: Re-Reported as Committed",24,0,0,0,24
1771590,1349111,2023-06-30,Senate,"Senate Floor: SB 774 PN 873, Final Passage",50,0,0,0,50
1771592,1356255,2023-10-18,House,"House Health: Adopt Amendment A02054",25,0,0,0,25
1771592,1356256,2023-10-18,House,"House Health: Report Bill As Amended",24,1,0,0,25
1771592,1357684,2023-11-15,House,"House Floor: HB 1417 PN 2275, 2023 A2953, MOTION TO APPEAL RULING OF THE CHAIR",102,101,0,0,203
1771592,1357758,2023-11-15,House,"House Floor: HB 1417 PN 2275, 2023 A2982",101,102,0,0,203
1771592,1357759,2023-11-15,House,"House Floor: HB 1417 PN 2275, 2023 A2984",101,102,0,0,203
1771592,1362275,2023-12-11,House,"House Appropriations: Re-report Bill As Committed",22,15,0,0,37
1771592,1362466,2023-12-12,House,"House Floor: HB 1417 PN 2275, FINAL PASSAGE",153,50,0,0,203
1771606,1356437,2023-10-24,Senate,"Senate Education: Reported as Amended",10,0,1,0,11
1771606,1356438,2023-10-24,Senate,"Senate Education: Adopt Amendment A02560",10,0,1,0,11
1771606,1357439,2023-11-13,Senate,"Senate Appropriations: Re-Reported as Committed",24,0,0,0,24
1771606,1357649,2023-11-14,Senate,"Senate Floor: SB 700 PN 1183, Final Passage",50,0,0,0,50
1771606,1461872,2024-07-01,House,"House Education: Report Bill As Committed",25,0,0,0,25
1771606,1462988,2024-07-11,House,"House Floor: SB 700 PN , MOTION TO PROCEED BRADFORD",183,19,0,1,203
1771606,1462989,2024-07-11,House,"House Floor: SB 700 PN 1816, FINAL PASSAGE",137,65,0,1,203
1771606,1462990,2024-07-11,House,"House Appropriations: Re-report Bill As Amended",22,15,0,0,37
1771606,1462991,2024-07-11,House,"House Appropriations: Adopt Amendment A05531",22,15,0,0,37
1771606,1462992,2024-07-11,Senate,"Senate Rules And Executive Nominations: Re-Reported as Committed",16,1,0,0,17
1771606,1463052,2024-07-11,Senate,"Senate Floor: SB 700 PN 1816, Concur in House Amendments",42,7,0,1,50
1771611,1347472,2023-06-26,Senate,"Senate State Government: Reported as Amended",7,4,0,0,11
1771611,1347473,2023-06-26,Senate,"Senate State Government: Reported as Amended A01428",10,1,0,0,11
1771611,1347999,2023-06-28,Senate,"Senate Appropriations: Re-Reported as Committed",15,9,0,0,24
1771681,1345508,2023-06-20,Senate,"Senate Health And Human Services: Reported as Committed",11,0,0,0,11
1771697,1345355,2023-06-20,Senate,"Senate Health And Human Services: Reported as Committed",11,0,0,0,11
1771829,1454573,2024-06-05,House,"House Local Government: Report Bill As Committed",15,10,0,0,25
1771942,1457014,2024-06-12,House,"House Human Services: Re-refer Bill To Another Committee",25,0,0,0,25
1771942,1459734,2024-06-25,House,"House Children And Youth: Adopt Amendment A05004",25,0,0,0,25
1771942,1459735,2024-06-25,House,"House Children And Youth: Report Bill As Amended",25,0,0,0,25
1771942,1462420,2024-07-03,House,"House Rules: Re-report Bill As Committed",33,0,0,0,33
1771942,1462706,2024-07-08,House,"House Floor: HB 1425 PN 3387, FINAL PASSAGE",144,57,0,2,203
1771942,1462707,2024-07-08,House,"House Appropriations: Re-report Bill As Committed",24,13,0,0,37
1771977,1346923,2023-06-22,House,"House Commerce: Bring Up The Bill For Consideration",21,0,0,0,21
1771977,1346924,2023-06-22,House,"House Commerce: Adopt Amendment A01091",21,0,0,0,21
1771977,1346925,2023-06-22,House,"House Commerce: Report Bill As Amended",21,0,0,0,21
1772050,1377928,2024-02-07,Senate,"Senate Education: Reported as Amended",10,0,1,0,11
1772050,1377929,2024-02-07,Senate,"Senate Education: Adopt Amendment A03457",10,0,1,0,11
1772050,1455698,2024-06-10,Senate,"Senate Appropriations: Re-Reported as Committed",24,0,0,0,24
1772050,1456142,2024-06-11,Senate,"Senate Floor: SB 801 PN 1710, Final Passage",48,1,0,1,50
1772050,1467716,2024-09-30,House,"House Education: Report Bill As Committed",25,0,0,0,25
1772050,1468263,2024-10-07,House,"House Floor: SB 801 PN 1710, 2023 A5835",106,96,0,1,203
1772050,1468306,2024-10-08,House,"House Appropriations: Re-report Bill As Committed",37,0,0,0,37
1772050,1468419,2024-10-08,House,"House Floor: SB 801 PN 1939, FINAL PASSAGE",201,0,0,2,203
1772050,1468454,2024-10-09,Senate,"Senate Rules And Executive Nominations: Re-Reported as Committed",17,0,0,0,17
1772050,1468539,2024-10-09,Senate,"Senate Floor: SB 801 PN 1939, Concur in House Amendments",49,0,0,1,50
1772062,1354901,2023-09-19,Senate,"Senate Communications And Technology: Reported as Amended",11,0,0,0,11
1772062,1354902,2023-09-19,Senate,"Senate Communications And Technology: Adopt Amendment A01100",11,0,0,0,11
1772062,1354903,2023-09-19,Senate,"Senate Communications And Technology: Adopt Amendment A02020",11,0,0,0,11
1772062,1355452,2023-10-02,Senate,"Senate Appropriations: Re-Reported as Committed",23,0,1,0,24
1772062,1355712,2023-10-04,Senate,"Senate Floor: SB 824 PN 1151, Final Passage",50,0,0,0,50
1772062,1456062,2024-06-11,House,"House Consumer Protection, Technology And Utilities: Report Bill As Committed",25,0,0,0,25
1772062,1459806,2024-06-25,House,"House Floor: SB 824 PN 1151, FINAL PASSAGE",202,0,0,1,203
1772062,1459807,2024-06-25,House,"House Appropriations: Re-report Bill As Committed",37,0,0,0,37
1772065,1355711,2023-10-04,House,"House Finance: Report Bill As Committed",24,1,0,0,25
1772070,1347587,2023-06-27,Senate,"Senate Banking And Insurance: Reported as Committed",9,4,1,0,14
1772070,1355536,2023-10-03,Senate,"Senate Floor: SR 134 PN 901",29,19,0,2,50
1772073,1440384,2024-05-07,Senate,"Senate Education: Reported as Amended",8,3,0,0,11
1772073,1440385,2024-05-07,Senate,"Senate Education: Adopt Amendment A04368",8,3,0,0,11
1772207,1468157,2024-10-07,House,"House Transportation: Report Bill As Committed",25,0,0,0,25
1772208,1345399,2023-06-20,House,"House Agriculture And Rural Affairs: Report Bill As Committed",20,0,1,0,21
1772208,1349718,2023-07-06,House,"House Floor: HR 160 PN 1603",201,2,0,0,203
1772210,1347612,2023-06-27,House,"House Education: Re-report Bill As Committed",12,9,0,0,21
1772210,1412244,2024-03-20,House,"House Rules: Re-report Bill As Committed",18,15,0,0,33
1772210,1414600,2024-03-25,House,"House Floor: HB 1434 PN 1613, FINAL PASSAGE",102,99,0,1,202
1772210,1414601,2024-03-25,House,"House Appropriations: Re-report Bill As Committed",22,15,0,0,37
1772211,1345211,2023-06-20,House,"House Transportation: Report Bill As Committed",21,0,0,0,21
1772211,1347436,2023-06-26,House,"House Floor: HR 154 PN 1604, 2023 A1303",101,102,0,0,203
1772211,1347437,2023-06-26,House,"House Floor: HR 154 PN 1604",165,38,0,0,203
1772225,1410943,2024-03-19,House,"House Children And Youth: Adopt Amendment A03537",25,0,0,0,25
1772225,1410944,2024-03-19,House,"House Children And Youth: Adopt Amendment A03593",25,0,0,0,25
1772225,1410945,2024-03-19,House,"House Children And Youth: Adopt Amendment A03594",25,0,0,0,25
1772225,1410946,2024-03-19,House,"House Children And Youth: Report Bill As Amended",20,5,0,0,25
1772225,1415483,2024-03-26,House,"House Floor: HB 1443 PN 2744, 2023 A3684",201,0,0,1,202
1772225,1415484,2024-03-26,House,"House Floor: HB 1443 PN 2744, 2023 A3758",100,101,0,1,202
1772225,1415485,2024-03-26,House,"House Floor: HB 1443 PN 2744, 2023 A3760",100,101,0,1,202
1772225,1415486,2024-03-26,House,"House Floor: HB 1443 PN 2744, 2023 A3764",99,102,0,1,202
1772225,1415487,2024-03-26,House,"House Floor: HB 1443 PN 2744, 2023 A3772",100,101,0,1,202
1772225,1415488,2024-03-26,House,"House Floor: HB 1443 PN 2744, 2023 A3784",99,102,0,1,202
1772225,1416134,2024-03-27,House,"House Appropriations: Re-report Bill As Committed",22,14,1,0,37
1772225,1416510,2024-03-27,House,"House Floor: HB 1443 PN 2810, FINAL PASSAGE",102,99,0,1,202
1772225,1460271,2024-06-26,Senate,"Senate Community, Economic And Recreational Development: Reported as Amended",14,0,0,0,14
1772225,1460272,2024-06-26,Senate,"Senate Community, Economic And Recreational Development: Adopt Amendment A05132",14,0,0,0,14
1772231,1357524,2023-11-14,House,"House Judiciary: Report Bill As Committed",14,11,0,0,25
1772231,1460259,2024-06-26,House,"House Floor: HB 1441 PN 1625, 2023 A4997",102,100,0,1,203
1772231,1461202,2024-06-27,House,"House Floor: HB 1441 PN 3414, FINAL PASSAGE",116,86,0,1,203
1772231,1461868,2024-06-27,House,"House Appropriations: Re-report Bill As Committed",37,0,0,0,37
1772239,1449372,2024-05-22,House,"House Local Government: Adopt Amendment A04489",15,10,0,0,25
1772239,1449373,2024-05-22,House,"House Local Government: Report Bill As Amended",15,10,0,0,25
1772245,1346003,2023-06-21,House,"House Education: Report Bill As Committed",12,9,0,0,21
1772245,1346435,2023-06-21,House,"House Rules: Re-report Bill As Committed",18,15,0,0,33
1772245,1346778,2023-06-22,House,"House Floor: HB 1408 PN 1605, 2023 A1286, MOTION TO SUSPEND RULES",203,0,0,0,203
1772245,1346779,2023-06-22,House,"House Floor: HB 1408 PN 1605, 2023 A1286",203,0,0,0,203
1772245,1346780,2023-06-22,House,"House Floor: HB 1408 PN 1605, 2023 A1234",101,102,0,0,203
1772245,1346781,2023-06-22,House,"House Floor: HB 1408 PN 1605, 2023 A1238",101,102,0,0,203
1772245,1346782,2023-06-22,House,"House Floor: HB 1408 PN 1605, 2023 A1241",203,0,0,0,203
1772245,1346783,2023-06-22,House,"House Floor: HB 1408 PN 1605, 2023 A1209",203,0,0,0,203
1772245,1347412,2023-06-26,House,"House Appropriations: Re-report Bill As Committed",26,11,0,0,37
1772245,1347554,2023-06-26,House,"House Floor: HB 1408 PN 1692, FINAL PASSAGE",142,61,0,0,203
1772279,1347424,2023-06-26,Senate,"Senate State Government: Reported as Committed",11,0,0,0,11
1772279,1348109,2023-06-28,Senate,"Senate Floor: SB 829 PN 983, Final Passage",50,0,0,0,50
1772279,1348694,2023-06-29,House,"House State Government: Report Bill As Amended",21,0,0,0,21
1772279,1348695,2023-06-29,House,"House State Government: Adopt Amendment A01601",21,0,0,0,21
1772279,1349679,2023-07-06,House,"House Floor: SB 829 PN 991, 2023 A1678",203,0,0,0,203
1772279,1349680,2023-07-06,House,"House Floor: SB 829 PN 991, 2023 A1674",203,0,0,0,203
1772279,1349880,2023-07-07,House,"House Floor: SB 829 PN 1014, FINAL PASSAGE",202,1,0,0,203
1772279,1349881,2023-07-07,House,"House Appropriations: Re-report Bill As Committed",37,0,0,0,37
1772279,1349882,2023-07-07,House,"House Appropriations: Adopt Amendment A01801",15,22,0,0,37
1772279,1352452,2023-08-30,Senate,"Senate Floor: SB 829 PN 1014, Concur in House Amendments",47,0,0,3,50
1772279,1352453,2023-08-30,Senate,"Senate Rules And Executive Nominations: Re-Reported as Committed",17,0,0,0,17
1772281,1346641,2023-06-22,Senate,"Senate Judiciary: Reported as Committed",13,0,1,0,14
1772281,1354949,2023-09-19,Senate,"Senate Floor: SB 815 PN 917, Final Passage",46,0,0,4,50
1772281,1354950,2023-09-19,Senate,"Senate Appropriations: Re-Reported as Committed",23,0,1,0,24
1772281,1357438,2023-11-13,House,"House Judiciary: Report Bill As Committed",25,0,0,0,25
1772281,1362279,2023-12-11,House,"House Floor: SB 815 PN 917, 2023 A3003",203,0,0,0,203
1772281,1362341,2023-12-12,House,"House Appropriations: Re-report Bill As Committed",37,0,0,0,37
1772281,1362445,2023-12-12,House,"House Floor: SB 815 PN 1271, FINAL PASSAGE",202,1,0,0,203
1772281,1362654,2023-12-13,Senate,"Senate Floor: SB 815 PN 1271, Concur in House Amendments",50,0,0,0,50
1772281,1362655,2023-12-13,Senate,"Senate Rules And Executive Nominations: Re-Reported as Committed",17,0,0,0,17
1772282,1354944,2023-09-19,Senate,"Senate Transportation: Reported as Amended",14,0,0,0,14
1772282,1354945,2023-09-19,Senate,"Senate Transportation: Adopt Amendment A01977",14,0,0,0,14
1772282,1355454,2023-10-02,Senate,"Senate Appropriations: Re-Reported as Committed",23,0,1,0,24
1772282,1355707,2023-10-04,Senate,"Senate Floor: SB 799 PN 1150, Final Passage",50,0,0,0,50
1772282,1421704,2024-04-08,House,"House Transportation: Report Bill As Amended",15,10,0,0,25
1772282,1421705,2024-04-08,House,"House Transportation: Adopt Amendment A03859",14,11,0,0,25
1772285,1345892,2023-06-21,Senate,"Senate Urban Affairs And Housing: Reported as Amended",10,1,0,0,11
1772285,1345893,2023-06-21,Senate,"Senate Urban Affairs And Housing: Adopt Amendment A01203",10,1,0,0,11
1772286,1354992,2023-09-20,Senate,"Senate Veterans Affairs And Emergency Preparedness: Reported as Committed",8,2,0,0,10
1772286,1376844,2024-02-06,Senate,"Senate Floor: SB 792 PN 919, 2023 A3452, ROBINSON Amendment No. A-3452",46,2,0,2,50
1772286,1378278,2024-02-07,Senate,"Senate Floor: SB 792 PN 1358, Final Passage",49,0,0,1,50
1772286,1378279,2024-02-07,Senate,"Senate Appropriations: Re-Reported as Committed",24,0,0,0,24
1772294,1345907,2023-06-21,Senate,"Senate Law And Justice: Reported as Committed",11,0,0,0,11
1772294,1347413,2023-06-26,Senate,"Senate Appropriations: Re-Reported as Committed",24,0,0,0,24
1772294,1347466,2023-06-26,Senate,"Senate Floor: SB 836 PN 925, Final Passage",49,0,0,1,50
1772294,1348908,2023-06-29,House,"House Judiciary: Report Bill As Committed",21,0,0,0,21
1772294,1355484,2023-10-02,House,"House Floor: SB 836 PN 925, FINAL PASSAGE",202,1,0,0,203
1772294,1355485,2023-10-02,House,"House Appropriations: Re-report Bill As Committed",37,0,0,0,37
1772296,1410915,2024-03-19,Senate,"Senate Judiciary: Reported as Committed",9,5,0,0,14
1772296,1421936,2024-04-08,Senate,"Senate Appropriations: Re-Reported as Committed",16,8,0,0,24
1772296,1423530,2024-04-09,Senate,"Senate Floor: SB 819 PN 928, Final Passage",32,18,0,0,50
1772297,1355271,2023-09-27,House,"House Health: Report Bill As Committed",25,0,0,0,25
1772301,1345962,2023-06-21,Senate,"Senate Environmental Resources And Energy: Reported as Committed",7,4,0,0,11
1772301,1411417,2024-03-19,Senate,"Senate Floor: SB 831 PN 921, 2023 A3616, YAW Amendment No. A-3616",49,0,0,1,50
1772301,1421893,2024-04-08,Senate,"Senate Floor: SB 831 PN 1434, 2023 A3729, Motion to Table MUTH Amendment No. A-3729",27,21,0,2,50
1772301,1421894,2024-04-08,Senate,"Senate Floor: SB 831 PN 1434, 2023 A3920, YAW Amendment No. A-3920",27,21,0,2,50
1772301,1421895,2024-04-08,Senate,"Senate Appropriations: Re-Reported as Committed",15,9,0,0,24
1772301,1423072,2024-04-09,Senate,"Senate Floor: SB 831 PN 1514, 2023 A3948, Motion to Table MUTH Amendment No. A-3948",28,22,0,0,50
1772301,1423073,2024-04-09,Senate,"Senate Floor: SB 831 PN 1514, Final Passage",30,20,0,0,50
1772301,1459773,2024-06-25,House,"House Consumer Protection, Technology And Utilities: Adopt Amendment A05108",25,0,0,0,25
1772301,1459774,2024-06-25,House,"House Consumer Protection, Technology And Utilities: Report Bill As Amended",25,0,0,0,25
1772301,1461368,2024-06-28,House,"House Floor: SB 831 PN 1774, 2023 A5223",197,5,0,1,203
1772301,1463036,2024-07-11,House,"House Floor: SB 831 PN 1793, FINAL PASSAGE",127,75,0,1,203
1772301,1463037,2024-07-11,Senate,"Senate Floor: SB 831 PN 1793, Concur in House Amendments",37,12,0,1,50
1772301,1463038,2024-07-11,House,"House Appropriations: Re-report Bill As Committed",37,0,0,0,37
1772301,1463039,2024-07-11,Senate,"Senate Rules And Executive Nominations: Re-Reported as Committed",16,1,0,0,17
1772302,1345793,2023-06-21,Senate,"Senate Law And Justice: Reported as Committed",10,1,0,0,11
1772304,1347676,2023-06-27,Senate,"Senate Judiciary: Reported as Committed",14,0,0,0,14
1772304,1348028,2023-06-28,Senate,"Senate Appropriations: Re-Reported as Committed",24,0,0,0,24
1772304,1348909,2023-06-29,Senate,"Senate Floor: SB 45 PN 927, Final Passage",50,0,0,0,50
1772304,1362091,2023-12-08,House,"House Judiciary: Report Bill As Committed",25,0,0,0,25
1772304,1414536,2024-03-25,House,"House Floor: SB 45 PN 927, FINAL PASSAGE",201,0,0,1,202
1772304,1414537,2024-03-25,House,"House Appropriations: Re-report Bill As Committed",37,0,0,0,37
1772306,1362449,2023-12-12,Senate,"Senate Environmental Resources And Energy: Reported as Amended",7,4,0,0,11
1772306,1362450,2023-12-12,Senate,"Senate Environmental Resources And Energy: Adopt Amendment A03299",7,4,0,0,11
1772306,1376252,2024-02-05,Senate,"Senate Appropriations: Re-Reported as Committed",15,8,1,0,24
1772306,1436678,2024-04-30,Senate,"Senate Floor: SB 832 PN 1277, 2023 A4202, Motion to Table BOSCOLA Amendment No. A-4202",28,22,0,0,50
1772306,1436679,2024-04-30,Senate,"Senate Floor: SB 832 PN 1277, 2023 A4251, PITTMAN Amendment No. A-4251",28,22,0,0,50
1772306,1437167,2024-05-01,Senate,"Senate Floor: SB 832 PN 1567, Final Passage",28,22,0,0,50
1772308,1347395,2023-06-26,Senate,"Senate Veterans Affairs And Emergency Preparedness: Reported as Amended",11,0,0,0,11
1772308,1347396,2023-06-26,Senate,"Senate Veterans Affairs And Emergency Preparedness: Adopt Amendment A01327",11,0,0,0,11
1772308,1347802,2023-06-27,Senate,"Senate Floor: SR 136 PN 966, 2023 A1499, MASTRIANO Amendment No. A-1499",49,0,0,1,50
1772308,1347803,2023-06-27,Senate,"Senate Floor: SR 136 PN 966, 2023 A1521, Motion to Table MUTH Amendment No. A-1521",27,22,0,1,50
1772308,1348107,2023-06-28,Senate,"Senate Floor: SR 136 PN 984",50,0,0,0,50
1772308,1349197,2023-06-30,House,"House Transportation: Report Bill As Committed",21,0,0,0,21
1772332,1346103,2023-06-21,House,"House Appropriations: Re-report Bill As Committed",22,15,0,0,37
1772332,1346415,2023-06-21,House,"House Rules: Re-report Bill As Committed",18,15,0,0,33
1772332,1346416,2023-06-22,House,"House Floor: HB 1461 PN 1619, MOTION TO APPEAL RULING OF THE CHAIR",102,101,0,0,203
1772332,1346417,2023-06-22,House,"House Floor: HB 1461 PN 1619, SECOND CONSIDERATION",126,77,0,0,203
1772332,1346895,2023-06-22,House,"House Appropriations: Re-report Bill As Committed",26,11,0,0,37
1772332,1347435,2023-06-26,House,"House Floor: HB 1461 PN 1619, FINAL PASSAGE",195,8,0,0,203
1772332,1347703,2023-06-27,Senate,"Senate Appropriations: Reported as Committed",24,0,0,0,24
1772332,1357501,2023-11-13,Senate,"Senate Appropriations: Re-Reported as Amended",24,0,0,0,24
1772332,1357502,2023-11-13,Senate,"Senate Appropriations: Adopt Amendment A02913",24,0,0,0,24
1772332,1357667,2023-11-15,Senate,"Senate Floor: HB 1461 PN 2288, Final Passage",45,5,0,0,50
1772332,1357730,2023-11-15,House,"House Floor: HB 1461 PN 2288, CONCURRENCE",149,54,0,0,203
1772332,1357731,2023-11-15,House,"House Rules: Re-report Bill As Committed",28,5,0,0,33
1772340,1346579,2023-06-22,House,"House Labor And Industry: Adopt Amendment",8,12,1,0,21
1772340,1346580,2023-06-22,House,"House Labor And Industry: Adopt Amendment",7,12,2,0,21
1772340,1346581,2023-06-22,House,"House Labor And Industry: Adopt Amendment",7,12,2,0,21
1772340,1346582,2023-06-22,House,"House Labor And Industry: Adopt Amendment",7,12,2,0,21
1772340,1346583,2023-06-22,House,"House Labor And Industry: Report Bill As Committed",12,9,0,0,21
1772340,1356083,2023-10-17,House,"House Rules: Re-report Bill As Committed",22,11,0,0,33
1772340,1356149,2023-10-17,House,"House Floor: HB 1449 PN 1633, 2023 A1341",69,134,0,0,203
1772340,1356150,2023-10-17,House,"House Floor: HB 1449 PN 1633, 2023 A1346",73,130,0,0,203
1772340,1356151,2023-10-17,House,"House Floor: HB 1449 PN 1633, 2023 A1414",65,138,0,0,203
1772340,1356192,2023-10-18,House,"House Appropriations: Re-report Bill As Committed",27,10,0,0,37
1772340,1356270,2023-10-18,House,"House Floor: HB 1449 PN 1633, FINAL PASSAGE",134,69,0,0,203
1772346,1390450,2024-02-21,House,"House Labor And Industry: Adopt Amendment A03443",25,0,0,0,25
1772346,1390451,2024-02-21,House,"House Labor And Industry: Report Bill As Amended",25,0,0,0,25
1772346,1414566,2024-03-25,House,"House Floor: HB 1446 PN 2726, FINAL PASSAGE",158,43,0,1,202
1772346,1414567,2024-03-25,House,"House Appropriations: Re-report Bill As Committed",37,0,0,0,37
1772346,1455906,2024-06-11,Senate,"Senate Labor And Industry: Reported as Committed",11,0,0,0,11
1772346,1462159,2024-07-02,Senate,"Senate Appropriations: Re-Reported as Committed",24,0,0,0,24
1772352,1346111,2023-06-21,House,"House Appropriations: Re-report Bill As Committed",22,15,0,0,37
1772352,1346418,2023-06-21,House,"House Rules: Re-report Bill As Committed",18,15,0,0,33
1772352,1346419,2023-06-22,House,"House Floor: HB 1459 PN 1618, MOTION TO APPEAL RULING OF THE CHAIR",102,101,0,0,203
1772352,1346420,2023-06-22,House,"House Floor: HB 1459 PN 1618, SECOND CONSIDERATION",115,88,0,0,203
1772352,1346892,2023-06-22,House,"House Appropriations: Re-report Bill As Committed",23,14,0,0,37
1772352,1347582,2023-06-26,House,"House Floor: HB 1459 PN 1618, FINAL PASSAGE",120,83,0,0,203
1772355,1348027,2023-06-28,House,"House Education: Report Bill As Committed",16,5,0,0,21
1772355,1349706,2023-07-06,House,"House Floor: HB 1448 PN 1632, 2023 A1589, MOTION TO APPEAL RULING OF THE CHAIR",102,101,0,0,203
1772355,1349707,2023-07-06,House,"House Floor: HB 1448 PN 1632, 2023 A1603",101,102,0,0,203
1772355,1349708,2023-07-06,House,"House Floor: HB 1448 PN 1632, 2023 A1606",101,102,0,0,203
1772355,1349709,2023-07-06,House,"House Floor: HB 1448 PN 1632, 2023 A1609",101,102,0,0,203
1772355,1349710,2023-07-06,House,"House Floor: HB 1448 PN 1632, 2023 A1705",102,101,0,0,203
1772355,1349711,2023-07-06,House,"House Floor: HB 1448 PN 1632, MOTION TO RECONSIDER SECOND CONSIDERATION",101,102,0,0,203
1772355,1349712,2023-07-06,House,"House Rules: Re-report Bill As Committed",18,15,0,0,33
1772355,1349863,2023-07-07,House,"House Appropriations: Re-report Bill As Committed",22,15,0,0,37
1772355,1349896,2023-07-07,House,"House Floor: HB 1448 PN 1826, FINAL PASSAGE",102,101,0,0,203
1772361,1347385,2023-06-26,House,"House Veterans Affairs And Emergency Preparedness: Report Bill As Committed",21,0,0,0,21
1772361,1348182,2023-06-28,House,"House Rules: Re-report Bill As Committed",33,0,0,0,33
1772361,1348745,2023-06-29,House,"House Floor: HB 1450 PN 1634, FINAL PASSAGE",203,0,0,0,203
1772361,1348746,2023-06-29,House,"House Appropriations: Re-report Bill As Committed",37,0,0,0,37
1772366,1346124,2023-06-21,House,"House Appropriations: Re-report Bill As Committed",22,15,0,0,37
1772366,1346432,2023-06-21,House,"House Rules: Re-report Bill As Committed",18,15,0,0,33
1772366,1346433,2023-06-22,House,"House Floor: HB 1458 PN 1617, MOTION TO APPEAL RULING OF THE CHAIR",102,101,0,0,203
1772366,1346434,2023-06-22,House,"House Floor: HB 1458 PN 1617, SECOND CONSIDERATION",113,90,0,0,203
1772366,1346896,2023-06-22,House,"House Appropriations: Re-report Bill As Committed",22,15,0,0,37
1772366,1347440,2023-06-26,House,"House Floor: HB 1458 PN 1617, FINAL PASSAGE",117,86,0,0,203
1772411,1345996,2023-06-21,House,"House Appropriations: Re-report Bill As Committed",22,15,0,0,37
1772411,1346519,2023-06-21,House,"House Rules: Re-report Bill As Committed",18,15,0,0,33
1772411,1346520,2023-06-22,House,"House Floor: HB 1456 PN 1616, MOTION TO APPEAL RULING OF THE CHAIR",102,101,0,0,203
1772411,1346521,2023-06-22,House,"House Floor: HB 1456 PN 1616, SECOND CONSIDERATION",122,81,0,0,203
1772411,1346522,2023-06-22,House,"House Appropriations: Re-report Bill As Committed",25,12,0,0,37
1772411,1355761,2023-10-04,House,"House Floor: HB 1456 PN 2108, 2023 A2447, MOTION TO SUSPEND RULES",101,102,0,0,203
1772411,1355762,2023-10-04,House,"House Floor: HB 1456 PN 2108, MOTION TO APPEAL RULING OF THE CHAIR",102,101,0,0,203
1772411,1355763,2023-10-04,House,"House Floor: HB 1456 PN 2108, CONSTITUTIONALITY",102,101,0,0,203
1772411,1355764,2023-10-04,House,"House Floor: HB 1456 PN 2108, FINAL PASSAGE",115,88,0,0,203
1772411,1355765,2023-10-04,House,"House Appropriations: Adopt Amendment A02239",22,15,0,0,37
1772411,1355766,2023-10-04,House,"House Appropriations: Re-report Bill As Amended",22,15,0,0,37
1772422,1348096,2023-06-28,House,"House Game And Fisheries: Report Bill As Committed",21,0,0,0,21
1772422,1356676,2023-10-30,House,"House Rules: Report Bill As Committed",18,15,0,0,33
1772422,1356765,2023-10-31,House,"House Appropriations: Re-report Bill As Committed",22,15,0,0,37
1772422,1357430,2023-11-13,House,"House Floor: HB 1451 PN 1635, FINAL PASSAGE",109,94,0,0,203
1772482,1426947,2024-04-15,House,"House Veterans Affairs And Emergency Preparedness: Adopt Amendment A03988",25,0,0,0,25
1772482,1426948,2024-04-15,House,"House Veterans Affairs And Emergency Preparedness: Report Bill As Amended",25,0,0,0,25
1772482,1436570,2024-04-30,House,"House Floor: HB 1463 PN 2939, FINAL PASSAGE",184,16,0,2,202
1772482,1436571,2024-04-30,House,"House Appropriations: Re-report Bill As Committed",37,0,0,0,37
1772484,1346523,2023-06-22,Senate,"Senate Judiciary: Reported as Amended",10,3,1,0,14
1772484,1346524,2023-06-22,Senate,"Senate Judiciary: Adopt Amendment A01299",12,1,1,0,14
1772484,1347710,2023-06-27,Senate,"Senate Floor: SB 838 PN 973, Final Passage",45,4,0,1,50
1772484,1347711,2023-06-27,Senate,"Senate Appropriations: Re-Reported as Committed",21,3,0,0,24
1772484,1348921,2023-06-29,House,"House Judiciary: Adopt Amendment A01672",12,9,0,0,21
1772484,1348922,2023-06-29,House,"House Judiciary: Report Bill As Amended",21,0,0,0,21
1772484,1355204,2023-09-26,House,"House Floor: SB 838 PN 993, 2023 A1722",202,0,0,0,202
1772484,1362347,2023-12-12,House,"House Appropriations: Adopt Amendment A03014",37,0,0,0,37
1772484,1362460,2023-12-12,House,"House Appropriations: Adopt Amendment A03337",22,15,0,0,37
1772484,1362461,2023-12-12,House,"House Appropriations: Re-report Bill As Amended",37,0,0,0,37
1772484,1362583,2023-12-13,House,"House Floor: SB 838 PN 1289, FINAL PASSAGE",178,25,0,0,203
1772484,1362584,2023-12-13,Senate,"Senate Floor: SB 838 PN 1289, Concur in House Amendments",48,2,0,0,50
1772484,1362585,2023-12-13,Senate,"Senate Rules And Executive Nominations: Re-Reported as Committed",16,1,0,0,17
1772490,1355505,2023-10-03,House,"House Judiciary: Report Bill As Committed",24,1,0,0,25
1772490,1355760,2023-10-04,House,"House Floor: HB 1466 PN 1650, 2023 A2281, MOTION TO APPEAL RULING OF THE CHAIR",102,101,0,0,203
1772490,1355799,2023-10-04,House,"House Appropriations: Re-report Bill As Committed",37,0,0,0,37
1772490,1355819,2023-10-05,House,"House Floor: HB 1466 PN 1650, FINAL PASSAGE",202,0,0,1,203
1772490,1461941,2024-07-01,Senate,"Senate Judiciary: Reported as Committed",14,0,0,0,14
1772490,1462239,2024-07-02,Senate,"Senate Appropriations: Re-Reported as Committed",24,0,0,0,24
1772490,1462792,2024-07-09,Senate,"Senate Floor: HB 1466 PN 3487, Final Passage",49,0,0,1,50
1772490,1462866,2024-07-10,House,"House Floor: HB 1466 PN 3487, CONCURRENCE",202,0,0,1,203
1772490,1462867,2024-07-10,House,"House Rules: Re-report Bill As Committed",33,0,0,0,33
1772502,1346644,2023-06-22,House,"House Labor And Industry: Adopt Amendment",8,12,1,0,21
1772502,1346645,2023-06-22,House,"House Labor And Industry: Adopt Amendment",8,12,1,0,21
1772502,1346646,2023-06-22,House,"House Labor And Industry: Adopt Amendment",8,12,1,0,21
1772502,1346647,2023-06-22,House,"House Labor And Industry: Adopt Amendment",8,12,1,0,21
1772502,1346648,2023-06-22,House,"House Labor And Industry: Report Bill As Committed",12,9,0,0,21
1772502,1348596,2023-06-29,House,"House Rules: Re-report Bill As Committed",18,15,0,0,33
1772502,1356161,2023-10-17,House,"House Floor: HB 1465 PN 1649, 2023 A2482",203,0,0,0,203
1772502,1356162,2023-10-17,House,"House Floor: HB 1465 PN 1649, 2023 A1344",203,0,0,0,203
1772502,1356163,2023-10-17,House,"House Floor: HB 1465 PN 1649, 2023 A1350",202,1,0,0,203
1772502,1356245,2023-10-18,House,"House Floor: HB 1465 PN 2161, FINAL PASSAGE",131,72,0,0,203
1772502,1356246,2023-10-18,House,"House Appropriations: Re-report Bill As Committed",27,10,0,0,37
1772510,1355498,2023-10-03,House,"House Judiciary: Adopt Amendment A02059",25,0,0,0,25
1772510,1355499,2023-10-03,House,"House Judiciary: Report Bill As Amended",14,11,0,0,25
1772520,1410865,2024-03-19,House,"House State Government: Report Bill As Committed",16,9,0,0,25
1772520,1427139,2024-04-15,House,"House Floor: HB 1472 PN 1658, 2023 A3810",99,102,0,1,202
1772520,1427140,2024-04-15,House,"House Floor: HB 1472 PN 1658, 2023 A3983, MOTION TO APPEAL RULING OF THE CHAIR",102,99,0,1,202
1772520,1427141,2024-04-15,House,"House Floor: HB 1472 PN 1658, 2023 A3957",99,102,0,1,202
1772520,1427142,2024-04-15,House,"House Floor: HB 1472 PN 1658, 2023 A3975",99,102,0,1,202
1772520,1427143,2024-04-15,House,"House Floor: HB 1472 PN 1658, 2023 A3974",201,0,0,1,202
1772520,1427144,2024-04-15,House,"House Floor: HB 1472 PN 1658, 2023 A3977",99,102,0,1,202
1772520,1427789,2024-04-16,House,"House Floor: HB 1472 PN 2941, FINAL PASSAGE",127,74,0,1,202
1772520,1427790,2024-04-16,House,"House Appropriations: Re-report Bill As Committed",37,0,0,0,37
1772522,1355198,2023-09-26,House,"House Environmental Resources And Energy: Report Bill As Committed",14,11,0,0,25
1772522,1356250,2023-10-18,House,"House Floor: HB 1474 PN 1660, 2023 A2302, MOTION TO APPEAL RULING OF THE CHAIR",102,101,0,0,203
1772522,1356251,2023-10-18,House,"House Floor: HB 1474 PN 1660, 2023 A2461",136,67,0,0,203
1772522,1356252,2023-10-18,House,"House Floor: HB 1474 PN 1660, 2023 A2553",102,101,0,0,203
1772522,1356253,2023-10-18,House,"House Floor: HB 1474 PN 1660, 2023 A2517",179,24,0,0,203
1772522,1356660,2023-10-30,House,"House Floor: HB 1474 PN 2174, FINAL PASSAGE",102,100,0,1,203
1772522,1356684,2023-10-30,House,"House Appropriations: Re-report Bill As Committed",23,14,0,0,37
1772539,1348156,2023-06-28,House,"House State Government: Report Bill As Committed",21,0,0,0,21
1772539,1355476,2023-10-02,House,"House Floor: HB 1479 PN 1665, 2023 A1644",101,102,0,0,203
1772539,1355477,2023-10-02,House,"House Rules: Re-report Bill As Committed",33,0,0,0,33
1772539,1355556,2023-10-03,House,"House Floor: HB 1479 PN 1665, FINAL PASSAGE",161,42,0,0,203
1772539,1355715,2023-10-03,House,"House Appropriations: Re-report Bill As Committed",37,0,0,0,37
1772540,1436064,2024-04-29,House,"House Human Services: Adopt Amendment A03864",25,0,0,0,25
1772540,1436065,2024-04-29,House,"House Human Services: Adopt Amendment A03864",25,0,0,0,25
1772544,1356237,2023-10-18,House,"House Labor And Industry: Adopt Amendment A02568",14,11,0,0,25
1772544,1356238,2023-10-18,House,"House Labor And Industry: Report Bill As Amended",14,11,0,0,25
1772544,1357694,2023-11-15,House,"House Floor: HB 1481 PN 2186, FINAL PASSAGE",106,97,0,0,203
1772544,1357695,2023-11-15,House,"House Appropriations: Re-report Bill As Committed",22,15,0,0,37
1772545,1356085,2023-10-17,House,"House Education: Report Bill As Committed",24,0,0,0,24
1772545,1356241,2023-10-18,House,"House Floor: HB 1478 PN 1664, 2023 A2569",203,0,0,0,203
1772545,1356667,2023-10-30,House,"House Floor: HB 1478 PN 2175, FINAL PASSAGE",202,0,0,1,203
1772545,1356668,2023-10-30,House,"House Appropriations: Re-report Bill As Committed",37,0,0,0,37
1772545,1362277,2023-12-11,Senate,"Senate Education: Reported as Committed",11,0,0,0,11
1772545,1362564,2023-12-13,Senate,"Senate Appropriations: Re-Reported as Committed",24,0,0,0,24
1772545,1362657,2023-12-13,Senate,"Senate Floor: HB 1478 PN 2175, Final Passage",50,0,0,0,50
1772548,1355990,2023-10-16,House,"House Environmental Resources And Energy: Adopt Amendment A02012",14,11,0,0,25
1772548,1355991,2023-10-16,House,"House Environmental Resources And Energy: Report Bill As Amended A02012",13,12,0,0,25
1772548,1362395,2023-12-12,House,"House Floor: HB 1476 PN 2129, 2023 A3081",103,100,0,0,203
1772548,1362618,2023-12-13,House,"House Floor: HB 1476 PN 2435, FINAL PASSAGE",102,101,0,0,203
1772548,1362619,2023-12-13,House,"House Appropriations: Re-report Bill As Committed",22,15,0,0,37
1772550,1356314,2023-10-18,House,"House Local Government: Report Bill As Committed",25,0,0,0,25
1772550,1357511,2023-11-14,House,"House Appropriations: Re-report Bill As Committed",37,0,0,0,37
1772550,1357640,2023-11-14,House,"House Floor: HB 1477 PN 1663, FINAL PASSAGE",203,0,0,0,203
1772550,1422935,2024-04-09,Senate,"Senate Local Government: Reported as Committed",11,0,0,0,11
1772550,1452943,2024-06-03,Senate,"Senate Appropriations: Re-Reported as Committed",24,0,0,0,24
1772550,1461928,2024-07-01,Senate,"Senate Floor: HB 1477 PN 1663, Final Passage",50,0,0,0,50
1772678,1348105,2023-06-28,House,"House State Government: Report Bill As Amended",12,9,0,0,21
1772678,1348106,2023-06-28,House,"House State Government: Adopt Amendment A01508",21,0,0,0,21
1772719,1355828,2023-10-03,House,"House Professional Licensure: Adopt Amendment A02282",25,0,0,0,25
1772719,1355829,2023-10-03,House,"House Professional Licensure: Report Bill As Amended",25,0,0,0,25
1772719,1356168,2023-10-17,House,"House Floor: HB 1490 PN 2083, 2023 A2510",110,93,0,0,203
1772719,1356169,2023-10-17,House,"House Floor: HB 1490 PN 2083, 2023 A2387",101,102,0,0,203
1772719,1356263,2023-10-18,House,"House Floor: HB 1490 PN 2162, FINAL PASSAGE",119,84,0,0,203
1772719,1356264,2023-10-18,House,"House Appropriations: Re-report Bill As Committed",37,0,0,0,37
1772719,1456694,2024-06-12,Senate,"Senate Consumer Protection And Professional Licensure: Adopt Amendment A04909",12,0,2,0,14
1772719,1456695,2024-06-12,Senate,"Senate Consumer Protection And Professional Licensure: Reported as Amended A04909",12,0,2,0,14
1772719,1459736,2024-06-25,Senate,"Senate Appropriations: Re-Reported as Committed",24,0,0,0,24
1772719,1459889,2024-06-25,Senate,"Senate Floor: HB 1490 PN 3312, Final Passage",48,2,0,0,50
1772719,1460189,2024-06-26,House,"House Floor: HB 1490 PN 3312, CONCURRENCE",119,83,0,1,203
1772719,1460190,2024-06-26,House,"House Rules: Re-report Bill As Committed",33,0,0,0,33
1772755,1347593,2023-06-27,House,"House Education: Report Bill As Committed A01427",9,12,0,0,21
1772755,1347594,2023-06-27,House,"House Education: To Table",9,12,0,0,21
1772755,1347595,2023-06-27,House,"House Education: Report Bill As Committed",12,9,0,0,21
1772755,1349548,2023-07-05,House,"House Floor: HB 1422 PN 1704, 2023 A1583",202,1,0,0,203
1772755,1349549,2023-07-05,House,"House Floor: HB 1422 PN 1704, 2023 A1604",101,102,0,0,203
1772755,1349550,2023-07-05,House,"House Floor: HB 1422 PN 1704, 2023 A1614",203,0,0,0,203
1772755,1349551,2023-07-05,House,"House Floor: HB 1422 PN 1704, 2023 A1634",101,102,0,0,203
1772755,1349552,2023-07-05,House,"House Floor: HB 1422 PN 1704, 2023 A1656",102,101,0,0,203
1772755,1349553,2023-07-05,House,"House Floor: HB 1422 PN 1704, 2023 A1697, MOTION TO SUSPEND RULES",101,102,0,0,203
1772755,1349554,2023-07-05,House,"House Rules: Re-report Bill As Committed",18,15,0,0,33
1772755,1349850,2023-07-06,House,"House Appropriations: Adopt Amendment A01787",15,22,0,0,37
1772755,1349851,2023-07-06,House,"House Appropriations: Re-report Bill As Amended",22,15,0,0,37
1772755,1349852,2023-07-06,House,"House Appropriations: Adopt Amendment A01798",37,0,0,0,37
1772755,1349878,2023-07-07,House,"House Floor: HB 1422 PN 1828, FINAL PASSAGE",122,81,0,0,203
1772963,1348100,2023-06-28,House,"House Education: Report Bill As Committed",21,0,0,0,21
1772963,1355283,2023-09-27,House,"House Floor: HB 1507 PN 1723, FINAL PASSAGE",202,0,0,0,202
1772963,1355284,2023-09-27,House,"House Appropriations: Re-report Bill As Committed",37,0,0,0,37
1772963,1356408,2023-10-24,Senate,"Senate Education: Reported as Committed",10,0,1,0,11
1772963,1362257,2023-12-11,Senate,"Senate Appropriations: Re-Reported as Committed",24,0,0,0,24
1772963,1362447,2023-12-12,Senate,"Senate Floor: HB 1507 PN 1723, Final Passage",50,0,0,0,50
1772973,1414469,2024-03-25,House,"House Insurance: Adopt Amendment A03539",25,0,0,0,25
1772973,1414470,2024-03-25,House,"House Insurance: Report Bill As Amended",25,0,0,0,25
1772973,1422712,2024-04-09,House,"House Floor: HB 1512 PN 2786, 2023 A3906",201,0,0,1,202
1772973,1424188,2024-04-10,House,"House Floor: HB 1512 PN 2883, FINAL PASSAGE",197,3,0,2,202
1772973,1424189,2024-04-10,House,"House Appropriations: Re-report Bill As Committed",37,0,0,0,37
1772978,1453597,2024-06-04,Senate,"Senate Community, Economic And Recreational Development: Reported as Committed",9,5,0,0,14
1772979,1459832,2024-06-25,Senate,"Senate Judiciary: Reported as Amended",14,0,0,0,14
1772979,1459833,2024-06-25,Senate,"Senate Judiciary: Adopt Amendment A05146",14,0,0,0,14
1772983,1452910,2024-06-03,House,"House Judiciary: Report Bill As Committed",25,0,0,0,25
1772983,1458885,2024-06-24,House,"House Appropriations: Re-report Bill As Committed",37,0,0,0,37
1772983,1459304,2024-06-24,House,"House Floor: HB 1509 PN 1725, FINAL PASSAGE",103,99,0,1,203
1772983,1459727,2024-06-24,House,"House Appropriations: Re-report Bill As Committed",37,0,0,0,37
1772983,1467885,2024-10-01,Senate,"Senate Judiciary: Reported as Amended",13,0,1,0,14
1772983,1467886,2024-10-01,Senate,"Senate Judiciary: Adopt Amendment A05685",13,0,1,0,14
1772983,1468416,2024-10-08,Senate,"Senate Floor: HB 1509 PN 3692, 2023 A5934, BAKER Amendment No. A-5934",50,0,0,0,50
1772983,1468475,2024-10-09,Senate,"Senate Appropriations: Re-Reported as Committed",24,0,0,0,24
1772983,1468571,2024-10-09,Senate,"Senate Floor: HB 1509 PN 3742, Final Passage",49,0,0,1,50
1772983,1468572,2024-10-09,Senate,"Senate Floor: HB 1509 PN 3742, Final Passage - Reconsidered",48,1,0,1,50
1772983,1468770,2024-10-21,House,"House Floor: HB 1509 PN 3742, CONCURRENCE",113,89,0,1,203
1772983,1468771,2024-10-21,House,"House Rules: Re-report Bill As Committed",33,0,0,0,33
1772990,1348265,2023-06-28,House,"House Labor And Industry: Adopt Amendment A04174",9,12,0,0,21
1772990,1348266,2023-06-28,House,"House Labor And Industry: Report Bill As Committed",12,9,0,0,21
1773055,1347675,2023-06-27,Senate,"Senate Education: Reported as Committed",11,0,0,0,11
1773055,1354878,2023-09-18,Senate,"Senate Appropriations: Re-Reported as Committed",22,0,2,0,24
1773055,1354925,2023-09-19,Senate,"Senate Floor: SB 843 PN 963, Final Passage",46,0,0,4,50
1773055,1357432,2023-11-13,House,"House Education: Report Bill As Committed",26,0,0,0,26
1773055,1357591,2023-11-14,House,"House Floor: SB 843 PN 963, 2023 A2942",203,0,0,0,203
1773055,1357702,2023-11-14,House,"House Appropriations: Re-report Bill As Amended A03012",37,0,0,0,37
1773055,1357703,2023-11-14,House,"House Appropriations: Adopt Amendment A03012",37,0,0,0,37
1773055,1357704,2023-11-15,House,"House Floor: SB 843 PN 1239, FINAL PASSAGE",114,89,0,0,203
1773055,1362504,2023-12-13,House,"House Rules: Re-report Bill As Committed",33,0,0,0,33
1773055,1362505,2023-12-13,Senate,"Senate Rules And Executive Nominations: Re-Reported as Amended",17,0,0,0,17
1773055,1362506,2023-12-13,Senate,"Senate Rules And Executive Nominations: Adopt Amendment A03343",17,0,0,0,17
1773055,1362635,2023-12-13,House,"House Floor: SB 843 PN 1290, CONCURRENCE",188,15,0,0,203
1773055,1362636,2023-12-13,Senate,"Senate Floor: SB 843 PN 1290, Concurrence in House Amendments as Amended",45,5,0,0,50
1773059,1347616,2023-06-27,Senate,"Senate Transportation: Reported as Committed",14,0,0,0,14
1773059,1354977,2023-09-20,Senate,"Senate Appropriations: Re-Reported as Committed",23,0,1,0,24
1773059,1355625,2023-10-03,Senate,"Senate Floor: SB 851 PN 960, Final Passage",48,0,0,2,50
1773059,1355738,2023-10-04,House,"House Transportation: Report Bill As Amended",25,0,0,0,25
1773059,1355739,2023-10-04,House,"House Transportation: Adopt Amendment A02427",25,0,0,0,25
1773059,1356280,2023-10-18,House,"House Floor: SB 851 PN 1158, FINAL PASSAGE",178,25,0,0,203
1773059,1356281,2023-10-18,House,"House Appropriations: Re-report Bill As Committed",37,0,0,0,37
1773059,1356382,2023-10-23,Senate,"Senate Floor: SB 851 PN 1158, Concur in House Amendments",50,0,0,0,50
1773059,1356383,2023-10-23,Senate,"Senate Rules And Executive Nominations: Re-Reported as Committed",16,1,0,0,17
1773085,1356427,2023-10-24,Senate,"Senate Health And Human Services: Reported as Amended",11,0,0,0,11
1773085,1356428,2023-10-24,Senate,"Senate Health And Human Services: Adopt Amendment A02651",11,0,0,0,11
1773088,1356805,2023-10-31,House,"House State Government: Report Bill As Committed",25,0,0,0,25
1773088,1421778,2024-04-08,House,"House Floor: HB 1518 PN 1733, 2023 A3434",200,1,0,1,202
1773088,1422714,2024-04-09,House,"House Floor: HB 1518 PN 2873, FINAL PASSAGE",201,0,0,1,202
1773088,1422715,2024-04-09,House,"House Appropriations: Re-report Bill As Committed",37,0,0,0,37
1773100,1366850,2024-01-18,House,"House Education: Report Bill As Committed",14,11,0,0,25
1773110,1348143,2023-06-28,House,"House Human Services: Report Bill As Amended",20,1,0,0,21
1773110,1349705,2023-07-06,House,"House Rules: Re-report Bill As Committed",33,0,0,0,33
1773110,1349862,2023-07-07,House,"House Appropriations: Re-report Bill As Committed",37,0,0,0,37
1773110,1349898,2023-07-07,House,"House Floor: HB 1515 PN 1718, FINAL PASSAGE",199,4,0,0,203
1773116,1357486,2023-11-14,House,"House State Government: Report Bill As Committed",24,1,0,0,25
1773116,1357754,2023-11-15,House,"House Floor: HR 161 PN 1737",201,2,0,0,203
1773122,1348205,2023-06-28,House,"House State Government: Report Bill As Committed",13,8,0,0,21
1773130,1355349,2023-10-02,House,"House Game And Fisheries: Report Bill As Amended",14,11,0,0,25
1773130,1355497,2023-10-02,House,"House Game And Fisheries: Adopt Amendment A02057",25,0,0,0,25
1773130,1355994,2023-10-16,House,"House Appropriations: Re-report Bill As Committed",37,0,0,0,37
1773130,1356072,2023-10-16,House,"House Floor: HB 1522 PN 2071, FINAL PASSAGE",103,100,0,0,203
1773140,1355247,2023-09-27,House,"House Health: Report Bill As Committed",25,0,0,0,25
1773140,1355616,2023-10-03,House,"House Floor: HR 164 PN 1752",202,1,0,0,203
1773145,1355285,2023-09-27,House,"House Aging And Older Adult Services: Adopt Amendment A02089",25,0,0,0,25
1773145,1355286,2023-09-27,House,"House Aging And Older Adult Services: Report Bill As Amended",25,0,0,0,25
1773145,1355611,2023-10-03,House,"House Floor: HB 1527 PN 2053, 2023 A2171",101,102,0,0,203
1773145,1356074,2023-10-16,House,"House Appropriations: Adopt Amendment A02499",22,15,0,0,37
1773145,1356075,2023-10-16,House,"House Appropriations: Re-report Bill As Amended",22,15,0,0,37
1773145,1356076,2023-10-16,House,"House Appropriations: Adopt Amendment A02541",15,22,0,0,37
1773145,1356155,2023-10-17,House,"House Floor: HB 1527 PN 2139, FINAL PASSAGE",203,0,0,0,203
1773160,1355240,2023-09-27,House,"House Aging And Older Adult Services: Adopt Amendment A01608",25,0,0,0,25
1773160,1355241,2023-09-27,House,"House Aging And Older Adult Services: Re-report Bill As Amended",25,0,0,0,25
1773160,1355607,2023-10-03,House,"House Floor: HR 165 PN 2054, 2023 A2220",101,102,0,0,203
1773160,1355608,2023-10-03,House,"House Floor: HR 165 PN 2054",123,80,0,0,203
1773172,1349854,2023-07-07,House,"House Floor: HR 168 PN 1755, MOTION TO SUSPEND RULES",202,1,0,0,203
1773172,1349855,2023-07-07,House,"House Floor: HR 168 PN 1755",202,1,0,0,203
1773172,1349856,2023-07-07,House,"House Rules: Report Bill As Committed",33,0,0,0,33
1773180,1458897,2024-06-24,House,"House Education: Adopt Amendment A05068",25,0,0,0,25
1773180,1458898,2024-06-24,House,"House Education: Report Bill As Amended",22,3,0,0,25
1773180,1462713,2024-07-08,House,"House Rules: Re-report Bill As Committed",33,0,0,0,33
1773180,1462778,2024-07-09,House,"House Floor: HB 1526 PN 3371, FINAL PASSAGE",168,34,0,1,203
1773180,1462779,2024-07-09,House,"House Appropriations: Re-report Bill As Committed",37,0,0,0,37
1773209,1348184,2023-06-28,House,"House Human Services: Report Bill As Amended",21,0,0,0,21
1773334,1355503,2023-10-03,House,"House Judiciary: Re-report Bill As Committed",14,11,0,0,25
1773348,1348735,2023-06-29,House,"House Veterans Affairs And Emergency Preparedness: Adopt Amendment",4,16,1,0,21
1773348,1348736,2023-06-29,House,"House Veterans Affairs And Emergency Preparedness: To Table",8,12,1,0,21
1773348,1348737,2023-06-29,House,"House Veterans Affairs And Emergency Preparedness: Report Bill As Committed",16,4,1,0,21
1773420,1355258,2023-09-27,House,"House Agriculture And Rural Affairs: Adopt Amendment A02118",21,4,0,0,25
1773420,1355259,2023-09-27,House,"House Agriculture And Rural Affairs: Adopt Amendment A01748",25,0,0,0,25
1773420,1355260,2023-09-27,House,"House Agriculture And Rural Affairs: Report Bill As Amended",21,4,0,0,25
1773420,1355604,2023-10-03,House,"House Floor: HB 1540 PN 2050, 2023 A2217, MOTION TO APPEAL RULING OF THE CHAIR",102,101,0,0,203
1773420,1355605,2023-10-03,House,"House Floor: HB 1540 PN 2050, 2023 A2218, MOTION TO APPEAL RULING OF THE CHAIR",102,101,0,0,203
1773420,1355606,2023-10-03,House,"House Floor: HB 1540 PN 2050, 2023 A2164, MOTION TO APPEAL RULING OF THE CHAIR",102,101,0,0,203
1773420,1355742,2023-10-04,House,"House Floor: HB 1540 PN 2050, FINAL PASSAGE",123,80,0,0,203
1773420,1355743,2023-10-04,House,"House Appropriations: Re-report Bill As Committed",37,0,0,0,37
1773420,1357474,2023-11-13,Senate,"Senate Agriculture And Rural Affairs: Reported as Amended A02933",11,0,0,0,11
1773420,1462722,2024-07-08,Senate,"Senate Appropriations: Re-Reported as Committed",22,0,2,0,24
1773420,1462993,2024-07-11,House,"House Floor: HB 1540 PN 3496, CONCURRENCE",138,64,0,1,203
1773420,1462994,2024-07-11,House,"House Rules: Re-report Bill As Committed",18,15,0,0,33
1773420,1463057,2024-07-11,Senate,"Senate Floor: HB 1540 PN 3496, Final Passage",49,0,0,1,50
1773427,1356741,2023-10-31,House,"House State Government: Report Bill As Committed",25,0,0,0,25
1773427,1362598,2023-12-13,House,"House Floor: HB 1538 PN 1782, 2023 A3199",202,1,0,0,203
1773427,1410297,2024-03-18,House,"House Floor: HB 1538 PN 2443, FINAL PASSAGE",102,99,0,1,202
1773427,1410298,2024-03-18,House,"House Appropriations: Re-report Bill As Committed",37,0,0,0,37
1773451,1362409,2023-12-12,House,"House State Government: Report Bill As Committed",14,11,0,0,25
1773451,1462407,2024-07-03,House,"House Floor: HR 170 PN 1789, 2023 A3599",181,21,0,1,203
1773451,1462408,2024-07-03,House,"House Floor: HR 170 PN 1789, 2023 A5399",100,102,0,1,203
1773451,1462409,2024-07-03,House,"House Floor: HR 170 PN 1789, 2023 A5400",202,0,0,1,203
1773451,1462410,2024-07-03,House,"House Floor: HR 170 PN 3488",125,77,0,1,203
1773453,1467948,2024-10-01,House,"House Veterans Affairs And Emergency Preparedness: Report Bill As Committed",17,8,0,0,25
1773462,1362428,2023-12-12,House,"House Agriculture And Rural Affairs: Report Bill As Committed",25,0,0,0,25
1773462,1411143,2024-03-19,House,"House Appropriations: Re-report Bill As Committed",37,0,0,0,37
1773462,1414895,2024-03-25,House,"House Floor: HB 1543 PN 1795, FINAL PASSAGE",201,0,0,1,202
1773462,1462704,2024-03-19,House,"House Appropriations: Re-report Bill As Committed",37,0,0,0,37
1773476,1362429,2023-12-12,House,"House Education: Adopt Amendment A03164",14,11,0,0,25
1773476,1362430,2023-12-12,House,"House Education: Report Bill As Amended",14,11,0,0,25
1773492,1355288,2023-09-27,House,"House Aging And Older Adult Services: Re-refer Bill To Another Committee",25,0,0,0,25
1773492,1366647,2024-01-18,House,"House Education: Report Bill As Committed",25,0,0,0,25
1773492,1411861,2024-03-20,House,"House Floor: HB 1553 PN 1803, 2023 A3390",201,0,0,1,202
1773492,1414827,2024-03-25,House,"House Floor: HB 1553 PN 2761, FINAL PASSAGE",201,0,0,1,202
1773492,1414828,2024-03-25,House,"House Appropriations: Re-report Bill As Committed",37,0,0,0,37
1773492,1461909,2024-07-01,Senate,"Senate Education: Reported as Committed",10,1,0,0,11
1773499,1389253,2024-02-20,House,"House Housing And Community Development: Report Bill As Amended",25,0,0,0,25
1773499,1389254,2024-02-20,House,"House Housing And Community Development: Report Bill As Amended A03461",25,0,0,0,25
1773499,1415186,2024-03-26,House,"House Appropriations: Re-report Bill As Committed",22,15,0,0,37
1773499,1415723,2024-03-26,House,"House Floor: HB 1549 PN 2724, FINAL PASSAGE",106,95,0,1,202
1773511,1362420,2023-12-12,Senate,"Senate Community, Economic And Recreational Development: Reported as Amended",13,1,0,0,14
1773511,1362421,2023-12-12,Senate,"Senate Community, Economic And Recreational Development: Adopt Amendment A03192",10,4,0,0,14
1773511,1362422,2023-12-12,Senate,"Senate Community, Economic And Recreational Development: Adopt Amendment A03206",4,10,0,0,14
1773517,1355530,2023-10-03,Senate,"Senate Judiciary: Reported as Committed",12,2,0,0,14
1773517,1356506,2023-10-25,Senate,"Senate Floor: SB 842 PN 995, Final Passage",48,2,0,0,50
1773528,1357594,2023-11-14,Senate,"Senate State Government: Reported as Committed",11,0,0,0,11
1773528,1362313,2023-12-11,Senate,"Senate Floor: SB 847 PN 999, Final Passage",48,0,0,2,50
1773549,1355263,2023-09-27,House,"House Health: Report Bill As Committed",25,0,0,0,25
1773549,1357418,2023-11-13,House,"House Floor: HR 171 PN 1813",202,1,0,0,203
1773735,1355554,2023-10-03,House,"House State Government: Report Bill As Committed",25,0,0,0,25
1773735,1356279,2023-10-18,House,"House Floor: HB 1556 PN 1817, 2023 A2542",90,113,0,0,203
1773735,1356669,2023-10-30,House,"House Floor: HB 1556 PN 1817, FINAL PASSAGE",201,1,0,1,203
1773735,1356670,2023-10-30,House,"House Appropriations: Re-report Bill As Committed",37,0,0,0,37
1773735,1357440,2023-11-13,Senate,"Senate State Government: Reported as Committed",11,0,0,0,11
1773735,1357650,2023-11-14,Senate,"Senate Appropriations: Re-Reported as Committed",24,0,0,0,24
1773735,1357666,2023-11-15,Senate,"Senate Floor: HB 1556 PN 1817, Final Passage",50,0,0,0,50
1773745,1440762,2024-05-08,Senate,"Senate Labor And Industry: Reported as Amended",10,1,0,0,11
1773745,1440763,2024-05-08,Senate,"Senate Labor And Industry: Adopt Amendment A04132",10,1,0,0,11
1773757,1356147,2023-10-16,House,"House Tourism And Economic And Recreational Development: Report Bill As Amended",25,0,0,0,25
1773757,1356148,2023-10-16,House,"House Tourism And Economic And Recreational Development: Adopt Amendment A02438",25,0,0,0,25
1773757,1356261,2023-10-18,House,"House Floor: HR 173 PN 2130",202,1,0,0,203
1773785,1356700,2023-10-30,House,"House Transportation: Report Bill As Committed",23,0,2,0,25
1773795,1453903,2024-06-05,Senate,"Senate Finance: Reported as Amended",7,4,0,0,11
1773795,1453904,2024-06-05,Senate,"Senate Finance: Adopt Amendment A04769",9,2,0,0,11
1773803,1356131,2023-10-17,Senate,"Senate Law And Justice: Reported as Committed",11,0,0,0,11
1773918,1355256,2023-09-27,House,"House Health: Adopt Amendment A02116",14,11,0,0,25
1773918,1355257,2023-09-27,House,"House Health: Report Bill As Amended",14,11,0,0,25
1773924,1362149,2023-12-11,House,"House Professional Licensure: Report Bill As Committed",25,0,0,0,25
1773924,1362372,2023-12-12,House,"House Floor: HB 1564 PN 1838, 2023 A3171",201,2,0,0,203
1773924,1362499,2023-12-13,House,"House Appropriations: Re-report Bill As Committed",37,0,0,0,37
1773924,1362630,2023-12-13,House,"House Floor: HB 1564 PN 2436, FINAL PASSAGE",152,51,0,0,203
1773924,1375594,2024-02-05,Senate,"Senate Consumer Protection And Professional Licensure: Adopt Amendment A03426",12,1,1,0,14
1773924,1375595,2024-02-05,Senate,"Senate Consumer Protection And Professional Licensure: Reported as Amended A03426",12,1,1,0,14
1773924,1378173,2024-02-07,Senate,"Senate Floor: HB 1564 PN 2568, Final Passage",44,5,0,1,50
1773924,1378174,2024-02-07,Senate,"Senate Appropriations: Re-Reported as Committed",24,0,0,0,24
1773924,1410074,2024-03-18,House,"House Rules: Re-report Bill As Committed",33,0,0,0,33
1773924,1410091,2024-03-18,House,"House Floor: HB 1564 PN 2568, CONCURRENCE",135,66,0,1,202
1773927,1356297,2023-10-18,House,"House Local Government: Adopt Amendment A02555",25,0,0,0,25
1773927,1356298,2023-10-18,House,"House Local Government: Report Bill As Amended",25,0,0,0,25
1773927,1357473,2023-11-13,House,"House Floor: HB 1567 PN 2172, 2023 A2629",203,0,0,0,203
1773927,1357605,2023-11-14,House,"House Floor: HB 1567 PN 2286, FINAL PASSAGE",203,0,0,0,203
1773927,1357606,2023-11-14,House,"House Appropriations: Re-report Bill As Committed",37,0,0,0,37
1773927,1424037,2024-04-10,Senate,"Senate Urban Affairs And Housing: Reported as Committed",11,0,0,0,11
1773927,1467356,2024-09-17,Senate,"Senate Appropriations: Re-Reported as Committed",24,0,0,0,24
1773927,1467434,2024-09-18,Senate,"Senate Floor: HB 1567 PN 2286, Final Passage",48,1,0,1,50
1774073,1453245,2024-06-04,Senate,"Senate Aging And Youth: Reported as Amended A04709",11,0,0,0,11
1774073,1460200,2024-06-26,Senate,"Senate Appropriations: Re-Reported as Committed",23,0,1,0,24
1774073,1460981,2024-06-27,Senate,"Senate Floor: SB 840 PN 1676, Final Passage",49,0,0,1,50
1774073,1468075,2024-10-02,House,"House Health: Report Bill As Committed",24,1,0,0,25
1774073,1468319,2024-10-08,House,"House Floor: SB 840 PN 1676, FINAL PASSAGE",195,6,0,2,203
1774073,1468320,2024-10-08,House,"House Appropriations: Re-report Bill As Committed",37,0,0,0,37
1774127,1467950,2024-10-01,House,"House Veterans Affairs And Emergency Preparedness: Adopt Amendment A05696",15,10,0,0,25
1774127,1467951,2024-10-01,House,"House Veterans Affairs And Emergency Preparedness: Report Bill As Amended",16,9,0,0,25
1774206,1412844,2024-03-20,House,"House Local Government: Report Bill As Amended",22,3,0,0,25
1774206,1412845,2024-03-20,House,"House Local Government: Report Bill As Amended A03629",22,3,0,0,25
1774206,1422624,2024-04-09,House,"House Floor: HB 1573 PN 2753, 2023 A3831",99,102,0,1,202
1774206,1422625,2024-04-09,House,"House Floor: HB 1573 PN 2753, 2023 A3867",201,0,0,1,202
1774206,1426944,2024-04-15,House,"House Floor: HB 1573 PN 2884, FINAL PASSAGE",102,99,0,1,202
1774206,1426945,2024-04-15,House,"House Appropriations: Re-report Bill As Committed",22,15,0,0,37
1774244,1355218,2023-09-26,House,"House Veterans Affairs And Emergency Preparedness: Report Bill As Committed",25,0,0,0,25
1774244,1355243,2023-09-27,House,"House Floor: HR 178 PN 1862",201,1,0,0,202
1774248,1355270,2023-09-27,House,"House Health: Report Bill As Committed",25,0,0,0,25
1774383,1355231,2023-09-26,House,"House Human Services: Report Bill As Committed",25,0,0,0,25
1774383,1355292,2023-09-27,House,"House Floor: HR 180 PN 1864",201,1,0,0,202
1774443,1467775,2024-09-30,House,"House Consumer Protection, Technology And Utilities: Adopt Amendment A05614",25,0,0,0,25
1774443,1467776,2024-09-30,House,"House Consumer Protection, Technology And Utilities: Report Bill As Amended",25,0,0,0,25
1774443,1468832,2024-10-22,House,"House Floor: HB 1578 PN 3678, 2023 A5973",126,76,0,1,203
1774443,1468880,2024-10-23,House,"House Floor: HB 1578 PN 3790, FINAL PASSAGE",116,86,0,1,203
1774443,1468881,2024-10-23,House,"House Appropriations: Re-report Bill As Committed",37,0,0,0,37
1774528,1356231,2023-10-18,House,"House Commerce: Adopt Amendment A02578",25,0,0,0,25
1774528,1356232,2023-10-18,House,"House Commerce: Bring Up The Bill For Consideration",25,0,0,0,25
1774528,1356233,2023-10-18,House,"House Commerce: Report Bill As Amended A02578",25,0,0,0,25
1774528,1357446,2023-11-13,House,"House Floor: HB 1580 PN 2168, FINAL PASSAGE",203,0,0,0,203
1774528,1357447,2023-11-13,House,"House Appropriations: Re-report Bill As Committed",37,0,0,0,37
1774551,1355722,2023-10-04,Senate,"Senate Local Government: Reported as Committed",11,0,0,0,11
1774551,1357479,2023-11-13,Senate,"Senate Appropriations: Re-Reported as Committed",24,0,0,0,24
1774551,1362261,2023-12-11,Senate,"Senate Floor: SB 867 PN 1017, Final Passage",48,0,0,2,50
1774551,1467637,2024-09-25,House,"House Local Government: Report Bill As Committed",25,0,0,0,25
1774551,1468891,2024-10-23,House,"House Floor: SB 867 PN 1017, FINAL PASSAGE",199,3,0,1,203
1774551,1468892,2024-10-23,House,"House Appropriations: Re-report Bill As Committed",37,0,0,0,37
1774627,1356247,2023-10-18,House,"House Health: Adopt Amendment A02589",25,0,0,0,25
1774627,1356248,2023-10-18,House,"House Health: Report Bill As Amended",25,0,0,0,25
1774627,1357717,2023-11-15,House,"House Floor: HB 1585 PN 2166, 2023 A2996",198,5,0,0,203
1774627,1357718,2023-11-15,House,"House Floor: HB 1585 PN 2166, 2023 A2999",203,0,0,0,203
1774627,1362434,2023-12-12,House,"House Floor: HB 1585 PN 2323, FINAL PASSAGE",163,40,0,0,203
1774627,1362435,2023-12-12,House,"House Appropriations: Re-report Bill As Committed",37,0,0,0,37
1774664,1356295,2023-10-18,House,"House Local Government: Report Bill As Committed",25,0,0,0,25
1775057,1355213,2023-09-26,House,"House Human Services: Re-refer Bill To Another Committee",25,0,0,0,25
1775057,1355727,2023-10-04,House,"House Children And Youth: Adopt Amendment A02340",24,0,1,0,25
1775057,1355728,2023-10-04,House,"House Children And Youth: Report Bill As Amended",14,10,1,0,25
1775057,1422999,2024-04-09,House,"House Floor: HB 1593 PN 2103, 2023 A3751",102,98,1,1,202
1775057,1423000,2024-04-09,House,"House Floor: HB 1593 PN 2103, 2023 A3825",99,102,0,1,202
1775057,1424384,2024-04-10,House,"House Floor: HB 1593 PN 2898, FINAL PASSAGE",102,98,0,2,202
1775057,1424385,2024-04-10,House,"House Appropriations: Re-report Bill As Committed",22,15,0,0,37
1775230,1415350,2024-03-26,House,"House Consumer Protection, Technology And Utilities: Adopt Amendment A03726",25,0,0,0,25
1775230,1415351,2024-03-26,House,"House Consumer Protection, Technology And Utilities: Report Bill As Amended",21,4,0,0,25
1775230,1422858,2024-04-09,House,"House Floor: HB 1598 PN 2791, 2023 A3861",201,0,0,1,202
1775230,1422859,2024-04-09,House,"House Floor: HB 1598 PN 2791, 2023 A3863",201,0,0,1,202
1775230,1424216,2024-04-10,House,"House Floor: HB 1598 PN 2899, FINAL PASSAGE",146,54,0,2,202
1775230,1424217,2024-04-10,House,"House Appropriations: Re-report Bill As Committed",37,0,0,0,37
1775404,1468817,2024-10-22,House,"House Children And Youth: Adopt Amendment A06022",14,11,0,0,25
1775404,1468818,2024-10-22,House,"House Children And Youth: Report Bill As Amended",17,8,0,0,25
1775749,1356190,2023-10-18,House,"House Judiciary: Report Bill As Committed",15,10,0,0,25
1775749,1415324,2024-03-26,House,"House Floor: HB 1601 PN 1882, 2023 A3771",101,100,0,1,202
1775749,1416329,2024-03-27,House,"House Floor: HB 1601 PN 2811, FINAL PASSAGE",102,99,0,1,202
1775749,1416330,2024-03-27,House,"House Appropriations: Re-report Bill As Committed",22,14,1,0,37
1775777,1356128,2023-10-17,Senate,"Senate Law And Justice: Reported as Committed",7,4,0,0,11
1775789,1429401,2024-04-17,House,"House Health: Report Bill As Amended",14,11,0,0,25
1775789,1429402,2024-04-17,House,"House Health: Adopt Amendment A04048",14,11,0,0,25
1775789,1437231,2024-05-01,House,"House Floor: HB 1608 PN 2972, 2023 A4259",116,85,0,1,202
1775789,1439559,2024-05-06,House,"House Floor: HB 1608 PN 3038, FINAL PASSAGE",201,0,0,1,202
1775789,1439560,2024-05-06,House,"House Appropriations: Re-report Bill As Committed",37,0,0,0,37
1775789,1467937,2024-10-01,Senate,"Senate Health And Human Services: Reported as Committed",10,0,1,0,11
1775789,1468378,2024-10-08,Senate,"Senate Rules And Executive Nominations: Re-Reported as Amended",17,0,0,0,17
1775789,1468379,2024-10-08,Senate,"Senate Rules And Executive Nominations: Adopt Amendment A05949",17,0,0,0,17
1775789,1468462,2024-10-09,Senate,"Senate Appropriations: Re-Reported as Committed",24,0,0,0,24
1775789,1468557,2024-10-09,Senate,"Senate Floor: HB 1608 PN 3740, Final Passage",49,0,0,1,50
1775789,1468757,2024-10-21,House,"House Floor: HB 1608 PN 3740, CONCURRENCE",201,1,0,1,203
1775789,1468758,2024-10-21,House,"House Rules: Re-report Bill As Committed",33,0,0,0,33
1776067,1468252,2024-10-07,House,"House Transportation: Report Bill As Committed",25,0,0,0,25
1776098,1436338,2024-04-30,House,"House Consumer Protection, Technology And Utilities: Adopt Amendment A04068",25,0,0,0,25
1776098,1436339,2024-04-30,House,"House Consumer Protection, Technology And Utilities: Report Bill As Amended",17,8,0,0,25
1776098,1439481,2024-05-06,House,"House Floor: HB 1615 PN 3016, 2023 A4355, MOTION TO SUSPEND RULES",99,102,0,1,202
1776098,1439982,2024-05-07,House,"House Appropriations: Re-report Bill As Committed",22,14,1,0,37
1776098,1440066,2024-05-07,House,"House Floor: HB 1615 PN 3016, FINAL PASSAGE",102,99,0,1,202
1776147,1356187,2023-10-18,House,"House Judiciary: Report Bill As Committed",14,11,0,0,25
1776147,1462864,2024-07-10,House,"House Floor: HB 1617 PN 1901, FINAL PASSAGE",117,85,0,1,203
1776147,1462865,2024-07-10,House,"House Appropriations: Re-report Bill As Committed",37,0,0,0,37
1776202,1357413,2023-11-13,House,"House Human Services: Report Bill As Amended",25,0,0,0,25
1776202,1357414,2023-11-13,House,"House Human Services: Adopt Amendment A02584",25,0,0,0,25
1776217,1355546,2023-10-03,House,"House Consumer Protection, Technology And Utilities: Adopt Amendment A02106",25,0,0,0,25
1776217,1355547,2023-10-03,House,"House Consumer Protection, Technology And Utilities: Report Bill As Amended",25,0,0,0,25
1776217,1356693,2023-10-30,House,"House Floor: HB 1619 PN 2086, 2023 A2625",202,0,0,1,203
1776217,1356751,2023-10-31,House,"House Floor: HB 1619 PN 2226, FINAL PASSAGE",202,0,0,1,203
1776217,1356752,2023-10-31,House,"House Appropriations: Re-report Bill As Committed",37,0,0,0,37
1776217,1461029,2024-06-27,Senate,"Senate Consumer Protection And Professional Licensure: Reported as Committed",14,0,0,0,14
1776295,1356078,2023-10-16,House,"House Environmental Resources And Energy: Report Bill As Committed",22,3,0,0,25
1776295,1357656,2023-11-14,House,"House Floor: HR 185 PN 1932, 2023 A2637",203,0,0,0,203
1776295,1357657,2023-11-14,House,"House Floor: HR 185 PN 1932, 2023 A2771",198,5,0,0,203
1776295,1357658,2023-11-14,House,"House Floor: HR 185 PN 2307",199,4,0,0,203
1776302,1401539,2024-03-04,House,"House Veterans Affairs And Emergency Preparedness: Adopt Amendment A03479",25,0,0,0,25
1776302,1401540,2024-03-04,House,"House Veterans Affairs And Emergency Preparedness: Report Bill As Amended",25,0,0,0,25
1776302,1439398,2024-05-06,House,"House Floor: HB 1626 PN 2728, 2023 A4266",200,1,0,1,202
1776302,1439399,2024-05-06,House,"House Floor: HB 1626 PN 2728, 2023 A4275",201,0,0,1,202
1776302,1440541,2024-05-07,House,"House Floor: HB 1626 PN 3057, FINAL PASSAGE",119,82,0,1,202
1776302,1440542,2024-05-07,House,"House Appropriations: Re-report Bill As Committed",36,0,1,0,37
1776382,1355261,2023-09-27,House,"House Health: Report Bill As Committed",25,0,0,0,25
1776383,1355206,2023-09-26,House,"House Human Services: Report Bill As Committed",25,0,0,0,25
1776738,1401648,2024-03-04,House,"House Veterans Affairs And Emergency Preparedness: Report Bill As Committed",23,2,0,0,25
1776738,1436096,2024-04-29,House,"House Floor: HB 1632 PN 1916, 2023 A4070",201,0,0,1,202
1776738,1440536,2024-05-07,House,"House Appropriations: Re-refer Bill To Another Committee",14,22,1,0,37
1776738,1440537,2024-05-07,House,"House Appropriations: Report Bill As Amended",22,14,1,0,37
1776738,1440538,2024-05-07,House,"House Appropriations: Adopt Amendment A04335",22,14,1,0,37
1776738,1440539,2024-05-07,House,"House Appropriations: Adopt Amendment A04270",22,14,1,0,37
1776738,1440971,2024-05-08,House,"House Floor: HB 1632 PN 3069, FINAL PASSAGE",154,46,0,2,202
1776738,1467876,2024-10-01,Senate,"Senate Labor And Industry: Reported as Committed",10,0,1,0,11
1776764,1357509,2023-11-14,House,"House Judiciary: Adopt Amendment A02932",25,0,0,0,25
1776764,1357510,2023-11-14,House,"House Judiciary: Report Bill As Amended",14,11,0,0,25
1776830,1355540,2023-10-03,House,"House State Government: Report Bill As Committed",13,12,0,0,25
1776830,1355754,2023-10-04,House,"House Floor: HB 1634 PN 1918, MOTION TO TABLE AMENDMENTS",102,101,0,0,203
1776830,1355821,2023-10-04,House,"House Appropriations: Re-report Bill As Committed",22,1,14,0,37
1776830,1355822,2023-10-05,House,"House Floor: HB 1634 PN 1918, FINAL PASSAGE",102,100,0,1,203
1776831,1416130,2024-03-27,House,"House Health: Report Bill As Amended",21,4,0,0,25
1776831,1416131,2024-03-27,House,"House Health: Adopt Amendment A03756",24,1,0,0,25
1776831,1416132,2024-03-27,House,"House Health: Adopt Amendment A03814",25,0,0,0,25
1776831,1416133,2024-03-27,House,"House Health: Adopt Amendment A03789",22,3,0,0,25
1776831,1427687,2024-04-16,House,"House Floor: HB 1633 PN 2817, 2023 A3902",124,77,0,1,202
1776831,1427688,2024-04-16,House,"House Floor: HB 1633 PN 2817, 2023 A3913",99,102,0,1,202
1776831,1429310,2024-04-17,House,"House Floor: HB 1633 PN 2959, CONSTITUTIONALITY",136,64,0,2,202
1776831,1429311,2024-04-17,House,"House Floor: HB 1633 PN 2959, FINAL PASSAGE",150,50,0,2,202
1776831,1429312,2024-04-17,House,"House Appropriations: Re-report Bill As Committed",37,0,0,0,37
1776831,1462404,2024-07-03,Senate,"Senate Health And Human Services: Reported as Amended",11,0,0,0,11
1776831,1462405,2024-07-03,Senate,"Senate Health And Human Services: Adopt Amendment A05412",11,0,0,0,11
1776831,1462968,2024-07-11,Senate,"Senate Appropriations: Re-Reported as Committed",23,0,1,0,24
1776831,1463031,2024-07-11,House,"House Floor: HB 1633 PN 3504, CONCURRENCE",155,46,1,1,203
1776831,1463032,2024-07-11,Senate,"Senate Floor: HB 1633 PN 3504, Final Passage",48,1,0,1,50
1776831,1463033,2024-07-11,House,"House Rules: Re-report Bill As Committed",18,15,0,0,33
1776933,1355721,2023-10-04,Senate,"Senate Local Government: Reported as Committed",11,0,0,0,11
1776933,1357475,2023-11-13,Senate,"Senate Appropriations: Re-Reported as Committed",24,0,0,0,24
1776933,1362338,2023-12-11,Senate,"Senate Floor: SB 887 PN 1053, Final Passage",48,0,0,2,50
1776933,1449080,2024-05-22,House,"House Local Government: Report Bill As Committed",25,0,0,0,25
1776933,1456560,2024-06-12,House,"House Appropriations: Re-report Bill As Committed",37,0,0,0,37
1776933,1456942,2024-06-12,House,"House Floor: SB 887 PN 1053, FINAL PASSAGE",201,0,0,2,203
1776971,1362748,2023-12-13,House,"House Local Government: Report Bill As Committed",25,0,0,0,25
1776972,1355462,2023-10-02,House,"House Veterans Affairs And Emergency Preparedness: Adopt Amendment A02183",25,0,0,0,25
1776972,1355463,2023-10-02,House,"House Veterans Affairs And Emergency Preparedness: Report Bill As Amended",25,0,0,0,25
1776972,1356063,2023-10-16,House,"House Floor: HR 189 PN 2072",202,1,0,0,203
1777039,1355325,2023-09-27,House,"House Health: Report Bill As Committed",25,0,0,0,25
1777065,1355217,2023-09-26,House,"House Human Services: Report Bill As Committed",25,0,0,0,25
1777065,1355300,2023-09-27,House,"House Floor: HR 193 PN 1940",201,1,0,0,202
1777086,1357689,2023-11-15,House,"House Commerce: Bring Up The Bill For Consideration",25,0,0,0,25
1777086,1357690,2023-11-15,House,"House Commerce: Adopt Amendment A02992",25,0,0,0,25
1777086,1357691,2023-11-15,House,"House Commerce: Report Bill As Amended A02992",25,0,0,0,25
1777086,1362560,2023-12-13,House,"House Floor: HB 1646 PN 2316, 2023 A3117",115,88,0,0,203
1777086,1362561,2023-12-13,House,"House Floor: HB 1646 PN 2316, 2023 A3291, MOTION TO APPEAL RULING OF THE CHAIR",102,101,0,0,203
1777086,1410446,2024-03-18,House,"House Floor: HB 1646 PN 2444, FINAL PASSAGE",199,2,0,1,202
1777086,1410447,2024-03-18,House,"House Appropriations: Re-report Bill As Committed",37,0,0,0,37
1777128,1355254,2023-09-27,House,"House Health: Report Bill As Committed",25,0,0,0,25
1777152,1355516,2023-10-03,House,"House Consumer Protection, Technology And Utilities: Adopt Amendment A02147",25,0,0,0,25
1777152,1355517,2023-10-03,House,"House Consumer Protection, Technology And Utilities: Report Bill As Amended",25,0,0,0,25
1777152,1356137,2023-10-17,House,"House Floor: HB 1658 PN 2087, FINAL PASSAGE",201,2,0,0,203
1777152,1356138,2023-10-17,House,"House Appropriations: Re-report Bill As Committed",37,0,0,0,37
1777153,1357857,2023-11-15,House,"House Health: Report Bill As Amended",13,11,1,0,25
1777153,1357858,2023-11-15,House,"House Health: Adopt Amendment A02920",22,2,1,0,25
1777153,1357859,2023-11-15,House,"House Health: Adopt Amendment A02750",24,0,1,0,25
1777153,1357860,2023-11-15,House,"House Health: Adopt Amendment A02991",13,11,1,0,25
1777271,1355520,2023-10-03,House,"House Consumer Protection, Technology And Utilities: Report Bill As Committed",25,0,0,0,25
1777319,1354502,2023-09-12,House,"House Transportation: Report Bill As Committed",24,0,0,0,24
1777319,1355301,2023-09-27,House,"House Floor: HR 197 PN 1966",171,31,0,0,202
1777319,1355865,2023-10-03,Senate,"Senate Veterans Affairs And Emergency Preparedness: Reported as Committed",11,0,0,0,11
1777319,1356651,2023-10-23,Senate,"Senate Floor: HR 197 PN 1966",50,0,0,0,50
1777339,1355704,2023-10-04,House,"House Children And Youth: Report Bill As Committed",23,1,1,0,25
1777344,1355291,2023-09-27,House,"House Agriculture And Rural Affairs: Report Bill As Committed",16,8,1,0,25
1777344,1355698,2023-10-03,House,"House Floor: HB 1661 PN 1963, 2023 A2363, MOTION TO SUSPEND RULES",203,0,0,0,203
1777344,1355699,2023-10-03,House,"House Floor: HB 1661 PN 1963, 2023 A2363",194,9,0,0,203
1777344,1355718,2023-10-04,House,"House Appropriations: Re-report Bill As Committed",37,0,0,0,37
1777344,1355779,2023-10-04,House,"House Floor: HB 1661 PN 2091, FINAL PASSAGE",169,34,0,0,203
1777344,1357423,2023-11-13,Senate,"Senate Agriculture And Rural Affairs: Reported as Committed",11,0,0,0,11
1777344,1410140,2024-03-18,Senate,"Senate Appropriations: Re-Reported as Committed",22,1,1,0,24
1777344,1436564,2024-04-30,Senate,"Senate Floor: HB 1661 PN 2091, 2023 A4198, VOGEL Amendment No. A-4198",50,0,0,0,50
1777344,1437175,2024-05-01,Senate,"Senate Floor: HB 1661 PN 3026, Final Passage",49,1,0,0,50
1777344,1439436,2024-05-06,House,"House Floor: HB 1661 PN 3026, CONCURRENCE",172,29,0,1,202
1777344,1439437,2024-05-06,House,"House Rules: Re-report Bill As Committed",33,0,0,0,33
1777389,1354503,2023-09-12,House,"House Transportation: Report Bill As Committed",24,0,0,0,24
1777395,1356391,2023-10-24,Senate,"Senate Education: Reported as Amended",6,4,1,0,11
1777395,1356392,2023-10-24,Senate,"Senate Education: Adopt Amendment A02654",6,4,1,0,11
1777395,1357752,2023-11-15,Senate,"Senate Floor: SB 907 PN 1182, 2023 A2989, REGAN Amendment No. A-2989",41,9,0,0,50
1777395,1362493,2023-12-13,Senate,"Senate Appropriations: Re-Reported as Amended",15,9,0,0,24
1777395,1362494,2023-12-13,Senate,"Senate Appropriations: Adopt Amendment A03326",15,9,0,0,24
1777395,1362624,2023-12-13,Senate,"Senate Floor: SB 907 PN 1291, Final Passage",30,19,0,1,50
1777409,1414569,2024-03-25,House,"House Insurance: Adopt Amendment A03487",25,0,0,0,25
1777409,1414570,2024-03-25,House,"House Insurance: Report Bill As Amended",25,0,0,0,25
1777409,1421832,2024-04-08,House,"House Floor: HB 1664 PN 2787, FINAL PASSAGE",201,0,0,1,202
1777409,1421833,2024-04-08,House,"House Appropriations: Re-report Bill As Committed",37,0,0,0,37
1777409,1455889,2024-06-11,Senate,"Senate Banking And Insurance: Reported as Amended",14,0,0,0,14
1777409,1455890,2024-06-11,Senate,"Senate Banking And Insurance: Adopt Amendment A04886",14,0,0,0,14
1777409,1461000,2024-06-27,Senate,"Senate Appropriations: Re-Reported as Committed",24,0,0,0,24
1777409,1462180,2024-07-02,Senate,"Senate Floor: HB 1664 PN 3392, 2023 A5225, DISANTO Amendment No. A-5225",49,1,0,0,50
1777409,1462398,2024-07-03,Senate,"Senate Floor: HB 1664 PN 3478, Final Passage",50,0,0,0,50
1777409,1462708,2024-07-08,House,"House Floor: HB 1664 PN 3478, CONCURRENCE",201,0,0,2,203
1777409,1462709,2024-07-08,House,"House Rules: Re-report Bill As Committed",33,0,0,0,33
1777425,1366662,2024-01-18,House,"House Education: Report Bill As Committed",14,11,0,0,25
1777425,1412338,2024-03-20,House,"House Floor: HB 1665 PN 1969, 2023 A3463",99,102,0,1,202
1777425,1412339,2024-03-20,House,"House Floor: HB 1665 PN 1969, 2023 A3658",103,98,0,1,202
1777425,1414507,2024-03-25,House,"House Floor: HB 1665 PN 2762, FINAL PASSAGE",102,99,0,1,202
1777425,1414508,2024-03-25,House,"House Appropriations: Re-report Bill As Committed",22,15,0,0,37
1777565,1355255,2023-09-27,House,"House Health: Report Bill As Committed",25,0,0,0,25
1777565,1355780,2023-10-04,House,"House Floor: HR 200 PN 1976",202,1,0,0,203
1777599,1355269,2023-09-27,House,"House Health: Report Bill As Committed",25,0,0,0,25
1777599,1355474,2023-10-02,House,"House Floor: HR 201 PN 1978",202,1,0,0,203
1777616,1355246,2023-09-27,House,"House Health: Report Bill As Committed",25,0,0,0,25
1777616,1355783,2023-10-04,House,"House Floor: HR 202 PN 1983",200,3,0,0,203
1777628,1355250,2023-09-27,House,"House Health: Report Bill As Committed",25,0,0,0,25
1777628,1355493,2023-10-02,House,"House Floor: HR 203 PN 1984",202,1,0,0,203
1777633,1384575,2024-02-14,House,"House Judiciary: Report Bill As Committed",24,1,0,0,25
1777633,1415748,2024-03-26,House,"House Floor: HB 1678 PN 1986, 2023 A3785",124,77,0,1,202
1777633,1416211,2024-03-27,House,"House Appropriations: Re-report Bill As Committed",24,12,1,0,37
1777633,1416574,2024-03-27,House,"House Floor: HB 1678 PN 2812, FINAL PASSAGE",152,49,0,1,202
1777863,1354942,2023-09-19,Senate,"Senate Transportation: Reported as Committed",14,0,0,0,14
1777863,1356066,2023-10-16,Senate,"Senate Appropriations: Re-Reported as Committed",22,0,2,0,24
1777863,1356114,2023-10-17,Senate,"Senate Floor: SB 897 PN 1095, Final Passage",49,0,0,1,50
1777875,1356546,2023-10-25,Senate,"Senate Consumer Protection And Professional Licensure: Reported as Committed",14,0,0,0,14
1777875,1357537,2023-11-14,Senate,"Senate Floor: SB 910 PN 1080, Final Passage",50,0,0,0,50
1777875,1357538,2023-11-14,Senate,"Senate Appropriations: Re-Reported as Committed",24,0,0,0,24
1777875,1362258,2023-12-11,House,"House Professional Licensure: Report Bill As Committed",25,0,0,0,25
1777875,1362414,2023-12-12,House,"House Floor: SB 910 PN 1080, 2023 A3241",101,102,0,0,203
1777875,1362556,2023-12-13,House,"House Floor: SB 910 PN 1080, FINAL PASSAGE",203,0,0,0,203
1777875,1362557,2023-12-13,House,"House Appropriations: Re-report Bill As Committed",37,0,0,0,37
1777879,1354941,2023-09-19,Senate,"Senate Transportation: Reported as Committed",11,3,0,0,14
1777879,1356073,2023-10-16,Senate,"Senate Appropriations: Re-Reported as Committed",21,1,2,0,24
1777879,1356195,2023-10-18,Senate,"Senate Floor: SB 934 PN 1079, Final Passage",43,5,0,2,50
1777882,1354994,2023-09-20,Senate,"Senate Veterans Affairs And Emergency Preparedness: Reported as Amended",10,0,0,0,10
1777882,1354995,2023-09-20,Senate,"Senate Veterans Affairs And Emergency Preparedness: Adopt Amendment A02022",10,0,0,0,10
1777882,1355989,2023-10-16,Senate,"Senate Appropriations: Re-Reported as Committed",22,0,2,0,24
1777882,1356194,2023-10-18,Senate,"Senate Floor: SB 933 PN 1109, Final Passage",48,0,0,2,50
1777882,1467278,2024-09-05,House,"House Veterans Affairs And Emergency Preparedness: Adopt Amendment A05567",25,0,0,0,25
1777882,1467279,2024-09-05,House,"House Veterans Affairs And Emergency Preparedness: Report Bill As Amended",25,0,0,0,25
1777895,1355210,2023-09-26,House,"House Human Services: Report Bill As Committed",25,0,0,0,25
1777895,1355281,2023-09-27,House,"House Floor: HR 205 PN 1996",201,1,0,0,202
1777907,1355274,2023-09-27,House,"House Aging And Older Adult Services: Report Bill As Committed",25,0,0,0,25
1777907,1355746,2023-10-04,House,"House Floor: HR 206 PN 1997",202,1,0,0,203
1778100,1384556,2024-02-14,House,"House Judiciary: Report Bill As Committed",14,11,0,0,25
1778102,1355267,2023-09-27,House,"House Health: Report Bill As Committed",25,0,0,0,25
1778104,1356116,2023-10-17,House,"House Education: Report Bill As Committed",24,0,0,0,24
1778105,1355569,2023-10-03,House,"House State Government: Report Bill As Committed",24,1,0,0,25
1778105,1356064,2023-10-16,House,"House Floor: HR 208 PN 1998",203,0,0,0,203
1778106,1452801,2024-06-03,House,"House Education: Adopt Amendment A04626",25,0,0,0,25
1778106,1452802,2024-06-03,House,"House Education: Report Bill As Amended",17,8,0,0,25
1778106,1462170,2024-07-02,House,"House Floor: HB 1685 PN 3214, 2023 A5215",201,0,0,2,203
1778106,1462391,2024-07-03,House,"House Floor: HB 1685 PN 3480, FINAL PASSAGE",157,45,0,1,203
1778106,1462392,2024-07-03,House,"House Appropriations: Re-report Bill As Committed",37,0,0,0,37
1778107,1362436,2023-12-12,House,"House Education: Adopt Amendment A03165",24,1,0,0,25
1778107,1362437,2023-12-12,House,"House Education: Report Bill As Amended",14,11,0,0,25
1778108,1454027,2024-06-05,House,"House Children And Youth: Re-refer Bill To Another Committee",11,14,0,0,25
1778326,1356788,2023-10-31,House,"House Judiciary: Adopt Amendment A02734",25,0,0,0,25
1778326,1356789,2023-10-31,House,"House Judiciary: Report Bill As Committed",15,10,0,0,25
1778326,1362546,2023-12-13,House,"House Floor: HB 1700 PN 2231, FINAL PASSAGE",203,0,0,0,203
1778326,1362547,2023-12-13,House,"House Appropriations: Re-report Bill As Committed",37,0,0,0,37
1778326,1461926,2024-07-01,Senate,"Senate Judiciary: Reported as Committed",14,0,0,0,14
1778326,1468530,2024-10-09,Senate,"Senate Floor: HB 1700 PN 2231, Final Passage",49,0,0,1,50
1778435,1355193,2023-09-26,House,"House Veterans Affairs And Emergency Preparedness: Report Bill As Committed",25,0,0,0,25
1778439,1355275,2023-09-27,House,"House Agriculture And Rural Affairs: Report Bill As Committed",25,0,0,0,25
1778439,1356184,2023-10-17,House,"House Floor: HR 213 PN 2013",202,1,0,0,203
1778440,1357444,2023-11-13,House,"House Human Services: Adopt Amendment",25,0,0,0,25
1778440,1357445,2023-11-13,House,"House Human Services: Report Bill As Amended",25,0,0,0,25
1778442,1355282,2023-09-27,House,"House State Government: Report Bill As Committed",24,1,0,0,25
1778442,1355480,2023-10-02,House,"House Floor: HR 212 PN 2012",202,1,0,0,203
1778446,1356764,2023-10-31,House,"House State Government: Report Bill As Committed",25,0,0,0,25
1778446,1357573,2023-11-14,House,"House Floor: HB 1706 PN 2018, 2023 A2859",101,102,0,0,203
1778446,1357574,2023-11-14,House,"House Floor: HB 1706 PN 2018, 2023 A2870",101,102,0,0,203
1778446,1357575,2023-11-14,House,"House Floor: HB 1706 PN 2018, 2023 A2935",203,0,0,0,203
1778446,1357699,2023-11-15,House,"House Floor: HB 1706 PN 2309, FINAL PASSAGE",201,2,0,0,203
1778446,1357700,2023-11-15,House,"House Appropriations: Re-report Bill As Committed",37,0,0,0,37
1778568,1355239,2023-09-27,House,"House Judiciary: Report Bill As Committed",14,11,0,0,25
1778578,1355720,2023-10-04,Senate,"Senate Local Government: Reported as Committed",11,0,0,0,11
1778578,1357468,2023-11-13,Senate,"Senate Appropriations: Re-Reported as Committed",24,0,0,0,24
1778578,1357701,2023-11-15,Senate,"Senate Floor: SB 945 PN 1111, Final Passage",50,0,0,0,50
1778578,1413288,2024-03-20,House,"House Local Government: Report Bill As Committed",25,0,0,0,25
1778578,1429237,2024-04-17,House,"House Appropriations: Re-report Bill As Committed",37,0,0,0,37
1778578,1429864,2024-04-17,House,"House Floor: SB 945 PN 1111, FINAL PASSAGE",199,0,0,3,202
1778582,1355490,2023-10-02,House,"House Veterans Affairs And Emergency Preparedness: Adopt Amendment A02145",25,0,0,0,25
1778582,1355491,2023-10-02,House,"House Veterans Affairs And Emergency Preparedness: Report Bill As Amended",25,0,0,0,25
1778582,1355774,2023-10-04,House,"House Floor: HR 217 PN 2073",202,1,0,0,203
1778583,1356244,2023-10-18,House,"House Health: Re-refer Bill To Another Committee",25,0,0,0,25
1778584,1355302,2023-09-27,House,"House Health: Report Bill As Committed",25,0,0,0,25
1778584,1356062,2023-10-16,House,"House Floor: HR 218 PN 2027",202,1,0,0,203
1778614,1355996,2023-10-16,House,"House Children And Youth: Report Bill As Committed",24,1,0,0,25
1778633,1355233,2023-09-27,House,"House Judiciary: Report Bill As Committed",25,0,0,0,25
1778683,1355236,2023-09-27,House,"House Judiciary: Report Bill As Committed",25,0,0,0,25
1778683,1356697,2023-10-30,House,"House Floor: HR 221 PN 2035",201,1,0,1,203
1778684,1356225,2023-10-18,House,"House Commerce: Bring Up The Bill For Consideration",25,0,0,0,25
1778684,1356226,2023-10-18,House,"House Commerce: Adopt Amendment A02485",25,0,0,0,25
1778684,1356227,2023-10-18,House,"House Commerce: Report Bill As Amended A02485",25,0,0,0,25
1778684,1356710,2023-10-31,House,"House Floor: HB 1716 PN 2169, 2023 A2632",100,102,0,1,203
1778684,1356711,2023-10-31,House,"House Floor: HB 1716 PN 2169, 2023 A2784",102,100,0,1,203
1778684,1357421,2023-11-13,House,"House Floor: HB 1716 PN 2230, FINAL PASSAGE",203,0,0,0,203
1778684,1357422,2023-11-13,House,"House Appropriations: Re-report Bill As Committed",37,0,0,0,37
1778684,1461944,2024-07-01,Senate,"Senate Judiciary: Reported as Committed",14,0,0,0,14
1778684,1462169,2024-07-02,Senate,"Senate Appropriations: Re-Reported as Committed",24,0,0,0,24
1778684,1462390,2024-07-03,Senate,"Senate Floor: HB 1716 PN 2230, Final Passage",50,0,0,0,50
1778701,1355511,2023-10-03,House,"House Labor And Industry: Report Bill As Committed",25,0,0,0,25
1778701,1356057,2023-10-16,House,"House Floor: HR 222 PN 2044",202,1,0,0,203
1778740,1355478,2023-10-02,House,"House Veterans Affairs And Emergency Preparedness: Adopt Amendment A02213",25,0,0,0,25
1778740,1355479,2023-10-02,House,"House Veterans Affairs And Emergency Preparedness: Report Bill As Amended",25,0,0,0,25
1778740,1356260,2023-10-18,House,"House Floor: HR 223 PN 2074",202,1,0,0,203
1778872,1356249,2023-10-18,House,"House Judiciary: Re-refer Bill To Another Committee",25,0,0,0,25
1778896,1436640,2024-04-30,Senate,"Senate State Government: Reported as Amended",10,1,0,0,11
1778896,1436641,2024-04-30,Senate,"Senate State Government: Adopt Amendment A04211",10,1,0,0,11
1778896,1436642,2024-04-30,Senate,"Senate State Government: Adopt Amendment A04090",10,1,0,0,11
1778901,1357834,2023-11-15,House,"House Local Government: Report Bill As Committed",24,1,0,0,25
1778901,1362473,2023-12-12,House,"House Floor: HR 224 PN 2061, 2023 A3201",101,102,0,0,203
1778901,1362474,2023-12-12,House,"House Floor: HR 224 PN 2061, 2023 A3202",101,102,0,0,203
1778901,1362475,2023-12-12,House,"House Floor: HR 224 PN 2061",102,101,0,0,203
1778905,1355753,2023-10-04,House,"House Judiciary: Report Bill As Committed",25,0,0,0,25
1778905,1356661,2023-10-30,House,"House Floor: HR 225 PN 2062",201,1,0,1,203
1779004,1355613,2023-10-03,Senate,"Senate Health And Human Services: Reported as Amended",11,0,0,0,11
1779004,1355614,2023-10-03,Senate,"Senate Health And Human Services: Adopt Amendment A02224",11,0,0,0,11
1779004,1356067,2023-10-16,Senate,"Senate Appropriations: Re-Reported as Committed",22,0,2,0,24
1779004,1356115,2023-10-17,Senate,"Senate Floor: SB 941 PN 1148, Final Passage",49,0,0,1,50
1779004,1357945,2023-11-15,House,"House Professional Licensure: Re-refer Bill To Another Committee",25,0,0,0,25
1779004,1362202,2023-12-11,House,"House Human Services: Report Bill As Committed",24,1,0,0,25
1779004,1362452,2023-12-12,House,"House Floor: SB 941 PN 1148, 2023 A3200",203,0,0,0,203
1779004,1362511,2023-12-13,House,"House Floor: SB 941 PN 1287, FINAL PASSAGE",202,1,0,0,203
1779004,1362512,2023-12-13,House,"House Appropriations: Re-report Bill As Committed",37,0,0,0,37
1779004,1362637,2023-12-13,Senate,"Senate Floor: SB 941 PN 1287, Concur in House Amendments",50,0,0,0,50
1779004,1362638,2023-12-13,Senate,"Senate Rules And Executive Nominations: Re-Reported as Committed",17,0,0,0,17
1779015,1356390,2023-10-24,Senate,"Senate Banking And Insurance: Reported as Committed",14,0,0,0,14
1779015,1362271,2023-12-11,Senate,"Senate Appropriations: Re-Reported as Committed",24,0,0,0,24
1779015,1362360,2023-12-12,Senate,"Senate Floor: SB 943 PN 1121, Final Passage",50,0,0,0,50
1779015,1439371,2024-05-06,House,"House Insurance: Report Bill As Committed",25,0,0,0,25
1779015,1453928,2024-06-05,House,"House Appropriations: Re-report Bill As Committed",37,0,0,0,37
1779015,1454160,2024-06-05,House,"House Floor: SB 943 PN 1121, FINAL PASSAGE",202,0,0,1,203
1779035,1356262,2023-10-18,House,"House Health: Report Bill As Committed",25,0,0,0,25
1779035,1357688,2023-11-15,House,"House Floor: HR 227 PN 2064",202,1,0,0,203
1779041,1456556,2024-06-12,House,"House Veterans Affairs And Emergency Preparedness: Report Bill As Committed",25,0,0,0,25
1779049,1356065,2023-10-16,House,"House Environmental Resources And Energy: Report Bill As Committed",14,11,0,0,25
1779179,1357809,2023-11-15,House,"House Local Government: Report Bill As Committed",25,0,0,0,25
1779179,1424240,2024-04-10,House,"House Floor: HB 1730 PN 2066, 2023 A2995",24,176,0,2,202
1779179,1426952,2024-04-15,House,"House Floor: HB 1730 PN 2066, FINAL PASSAGE",201,0,0,1,202
1779179,1426953,2024-04-15,House,"House Appropriations: Re-report Bill As Committed",37,0,0,0,37
1779179,1455921,2024-06-11,Senate,"Senate Local Government: Reported as Committed",11,0,0,0,11
1779179,1467884,2024-10-01,Senate,"Senate Appropriations: Re-Reported as Committed",23,0,1,0,24
1779179,1468551,2024-10-09,Senate,"Senate Floor: HB 1730 PN 2066, Final Passage",49,0,0,1,50
1779335,1388966,2024-02-20,House,"House Housing And Community Development: Report Bill As Committed",25,0,0,0,25
1779448,1357484,2023-11-14,Senate,"Senate Education: Reported as Amended",11,0,0,0,11
1779448,1357485,2023-11-14,Senate,"Senate Education: Adopt Amendment A02936",11,0,0,0,11
1779448,1357756,2023-11-15,Senate,"Senate Floor: SR 178 PN 1227",50,0,0,0,50
1779463,1356091,2023-10-17,House,"House State Government: Report Bill As Committed",24,1,0,0,25
1779481,1355759,2023-10-04,House,"House Finance: Report Bill As Committed",25,0,0,0,25
1779498,1457050,2024-06-12,House,"House Finance: Adopt Amendment A04915",14,11,0,0,25
1779498,1457051,2024-06-12,House,"House Finance: Report Bill As Amended",15,10,0,0,25
1779524,1357493,2023-11-13,Senate,"Senate Intergovernmental Operations: Reported as Committed",11,0,0,0,11
1779524,1362451,2023-12-12,Senate,"Senate Floor: SR 169 PN 1272",50,0,0,0,50
1779531,1356094,2023-10-17,House,"House State Government: Report Bill As Committed",24,1,0,0,25
1779531,1357491,2023-11-13,House,"House Floor: HR 233 PN 2109",202,1,0,0,203
1779545,1356269,2023-10-18,House,"House Health: Report Bill As Committed",25,0,0,0,25
1779549,1356810,2023-10-31,House,"House State Government: Report Bill As Committed",24,1,0,0,25
1779549,1357470,2023-11-13,House,"House Floor: HR 235 PN 2111",201,2,0,0,203
1779565,1362424,2023-12-12,House,"House Education: Report Bill As Committed",15,10,0,0,25
1779565,1446152,2024-05-21,House,"House Floor: HB 1743 PN 2112, 2023 A4504",102,100,0,1,203
1779565,1446153,2024-05-21,House,"House Floor: HB 1743 PN 2112, MOTION TO TABLE AMENDMENTS",102,100,0,1,203
1779565,1447718,2024-05-22,House,"House Appropriations: Re-report Bill As Committed",22,15,0,0,37
1779565,1448217,2024-05-22,House,"House Floor: HB 1743 PN 3149, FINAL PASSAGE",103,99,0,1,203
1779659,1356756,2023-10-31,House,"House Housing And Community Development: Report Bill As Amended",14,11,0,0,25
1779659,1356757,2023-10-31,House,"House Housing And Community Development: Adopt Amendment A02783",24,1,0,0,25
1779659,1356758,2023-10-31,House,"House Housing And Community Development: Adopt Amendment A02755",24,1,0,0,25
1779659,1411068,2024-03-19,House,"House Floor: HB 287 PN 2227, 2023 A2959, MOTION TO APPEAL RULING OF THE CHAIR",102,99,0,1,202
1779659,1411069,2024-03-19,House,"House Floor: HB 287 PN 2227, 2023 A3596",199,2,0,1,202
1779659,1412297,2024-03-20,House,"House Floor: HB 287 PN 2747, FINAL PASSAGE",102,99,0,1,202
1779659,1412298,2024-03-20,House,"House Appropriations: Re-report Bill As Committed",22,15,0,0,37
1779666,1357595,2023-11-14,House,"House Children And Youth: Adopt Amendment A02849",24,0,1,0,25
1779666,1357596,2023-11-14,House,"House Children And Youth: Report Bill As Amended",24,0,1,0,25
1779688,1356059,2023-10-16,House,"House Transportation: Adopt Amendment A02493",25,0,0,0,25
1779688,1356060,2023-10-16,House,"House Transportation: Report Bill As Amended",25,0,0,0,25
1779688,1356688,2023-10-30,House,"House Floor: HB 1747 PN 2128, FINAL PASSAGE",154,48,0,1,203
1779688,1356689,2023-10-30,House,"House Appropriations: Re-report Bill As Committed",37,0,0,0,37
1779690,1356701,2023-10-30,House,"House Transportation: Report Bill As Committed",23,0,2,0,25
1779791,1362351,2023-12-12,House,"House Labor And Industry: Adopt Amendment A03100",25,0,0,0,25
1779791,1362352,2023-12-12,House,"House Labor And Industry: Report Bill As Amended",20,5,0,0,25
1779791,1411209,2024-03-19,House,"House Floor: HB 1748 PN 2413, 2023 A3473",92,109,0,1,202
1779791,1411912,2024-03-20,House,"House Floor: HB 1748 PN 2413, FINAL PASSAGE",117,84,0,1,202
1779791,1411913,2024-03-20,House,"House Appropriations: Re-report Bill As Committed",37,0,0,0,37
1780049,1356221,2023-10-18,House,"House Health: Report Bill As Committed",25,0,0,0,25
1780052,1356089,2023-10-17,Senate,"Senate Judiciary: Reported as Amended",14,0,0,0,14
1780052,1356090,2023-10-17,Senate,"Senate Judiciary: Adopt Amendment A02545",14,0,0,0,14
1780052,1362487,2023-12-13,Senate,"Senate Appropriations: Re-Reported as Committed",24,0,0,0,24
1780052,1362581,2023-12-13,Senate,"Senate Floor: SB 55 PN 1169, Final Passage",50,0,0,0,50
1780052,1384461,2024-02-14,House,"House Judiciary: Report Bill As Committed",25,0,0,0,25
1780052,1414481,2024-03-25,House,"House Appropriations: Re-report Bill As Committed",37,0,0,0,37
1780052,1414921,2024-03-25,House,"House Floor: SB 55 PN 1169, FINAL PASSAGE",119,82,0,1,202
1780056,1356197,2023-10-18,House,"House Labor And Industry: Adopt Amendment A02525",11,14,0,0,25
1780056,1356198,2023-10-18,House,"House Labor And Industry: Report Bill As Amended",14,11,0,0,25
1780056,1357719,2023-11-15,House,"House Floor: HB 1751 PN 2120, 2023 A2655",92,111,0,0,203
1780056,1357720,2023-11-15,House,"House Floor: HB 1751 PN 2120, 2023 A2656",92,111,0,0,203
1780056,1357721,2023-11-15,House,"House Floor: HB 1751 PN 2120, 2023 A2658",94,109,0,0,203
1780056,1357722,2023-11-15,House,"House Floor: HB 1751 PN 2120, 2023 A2668",92,111,0,0,203
1780056,1357723,2023-11-15,House,"House Floor: HB 1751 PN 2120, 2023 A2670",92,111,0,0,203
1780056,1357724,2023-11-15,House,"House Floor: HB 1751 PN 2120, 2023 A2672",92,111,0,0,203
1780056,1357725,2023-11-15,House,"House Floor: HB 1751 PN 2120, 2023 A2864",113,90,0,0,203
1780056,1362297,2023-12-11,House,"House Floor: HB 1751 PN 2324, FINAL PASSAGE",121,82,0,0,203
1780056,1362298,2023-12-11,House,"House Appropriations: Re-report Bill As Committed",23,14,0,0,37
1780074,1356736,2023-10-31,House,"House State Government: Report Bill As Committed",21,4,0,0,25
1780074,1357748,2023-11-15,House,"House Floor: HB 1752 PN 2131, FINAL PASSAGE",134,69,0,0,203
1780074,1357749,2023-11-15,House,"House Appropriations: Re-report Bill As Committed",37,0,0,0,37
1780157,1452791,2024-06-03,House,"House Insurance: Adopt Amendment A04587",25,0,0,0,25
1780157,1452792,2024-06-03,House,"House Insurance: Report Bill As Amended",25,0,0,0,25
1780157,1455681,2024-06-10,House,"House Appropriations: Re-report Bill As Committed",37,0,0,0,37
1780157,1455694,2024-06-10,House,"House Floor: HB 1754 PN 3198, FINAL PASSAGE",200,1,0,2,203
1780157,1455919,2024-06-11,Senate,"Senate Banking And Insurance: Reported as Committed",14,0,0,0,14
1780157,1459742,2024-06-25,Senate,"Senate Appropriations: Re-Reported as Committed",24,0,0,0,24
1780157,1459927,2024-06-25,Senate,"Senate Floor: HB 1754 PN 3198, Final Passage",50,0,0,0,50
1780428,1356396,2023-10-24,Senate,"Senate Transportation: Reported as Committed",14,0,0,0,14
1780428,1357659,2023-11-14,Senate,"Senate Floor: SB 958 PN 1178, Final Passage",50,0,0,0,50
1780536,1356124,2023-10-17,House,"House Education: Report Bill As Committed",24,0,0,0,24
1780538,1356183,2023-10-18,House,"House Health: Report Bill As Committed",25,0,0,0,25
1780548,1467628,2024-09-25,House,"House Local Government: Adopt Amendment A05639",25,0,0,0,25
1780548,1467629,2024-09-25,House,"House Local Government: Report Bill As Amended",14,11,0,0,25
1780554,1356095,2023-10-17,Senate,"Senate Judiciary: Reported as Committed",10,4,0,0,14
1780554,1356423,2023-10-24,Senate,"Senate Appropriations: Re-Reported as Committed",16,8,0,0,24
1780554,1356541,2023-10-25,Senate,"Senate Floor: SB 959 PN 1168, Final Passage",30,20,0,0,50
1780558,1356718,2023-10-31,House,"House Judiciary: Report Bill As Committed",25,0,0,0,25
1780558,1357855,2023-10-30,House,"House Aging And Older Adult Services: Re-refer Bill To Another Committee",24,0,1,0,25
1780558,1362554,2023-12-13,House,"House Floor: HB 1760 PN 2144, FINAL PASSAGE",203,0,0,0,203
1780558,1362555,2023-12-13,House,"House Appropriations: Re-refer Bill To Another Committee",37,0,0,0,37
1780558,1410885,2024-03-19,Senate,"Senate Aging And Youth: Reported as Committed",10,0,1,0,11
1780558,1452948,2024-06-03,Senate,"Senate Appropriations: Re-Reported as Committed",24,0,0,0,24
1780558,1461193,2024-06-27,Senate,"Senate Floor: HB 1760 PN 2144, Final Passage",49,0,0,1,50
1780564,1362480,2023-12-12,House,"House Veterans Affairs And Emergency Preparedness: Report Bill As Committed",25,0,0,0,25
1780567,1362782,2023-12-13,House,"House Local Government: Report Bill As Committed",25,0,0,0,25
1780567,1414803,2024-03-25,House,"House Floor: HB 1762 PN 2146, FINAL PASSAGE",201,0,0,1,202
1780567,1414804,2024-03-25,House,"House Appropriations: Re-report Bill As Committed",37,0,0,0,37
1780571,1452879,2024-06-03,House,"House State Government: Adopt Amendment A04425",25,0,0,0,25
1780571,1452880,2024-06-03,House,"House State Government: Report Bill As Amended",14,11,0,0,25
1780661,1415379,2024-03-26,House,"House Children And Youth: Report Bill As Committed",13,10,2,0,25
1780671,1356675,2023-10-30,House,"House Liquor Control: Report Bill As Committed",25,0,0,0,25
1780671,1357431,2023-11-13,House,"House Floor: HB 1768 PN 2155, 2023 A2759",102,101,0,0,203
1780671,1357631,2023-11-14,House,"House Floor: HB 1768 PN 2287, FINAL PASSAGE",110,93,0,0,203
1780671,1357632,2023-11-14,House,"House Appropriations: Re-report Bill As Committed",37,0,0,0,37
1780680,1415251,2024-03-26,House,"House Children And Youth: Report Bill As Amended A03750",23,0,2,0,25
1780680,1415252,2024-03-26,House,"House Children And Youth: Report Bill As Committed",13,10,2,0,25
1780695,1356211,2023-10-17,Senate,"Senate Floor: SR 191, Resolution",49,0,0,1,50
1780702,1356212,2023-10-18,House,"House Appropriations: Adopt Amendment A02621",37,0,0,0,37
1780702,1356213,2023-10-18,House,"House Appropriations: Re-report Bill As Amended",37,0,0,0,37
1780702,1356682,2023-10-30,House,"House Floor: HB 1772 PN 2176, MOTION TO SUSPEND RULES",170,32,0,1,203
1780702,1356774,2023-10-31,House,"House Floor: HB 1772 PN 2176, FINAL PASSAGE",153,49,0,1,203
1780702,1356775,2023-10-31,House,"House Appropriations: Re-report Bill As Committed",37,0,0,0,37
1780726,1356121,2023-10-17,House,"House Floor: HR 245 PN 2160",203,0,0,0,203
1780726,1356122,2023-10-17,House,"House Rules: Report Bill As Committed",33,0,0,0,33
1780788,1356182,2023-10-17,Senate,"Senate Floor: SR 185, Resolution",49,0,0,1,50
1781009,1357504,2023-11-14,House,"House Agriculture And Rural Affairs: Report Bill As Committed",21,1,3,0,25
1781009,1362413,2023-12-12,House,"House Appropriations: Re-report Bill As Committed",37,0,0,0,37
1781009,1362471,2023-12-12,House,"House Floor: HB 1777 PN 2181, FINAL PASSAGE",155,48,0,0,203
1781143,1356795,2023-10-31,House,"House State Government: Report Bill As Committed",24,1,0,0,25
1781143,1357417,2023-11-13,House,"House Floor: HR 246 PN 2205",202,1,0,0,203
1781150,1356402,2023-10-24,Senate,"Senate Transportation: Reported as Amended",14,0,0,0,14
1781150,1356403,2023-10-24,Senate,"Senate Transportation: Adopt Amendment A02663",14,0,0,0,14
1781150,1357459,2023-11-13,Senate,"Senate Floor: SB 964 PN 1179, Final Passage",50,0,0,0,50
1781272,1436122,2024-04-29,House,"House Human Services: Report Bill As Amended",24,1,0,0,25
1781272,1436123,2024-04-29,House,"House Human Services: Report Bill As Amended",23,2,0,0,25
1781272,1456095,2024-06-11,House,"House Floor: HB 1783 PN 2997, 2023 A4929",201,0,0,2,203
1781272,1456096,2024-06-11,House,"House Floor: HB 1783 PN 2997, 2023 A4935",201,0,0,2,203
1781272,1456596,2024-06-12,House,"House Floor: HB 1783 PN 3306, FINAL PASSAGE",187,14,0,2,203
1781272,1456597,2024-06-12,House,"House Appropriations: Re-report Bill As Committed",37,0,0,0,37
1781382,1357644,2023-11-14,House,"House Children And Youth: Report Bill As Committed",23,1,1,0,25
1781466,1357578,2023-11-14,House,"House Judiciary: Report Bill As Committed",25,0,0,0,25
1781500,1357416,2023-11-13,House,"House Judiciary: Report Bill As Committed",14,11,0,0,25
1781500,1357683,2023-11-15,House,"House Appropriations: Re-report Bill As Committed",26,11,0,0,37
1781500,1357755,2023-11-15,House,"House Floor: HB 1786 PN 2196, FINAL PASSAGE",117,86,0,0,203
1781508,1356664,2023-10-30,House,"House Transportation: Report Bill As Committed",23,0,2,0,25
1781655,1356694,2023-10-30,House,"House Health: Report Bill As Committed",25,0,0,0,25
1781655,1362314,2023-12-11,House,"House Floor: HB 1795 PN 2211, FINAL PASSAGE",203,0,0,0,203
1781655,1362315,2023-12-11,House,"House Appropriations: Re-report Bill As Committed",37,0,0,0,37
1781655,1411016,2024-03-19,Senate,"Senate Health And Human Services: Reported as Committed",9,0,2,0,11
1781655,1421797,2024-04-08,Senate,"Senate Appropriations: Re-Reported as Committed",24,0,0,0,24
1781655,1423659,2024-04-09,Senate,"Senate Floor: HB 1795 PN 2211, Final Passage",50,0,0,0,50
1781727,1378254,2024-02-07,House,"House Health: Report Bill As Committed",25,0,0,0,25
1781772,1378266,2024-02-07,House,"House Health: Report Bill As Committed",25,0,0,0,25
1781772,1441047,2024-05-08,House,"House Floor: HR 251 PN 2217",199,1,0,2,202
1781853,1356652,2023-10-30,House,"House Transportation: Report Bill As Amended",23,0,2,0,25
1781853,1356653,2023-10-30,House,"House Transportation: Adopt Amendment A02777",23,0,2,0,25
1781853,1422578,2024-04-09,House,"House Floor: HB 1798 PN 2221, FINAL PASSAGE",201,0,0,1,202
1781853,1422579,2024-04-09,House,"House Appropriations: Re-report Bill As Committed",37,0,0,0,37
1781957,1412882,2024-03-20,House,"House Local Government: Report Bill As Amended",14,11,0,0,25
1781957,1412883,2024-03-20,House,"House Local Government: Adopt Amendment A03579",24,1,0,0,25
1781957,1412884,2024-03-20,House,"House Local Government: Adopt Amendment A03233",24,1,0,0,25
1781957,1424230,2024-04-10,House,"House Floor: HB 1799 PN 2754, 2023 A3925, MOTION TO APPEAL RULING OF THE CHAIR",102,98,0,2,202
1781957,1424231,2024-04-10,House,"House Floor: HB 1799 PN 2754, 2023 A3739",98,102,0,2,202
1781957,1424232,2024-04-10,House,"House Floor: HB 1799 PN 2754, 2023 A3940",198,2,0,2,202
1781957,1427123,2024-04-15,House,"House Floor: HB 1799 PN 2920, 2023 A3996",201,0,0,1,202
1781957,1427124,2024-04-15,House,"House Floor: HB 1799 PN 2943, FINAL PASSAGE",106,95,0,1,202
1781957,1427125,2024-04-15,House,"House Appropriations: Re-report Bill As Committed",22,15,0,0,37
1782023,1356753,2023-10-31,House,"House State Government: Report Bill As Committed",24,1,0,0,25
1782023,1357609,2023-11-14,House,"House Floor: HR 253 PN 2219",202,1,0,0,203
1782071,1436638,2024-04-30,House,"House Environmental Resources And Energy: Adopt Amendment A04173",14,11,0,0,25
1782071,1436639,2024-04-30,House,"House Environmental Resources And Energy: Report Bill As Amended",14,11,0,0,25
1782135,1357533,2023-11-14,Senate,"Senate Judiciary: Reported as Amended",12,2,0,0,14
1782135,1357534,2023-11-14,Senate,"Senate Judiciary: Adopt Amendment A02968",13,1,0,0,14
1782135,1421930,2024-04-08,Senate,"Senate Appropriations: Re-Reported as Committed",19,5,0,0,24
1782135,1423485,2024-04-09,Senate,"Senate Floor: SB 975 PN 1228, 2023 A3503, BROOKS Amendment No. A-3503",37,13,0,0,50
1782135,1424647,2024-04-10,Senate,"Senate Floor: SB 975 PN 1518, Final Passage",40,10,0,0,50
1782161,1456704,2024-06-12,Senate,"Senate Education: Motion to Table A04782",7,4,0,0,11
1782161,1456705,2024-06-12,Senate,"Senate Education: Reported as Amended",10,1,0,0,11
1782161,1456706,2024-06-12,Senate,"Senate Education: Adopt Amendment A04150",11,0,0,0,11
1782161,1460198,2024-06-26,Senate,"Senate Floor: SB 971 PN 1728, Final Passage",47,3,0,0,50
1782161,1460199,2024-06-26,Senate,"Senate Appropriations: Re-Reported as Committed",22,1,1,0,24
1782172,1422526,2024-04-09,Senate,"Senate Veterans Affairs And Emergency Preparedness: Reported as Amended",11,0,0,0,11
1782172,1422527,2024-04-09,Senate,"Senate Veterans Affairs And Emergency Preparedness: Adopt Amendment A03843",11,0,0,0,11
1782172,1436025,2024-04-29,Senate,"Senate Appropriations: Re-Reported as Committed",24,0,0,0,24
1782172,1439477,2024-05-06,Senate,"Senate Floor: SB 973 PN 1515, Final Passage",48,0,0,2,50
1782172,1467282,2024-09-05,House,"House Veterans Affairs And Emergency Preparedness: Report Bill As Committed",25,0,0,0,25
1782187,1384594,2024-02-14,House,"House Judiciary: Report Bill As Committed",14,11,0,0,25
1782191,1362373,2023-12-12,House,"House Education: Report Bill As Amended",25,0,0,0,25
1782191,1362374,2023-12-12,House,"House Education: Adopt Amendment A03246",25,0,0,0,25
1782191,1410921,2024-03-19,House,"House Floor: HB 1745 PN 2417, 2023 A3332",201,0,0,1,202
1782191,1410922,2024-03-19,House,"House Floor: HB 1745 PN 2417, 2023 A3494",103,98,0,1,202
1782191,1412136,2024-03-20,House,"House Floor: HB 1745 PN 2749, FINAL PASSAGE",201,0,0,1,202
1782191,1412137,2024-03-20,House,"House Appropriations: Re-report Bill As Committed",37,0,0,0,37
1782191,1454021,2024-06-05,Senate,"Senate Finance: Reported as Amended",11,0,0,0,11
1782191,1454022,2024-06-05,Senate,"Senate Finance: Adopt Amendment A04747",11,0,0,0,11
1782203,1357561,2023-11-14,House,"House Children And Youth: Report Bill As Committed",23,1,1,0,25
1782296,1357516,2023-11-14,House,"House State Government: Report Bill As Committed",24,1,0,0,25
1782311,1357793,2023-11-15,House,"House Local Government: Report Bill As Committed",14,11,0,0,25
1782375,1410818,2024-03-18,House,"House Professional Licensure: Adopt Amendment A03424",25,0,0,0,25
1782375,1410819,2024-03-18,House,"House Professional Licensure: Report Bill As Amended",25,0,0,0,25
1782375,1416213,2024-03-27,House,"House Appropriations: Re-report Bill As Committed",36,0,1,0,37
1782375,1416572,2024-03-27,House,"House Floor: HB 1819 PN 2731, FINAL PASSAGE",199,2,0,1,202
1782399,1357946,2023-11-15,House,"House Professional Licensure: Report Bill As Committed",25,0,0,0,25
1782399,1362549,2023-12-13,House,"House Floor: HB 1820 PN 2256, 2023 A3107",101,102,0,0,203
1782399,1362550,2023-12-13,House,"House Floor: HB 1820 PN 2256, 2023 A3104",101,102,0,0,203
1782399,1362551,2023-12-13,House,"House Floor: HB 1820 PN 2256, 2023 A3108",101,102,0,0,203
1782399,1362552,2023-12-13,House,"House Floor: HB 1820 PN 2256, 2023 A3109",101,102,0,0,203
1782399,1362553,2023-12-13,House,"House Floor: HB 1820 PN 2256, 2023 A3298",106,97,0,0,203
1782399,1410462,2024-03-18,House,"House Floor: HB 1820 PN 2446, FINAL PASSAGE",201,0,0,1,202
1782399,1410463,2024-03-18,House,"House Appropriations: Re-report Bill As Committed",37,0,0,0,37
1782399,1461914,2024-07-01,Senate,"Senate Consumer Protection And Professional Licensure: Reported as Committed",14,0,0,0,14
1782399,1462144,2024-07-02,Senate,"Senate Appropriations: Re-Reported as Committed",24,0,0,0,24
1782399,1468441,2024-10-08,Senate,"Senate Floor: HB 1820 PN 2446, Final Passage",49,1,0,0,50
1782466,1357732,2023-11-15,House,"House Commerce: Bring Up The Bill For Consideration",25,0,0,0,25
1782466,1357733,2023-11-15,House,"House Commerce: Report Bill As Committed",25,0,0,0,25
1782466,1410059,2024-03-18,House,"House Appropriations: Re-report Bill As Committed",37,0,0,0,37
1782466,1410395,2024-03-18,House,"House Floor: HB 1818 PN 2254, FINAL PASSAGE",201,0,0,1,202
1782466,1456614,2024-06-12,Senate,"Senate Consumer Protection And Professional Licensure: Reported as Committed",12,0,2,0,14
1782466,1459758,2024-06-25,Senate,"Senate Appropriations: Re-Reported as Committed",24,0,0,0,24
1782466,1460263,2024-06-26,Senate,"Senate Floor: HB 1818 PN 2254, Final Passage",49,1,0,0,50
1782625,1378350,2024-02-06,House,"House Tourism And Economic And Recreational Development: Report Bill As Amended",25,0,0,0,25
1782625,1378351,2024-02-06,House,"House Tourism And Economic And Recreational Development: Adopt Amendment A03092",25,0,0,0,25
1782625,1427832,2024-04-16,House,"House Floor: HR 259 PN 2720",200,1,0,1,202
1782728,1357435,2023-11-13,Senate,"Senate Agriculture And Rural Affairs: Reported as Committed",11,0,0,0,11
1782728,1362267,2023-12-11,Senate,"Senate Appropriations: Re-Reported as Committed",24,0,0,0,24
1782728,1362348,2023-12-12,Senate,"Senate Floor: SB 979 PN 1206, Final Passage",50,0,0,0,50
1782728,1391517,2024-02-22,House,"House Agriculture And Rural Affairs: Report Bill As Committed",24,1,0,0,25
1782728,1427791,2024-04-16,House,"House Floor: SB 979 PN 1206, FINAL PASSAGE",166,34,0,2,202
1782728,1427792,2024-04-16,House,"House Appropriations: Re-report Bill As Committed",37,0,0,0,37
1783075,1357505,2023-11-14,House,"House Transportation: Report Bill As Amended",25,0,0,0,25
1783075,1357506,2023-11-14,House,"House Transportation: Adopt Amendment A02937",25,0,0,0,25
1783075,1362361,2023-12-12,House,"House Appropriations: Re-report Bill As Committed",37,0,0,0,37
1783075,1362459,2023-12-12,House,"House Floor: HB 1833 PN 2301, FINAL PASSAGE",189,14,0,0,203
1783075,1468569,2024-10-09,Senate,"Senate Transportation: Reported as Amended",13,1,0,0,14
1783075,1468570,2024-10-09,Senate,"Senate Transportation: Adopt Amendment A05939",11,3,0,0,14
1783161,1362322,2023-12-12,House,"House Labor And Industry: Adopt Amendment A03155",25,0,0,0,25
1783161,1362323,2023-12-12,House,"House Labor And Industry: Report Bill As Amended",25,0,0,0,25
1783161,1422808,2024-04-09,House,"House Floor: HB 1834 PN 2414, 2023 A3942",102,99,0,1,202
1783161,1424196,2024-04-10,House,"House Floor: HB 1834 PN 2900, FINAL PASSAGE",110,90,0,2,202
1783161,1424197,2024-04-10,House,"House Appropriations: Re-report Bill As Committed",37,0,0,0,37
1783180,1362324,2023-12-12,House,"House State Government: Report Bill As Committed",24,1,0,0,25
1783180,1411494,2024-03-19,House,"House Floor: HR 260 PN 2274",200,1,0,1,202
1783188,1362442,2023-12-12,House,"House State Government: Report Bill As Committed",25,0,0,0,25
1783200,1422546,2024-04-09,House,"House State Government: Report Bill As Committed",14,11,0,0,25
1783333,1455912,2024-06-11,Senate,"Senate Health And Human Services: Reported as Committed",11,0,0,0,11
1783333,1459864,2024-06-25,Senate,"Senate Appropriations: Re-Reported as Committed",24,0,0,0,24
1783333,1460202,2024-06-26,Senate,"Senate Floor: SB 965 PN 1215, Final Passage",50,0,0,0,50
1783399,1410810,2024-03-19,House,"House Consumer Protection, Technology And Utilities: Adopt Amendment A03589",25,0,0,0,25
1783399,1410811,2024-03-19,House,"House Consumer Protection, Technology And Utilities: Adopt Amendment",25,0,0,0,25
1783399,1410812,2024-03-19,House,"House Consumer Protection, Technology And Utilities: Report Bill As Amended",25,0,0,0,25
1783399,1414539,2024-03-25,House,"House Floor: HB 1842 PN 2745, 2023 A3697",198,3,0,1,202
1783399,1414540,2024-03-25,House,"House Floor: HB 1842 PN 2745, 2023 A3711",99,102,0,1,202
1783399,1414541,2024-03-25,House,"House Floor: HB 1842 PN 2745, 2023 A3712",99,102,0,1,202
1783399,1414542,2024-03-25,House,"House Floor: HB 1842 PN 2745, 2023 A3763, MOTION TO SUSPEND RULES",99,102,0,1,202
1783399,1415282,2024-03-26,House,"House Floor: HB 1842 PN 2789, FINAL PASSAGE",111,90,0,1,202
1783399,1415283,2024-03-26,House,"House Appropriations: Re-report Bill As Committed",23,14,0,0,37
1783447,1453184,2024-06-04,Senate,"Senate Judiciary: Reported as Amended",14,0,0,0,14
1783447,1453185,2024-06-04,Senate,"Senate Judiciary: Adopt Amendment A03866",14,0,0,0,14
1783447,1456730,2024-06-12,Senate,"Senate Floor: SR 196 PN 1680",48,0,0,2,50
1783476,1362356,2023-12-12,House,"House State Government: Report Bill As Committed",14,11,0,0,25
1783476,1453174,2024-06-04,House,"House Floor: HB 1839 PN 2280, 2023 A4638",100,102,0,1,203
1783476,1453175,2024-06-04,House,"House Floor: HB 1839 PN 2280, 2023 A4639",100,102,0,1,203
1783476,1453902,2024-06-05,House,"House Appropriations: Re-report Bill As Committed",37,0,0,0,37
1783476,1454129,2024-06-05,House,"House Floor: HB 1839 PN 2280, FINAL PASSAGE",102,100,0,1,203
1783484,1456480,2024-06-11,Senate,"Senate Game And Fisheries: Reported as Committed",10,1,0,0,11
1783484,1459783,2024-06-25,Senate,"Senate Appropriations: Re-Reported as Committed",24,0,0,0,24
1783488,1362101,2023-12-08,House,"House Judiciary: Report Bill As Committed",24,1,0,0,25
1783488,1362558,2023-12-13,House,"House Floor: HB 1843 PN 2294, 2023 A3294",203,0,0,0,203
1783488,1362559,2023-12-13,House,"House Floor: HB 1843 PN 2294, 2023 A3295",101,102,0,0,203
1783488,1410082,2024-03-18,House,"House Appropriations: Re-report Bill As Committed",37,0,0,0,37
1783488,1410090,2024-03-18,House,"House Floor: HB 1843 PN 2447, FINAL PASSAGE",125,76,0,1,202
1783699,1357532,2023-11-14,Senate,"Senate Transportation: Reported as Committed",14,0,0,0,14
1783699,1362214,2023-12-11,Senate,"Senate Floor: SB 977 PN 1224, Final Passage",47,1,0,2,50
1783835,1461094,2024-06-27,House,"House Judiciary: Adopt Amendment A05231",15,10,0,0,25
1783835,1461095,2024-06-27,House,"House Judiciary: Re-report Bill As Amended",15,10,0,0,25
1783866,1362468,2023-12-12,House,"House State Government: Report Bill As Committed",24,1,0,0,25
1783866,1362548,2023-12-13,House,"House Floor: HR 267 PN 2314",202,1,0,0,203
1783917,1377755,2024-02-06,House,"House Health: Report Bill As Committed",21,0,4,0,25
1783917,1424627,2024-04-10,House,"House Floor: HB 1853 PN 2325, 2023 A3924",200,0,0,2,202
1783917,1427175,2024-04-15,House,"House Floor: HB 1853 PN 2921, FINAL PASSAGE",124,77,0,1,202
1783917,1427176,2024-04-15,House,"House Appropriations: Re-report Bill As Committed",37,0,0,0,37
1783917,1453247,2024-06-04,Senate,"Senate Aging And Youth: Reported as Committed",11,0,0,0,11
1783917,1462156,2024-07-02,Senate,"Senate Appropriations: Re-Reported as Committed",24,0,0,0,24
1783917,1463053,2024-07-11,Senate,"Senate Floor: HB 1853 PN 2921, Final Passage",47,2,0,1,50
1783951,1362365,2023-12-12,Senate,"Senate Local Government: Reported as Committed",11,0,0,0,11
1783951,1410225,2024-03-18,Senate,"Senate Floor: SB 978 PN 1234, Final Passage",48,0,0,2,50
1783951,1410226,2024-03-18,Senate,"Senate Appropriations: Re-Reported as Committed",23,0,1,0,24
1783966,1362362,2023-12-12,Senate,"Senate Local Government: Reported as Committed",11,0,0,0,11
1783966,1410257,2024-03-18,Senate,"Senate Floor: SB 982 PN 1235, Final Passage",48,0,0,2,50
1783966,1410258,2024-03-18,Senate,"Senate Appropriations: Re-Reported as Committed",23,0,1,0,24
1783966,1467627,2024-09-25,House,"House Local Government: Report Bill As Committed",25,0,0,0,25
1783983,1461180,2024-06-26,House,"House Local Government: Report Bill As Committed",25,0,0,0,25
1783983,1462705,2024-07-08,House,"House Rules: Re-report Bill As Committed",33,0,0,0,33
1783983,1462740,2024-07-09,House,"House Floor: HB 1850 PN 2318, FINAL PASSAGE",202,0,0,1,203
1783983,1462741,2024-07-09,House,"House Appropriations: Re-report Bill As Committed",37,0,0,0,37
1783983,1468738,2024-10-21,Senate,"Senate Local Government: Reported as Committed",11,0,0,0,11
1783983,1468831,2024-10-22,Senate,"Senate Appropriations: Re-Reported as Committed",24,0,0,0,24
1784023,1401691,2024-03-04,House,"House Veterans Affairs And Emergency Preparedness: Adopt Amendment A03500",25,0,0,0,25
1784023,1401692,2024-03-04,House,"House Veterans Affairs And Emergency Preparedness: Adopt Amendment A03521",25,0,0,0,25
1784023,1401693,2024-03-04,House,"House Veterans Affairs And Emergency Preparedness: Report Bill As Amended",25,0,0,0,25
1784066,1467932,2024-10-01,House,"House Game And Fisheries: Report Bill As Committed",25,0,0,0,25
1784592,1362103,2023-12-08,House,"House Judiciary: Adopt Amendment A03131",25,0,0,0,25
1784592,1362104,2023-12-08,House,"House Judiciary: Report Bill As Amended",25,0,0,0,25
1784592,1423702,2024-04-09,House,"House Floor: HR 269 PN 2394, 2023 A3911",102,99,0,1,202
1784592,1423703,2024-04-09,House,"House Floor: HR 269 PN 2394, 2023 A3824",100,101,0,1,202
1784592,1423704,2024-04-09,House,"House Floor: HR 269 PN 2394, 2023 A3832",99,102,0,1,202
1784592,1423705,2024-04-09,House,"House Floor: HR 269 PN 2882",102,99,0,1,202
1784633,1467334,2024-09-17,Senate,"Senate Banking And Insurance: Reported as Amended",8,6,0,0,14
1784633,1467335,2024-09-17,Senate,"Senate Banking And Insurance: Adopt Amendment A05606",8,6,0,0,14
1785047,1362521,2023-12-13,House,"House Finance: Re-report Bill As Committed",25,0,0,0,25
1785133,1422755,2024-04-09,House,"House Consumer Protection, Technology And Utilities: Adopt Amendment A03849",25,0,0,0,25
1785133,1422756,2024-04-09,House,"House Consumer Protection, Technology And Utilities: Report Bill As Amended",18,7,0,0,25
1785154,1422741,2024-04-09,House,"House Consumer Protection, Technology And Utilities: Adopt Amendment A03844",25,0,0,0,25
1785154,1422742,2024-04-09,House,"House Consumer Protection, Technology And Utilities: Report Bill As Amended",22,3,0,0,25
1785163,1422775,2024-04-09,House,"House Consumer Protection, Technology And Utilities: Adopt Amendment A03851",25,0,0,0,25
1785163,1422776,2024-04-09,House,"House Consumer Protection, Technology And Utilities: Report Bill As Amended",19,6,0,0,25
1785173,1422716,2024-04-09,House,"House Consumer Protection, Technology And Utilities: Adopt Amendment A03850",25,0,0,0,25
1785173,1422717,2024-04-09,House,"House Consumer Protection, Technology And Utilities: Report Bill As Amended",18,7,0,0,25
1785184,1362319,2023-12-12,House,"House Veterans Affairs And Emergency Preparedness: Report Bill As Committed",25,0,0,0,25
1785258,1439362,2024-05-06,House,"House Insurance: Adopt Amendment A04095",25,0,0,0,25
1785258,1439363,2024-05-06,House,"House Insurance: Report Bill As Amended",25,0,0,0,25
1785258,1453159,2024-06-04,House,"House Floor: HB 1867 PN 3054, FINAL PASSAGE",181,21,0,1,203
1785258,1453160,2024-06-04,House,"House Appropriations: Re-report Bill As Committed",37,0,0,0,37
1785272,1392013,2024-02-22,House,"House Agriculture And Rural Affairs: Adopt Amendment A03432",24,1,0,0,25
1785272,1392014,2024-02-22,House,"House Agriculture And Rural Affairs: Adopt Amendment A03485",25,0,0,0,25
1785272,1392015,2024-02-22,House,"House Agriculture And Rural Affairs: Report Bill As Amended",24,1,0,0,25
1785272,1415593,2024-03-26,House,"House Floor: HB 1869 PN 2727, FINAL PASSAGE",148,53,0,1,202
1785272,1415594,2024-03-26,House,"House Appropriations: Re-report Bill As Committed",28,9,0,0,37
1789425,1453960,2024-06-05,House,"House Children And Youth: To Table",11,14,0,0,25
1789425,1455970,2024-06-11,House,"House Children And Youth: Adopt Amendment A04902",15,9,1,0,25
1789425,1455971,2024-06-11,House,"House Children And Youth: Report Bill As Committed",15,9,1,0,25
1789431,1389797,2024-02-21,House,"House Labor And Industry: Report Bill As Committed",25,0,0,0,25
1789431,1412632,2024-03-20,House,"House Floor: HR 272 PN 2362, 2023 A3488",201,0,0,1,202
1789431,1412633,2024-03-20,House,"House Floor: HR 272 PN 2760",200,1,0,1,202
1789464,1362266,2023-12-11,House,"House Professional Licensure: Report Bill As Committed",25,0,0,0,25
1789464,1362416,2023-12-12,House,"House Floor: HB 1882 PN 2363, 2023 A3283, MOTION TO SUSPEND RULES",203,0,0,0,203
1789464,1362417,2023-12-12,House,"House Floor: HB 1882 PN 2363, 2023 A3283",203,0,0,0,203
1789464,1362418,2023-12-12,House,"House Floor: HB 1882 PN 2363, 2023 A3244",203,0,0,0,203
1789464,1362419,2023-12-12,House,"House Floor: HB 1882 PN 2363, 2023 A3138",203,0,0,0,203
1789464,1362538,2023-12-13,House,"House Floor: HB 1882 PN 2437, FINAL PASSAGE",197,6,0,0,203
1789464,1362539,2023-12-13,House,"House Appropriations: Re-report Bill As Committed",37,0,0,0,37
1789601,1362377,2023-12-12,House,"House State Government: Report Bill As Committed",25,0,0,0,25
1789601,1362528,2023-12-13,House,"House Floor: HB 1885 PN 2374, 2023 A3252",203,0,0,0,203
1789601,1410178,2024-03-18,House,"House Floor: HB 1885 PN 2448, FINAL PASSAGE",201,0,0,1,202
1789601,1410179,2024-03-18,House,"House Appropriations: Re-report Bill As Committed",37,0,0,0,37
1789641,1362344,2023-12-12,House,"House Education: Adopt Amendment A03168",15,10,0,0,25
1789641,1362345,2023-12-12,House,"House Education: Report Bill As Amended",14,11,0,0,25
1789651,1454032,2024-06-05,House,"House Tourism And Economic And Recreational Development: Report Bill As Committed",20,5,0,0,25
1789651,1467837,2024-09-30,House,"House Floor: HB 1891 PN 2377, 2023 A5181",119,83,0,1,203
1789651,1468864,2024-10-22,House,"House Appropriations: Re-report Bill As Committed",22,15,0,0,37
1789690,1362337,2023-12-12,House,"House Agriculture And Rural Affairs: Report Bill As Committed",25,0,0,0,25
1789690,1410897,2024-03-19,House,"House Floor: HB 1889 PN 2367, FINAL PASSAGE",201,0,0,1,202
1789690,1410898,2024-03-19,House,"House Appropriations: Re-report Bill As Committed",37,0,0,0,37
1789690,1453183,2024-06-04,Senate,"Senate Agriculture And Rural Affairs: Reported as Committed",11,0,0,0,11
1789690,1459459,2024-06-24,Senate,"Senate Appropriations: Re-Reported as Committed",24,0,0,0,24
1789690,1463003,2024-07-11,Senate,"Senate Floor: HB 1889 PN 2367, Final Passage",49,0,0,1,50
1790934,1362537,2023-12-13,House,"House Floor: HR 273 PN 2385",202,1,0,0,203
1790934,1362932,2023-12-11,House,"House Tourism And Economic And Recreational Development: Report Bill As Committed",25,0,0,0,25
1790994,1467904,2024-10-01,House,"House Game And Fisheries: Report Bill As Committed",25,0,0,0,25
1791026,1362403,2023-12-12,House,"House Veterans Affairs And Emergency Preparedness: Report Bill As Committed",25,0,0,0,25
1791026,1362510,2023-12-13,House,"House Floor: HR 275 PN 2386",202,1,0,0,203
1791039,1362404,2023-12-12,House,"House State Government: Report Bill As Committed",24,1,0,0,25
1791153,1422956,2024-04-09,Senate,"Senate Transportation: Reported as Amended",14,0,0,0,14
1791153,1422957,2024-04-09,Senate,"Senate Transportation: Adopt Amendment A03908",14,0,0,0,14
1791153,1436617,2024-04-30,Senate,"Senate Floor: SB 998 PN 1561, Final Passage",49,1,0,0,50
1791153,1452940,2024-06-03,House,"House Judiciary: Re-refer Bill To Another Committee",25,0,0,0,25
1791153,1458962,2024-06-24,House,"House Transportation: Adopt Amendment A05046",25,0,0,0,25
1791153,1458963,2024-06-24,House,"House Transportation: Report Bill As Amended",25,0,0,0,25
1791153,1458964,2024-06-24,House,"House Transportation: Adopt Amendment A05061",25,0,0,0,25
1791179,1412927,2024-03-20,House,"House Local Government: Report Bill As Amended",25,0,0,0,25
1791179,1412928,2024-03-20,House,"House Local Government: Adopt Amendment A03660",24,1,0,0,25
1791179,1427020,2024-04-15,House,"House Floor: HB 1903 PN 2755, 2023 A3960",200,1,0,1,202
1791179,1427021,2024-04-15,House,"House Floor: HB 1903 PN 2755, 2023 A3976",99,102,0,1,202
1791179,1427714,2024-04-16,House,"House Floor: HB 1903 PN 2942, FINAL PASSAGE",133,67,0,2,202
1791179,1427715,2024-04-16,House,"House Appropriations: Re-report Bill As Committed",37,0,0,0,37
1791198,1362541,2023-12-13,House,"House Finance: Re-report Bill As Committed",25,0,0,0,25
1791213,1362343,2023-12-12,House,"House Veterans Affairs And Emergency Preparedness: Report Bill As Committed",25,0,0,0,25
1791213,1362600,2023-12-13,House,"House Floor: HR 277 PN 2388",201,2,0,0,203
1791271,1378334,2024-02-06,House,"House Tourism And Economic And Recreational Development: Report Bill As Committed",25,0,0,0,25
1791271,1414701,2024-03-25,House,"House Floor: HR 281 PN 2401",200,1,0,1,202
1791288,1410880,2024-03-19,House,"House State Government: Report Bill As Committed",24,1,0,0,25
1791288,1415849,2024-03-26,House,"House Floor: HR 280 PN 2409",199,2,0,1,202
1791320,1362256,2023-12-11,House,"House Transportation: Report Bill As Committed",25,0,0,0,25
1791320,1362402,2023-12-12,House,"House Floor: HR 279 PN 2393",179,24,0,0,203
1791320,1377953,2024-02-05,Senate,"Senate Floor: HR 279 PN 2440",47,1,0,2,50
1791320,1377954,2024-02-05,Senate,"Senate Veterans Affairs And Emergency Preparedness: Reported as Committed",11,0,0,0,11
1791322,1362331,2023-12-12,House,"House State Government: Report Bill As Committed",21,4,0,0,25
1791322,1362582,2023-12-13,House,"House Floor: HR 282 PN 2402",103,100,0,0,203
1791326,1415348,2024-03-26,House,"House Transportation: Report Bill As Committed",25,0,0,0,25
1791327,1362517,2023-12-13,Senate,"Senate Consumer Protection And Professional Licensure: Reported as Committed",14,0,0,0,14
1791327,1440235,2024-05-07,Senate,"Senate Floor: SB 1017 PN 1268, 2023 A4359, Motion to Table SAVAL Amendment No. A-4359",28,22,0,0,50
1791327,1440236,2024-05-07,Senate,"Senate Floor: SB 1017 PN 1268, 2023 A4361, Motion to Table SAVAL Amendment No. A-4361",28,22,0,0,50
1791327,1440237,2024-05-07,Senate,"Senate Floor: SB 1017 PN 1268, 2023 A4358, Motion to Table KEARNEY Amendment No. A-4358",28,22,0,0,50
1791327,1440238,2024-05-07,Senate,"Senate Floor: SB 1017 PN 1268, 2023 A4360, Motion to Table KEARNEY Amendment No. A-4360",28,22,0,0,50
1791327,1440239,2024-05-07,Senate,"Senate Floor: SB 1017 PN 1268, 2023 A4363, Motion to Table KEARNEY Amendment No. A-4363",28,22,0,0,50
1791327,1440240,2024-05-07,Senate,"Senate Floor: SB 1017 PN 1268, Final Passage",42,8,0,0,50
1791327,1440241,2024-05-07,Senate,"Senate Appropriations: Re-Reported as Committed",21,3,0,0,24
1791332,1362412,2023-12-12,Senate,"Senate Transportation: Reported as Committed",14,0,0,0,14
1791332,1377164,2024-02-05,Senate,"Senate Floor: SB 1020 PN 1267, Final Passage",48,0,0,2,50
1791337,1362513,2023-12-13,Senate,"Senate Consumer Protection And Professional Licensure: Reported as Committed",14,0,0,0,14
1791395,1362396,2023-12-12,House,"House Education: Adopt Amendment A03292",25,0,0,0,25
1791395,1362397,2023-12-12,House,"House Education: Report Bill As Amended",25,0,0,0,25
1791395,1410892,2024-03-19,House,"House Floor: HB 1875 PN 2418, FINAL PASSAGE",144,57,0,1,202
1791395,1410893,2024-03-19,House,"House Appropriations: Re-report Bill As Committed",23,14,0,0,37
1791409,1362333,2023-12-12,House,"House State Government: Report Bill As Committed",24,1,0,0,25
1791409,1362602,2023-12-13,House,"House Floor: HR 283 PN 2405",202,1,0,0,203
1791510,1410881,2024-03-19,Senate,"Senate Aging And Youth: Reported as Committed",10,0,1,0,11
1791510,1421813,2024-04-08,Senate,"Senate Appropriations: Re-Reported as Committed",24,0,0,0,24
1791510,1424237,2024-04-10,Senate,"Senate Floor: SB 1018 PN 1275, Final Passage",50,0,0,0,50
1791510,1436017,2024-04-29,House,"House Judiciary: Report Bill As Committed",14,11,0,0,25
1791510,1452844,2024-06-03,House,"House Floor: SB 1018 PN 1275, FINAL PASSAGE",133,69,0,1,203
1791510,1452845,2024-06-03,House,"House Appropriations: Re-report Bill As Committed",22,15,0,0,37
1793672,1440179,2024-05-07,House,"House State Government: Report Bill As Committed",24,1,0,0,25
1793684,1375881,2024-02-05,Senate,"Senate Community, Economic And Recreational Development: Adopt Amendment",9,5,0,0,14
1793684,1375882,2024-02-05,Senate,"Senate Community, Economic And Recreational Development: Adopt Amendment A03442",9,5,0,0,14
1794050,1377551,2024-02-06,House,"House Health: Report Bill As Amended",23,2,0,0,25
1794050,1377552,2024-02-06,House,"House Health: Adopt Amendment A03415",24,1,0,0,25
1794588,1401610,2024-03-04,House,"House Veterans Affairs And Emergency Preparedness: Report Bill As Committed",25,0,0,0,25
1796173,1410866,2024-03-19,House,"House State Government: Report Bill As Committed",24,1,0,0,25
1796446,1422655,2024-04-09,House,"House Environmental Resources And Energy: Adopt Amendment A03928",14,11,0,0,25
1796446,1422656,2024-04-09,House,"House Environmental Resources And Energy: To Table",11,14,0,0,25
1796446,1422657,2024-04-09,House,"House Environmental Resources And Energy: Report Bill As Amended",14,11,0,0,25
1798819,1440583,2024-05-08,Senate,"Senate Labor And Industry: Reported as Amended",11,0,0,0,11
1798819,1440584,2024-05-08,Senate,"Senate Labor And Industry: Adopt Amendment A04405",11,0,0,0,11
1798819,1440585,2024-05-08,Senate,"Senate Labor And Industry: Adopt Amendment A04309",11,0,0,0,11
1798819,1462875,2024-07-10,Senate,"Senate Appropriations: Re-Reported as Committed",23,0,1,0,24
1798819,1463049,2024-07-11,Senate,"Senate Floor: SB 1026 PN 1592, Final Passage",44,5,0,1,50
1799684,1456601,2024-06-12,House,"House Veterans Affairs And Emergency Preparedness: Adopt Amendment A04904",25,0,0,0,25
1799684,1456602,2024-06-12,House,"House Veterans Affairs And Emergency Preparedness: Report Bill As Amended",25,0,0,0,25
1799993,1459823,2024-06-25,Senate,"Senate Consumer Protection And Professional Licensure: Reported as Committed",14,0,0,0,14
1799993,1460185,2024-06-26,Senate,"Senate Appropriations: Re-Reported as Committed",23,0,1,0,24
1799993,1461041,2024-06-27,Senate,"Senate Floor: SB 1031 PN 1317, Final Passage",49,0,0,1,50
1800026,1453095,2024-06-04,Senate,"Senate Health And Human Services: Adopt Amendment A04554",11,0,0,0,11
1800026,1453307,2024-06-04,Senate,"Senate Health And Human Services: Reported as Amended",11,0,0,0,11
1800360,1377748,2024-02-06,House,"House Health: Report Bill As Amended",25,0,0,0,25
1800360,1377749,2024-02-06,House,"House Health: Adopt Amendment A03408",25,0,0,0,25
1800360,1377750,2024-02-06,House,"House Health: Adopt Amendment A03429",25,0,0,0,25
1800360,1414629,2024-03-25,House,"House Floor: HB 1956 PN 2722, FINAL PASSAGE",201,0,0,1,202
1800360,1414630,2024-03-25,House,"House Appropriations: Re-report Bill As Committed",37,0,0,0,37
1808591,1410849,2024-03-19,Senate,"Senate Judiciary: Reported as Amended",13,1,0,0,14
1808591,1410850,2024-03-19,Senate,"Senate Judiciary: Adopt Amendment A03620",14,0,0,0,14
1818235,1458880,2024-06-24,House,"House Judiciary: Adopt Amendment A05059",25,0,0,0,25
1818235,1458881,2024-06-24,House,"House Judiciary: Re-report Bill As Amended",24,1,0,0,25
1818235,1462135,2024-07-02,House,"House Rules: Re-report Bill As Committed",33,0,0,0,33
1818235,1462196,2024-07-02,House,"House Floor: HB 1962 PN 3373, 2023 A5352",201,0,0,2,203
1818235,1462197,2024-07-02,House,"House Floor: HB 1962 PN 3373, 2023 A5373, MOTION TO TABLE AMENDMENTS",102,99,0,2,203
1818235,1462415,2024-07-03,House,"House Floor: HB 1962 PN 3481, FINAL PASSAGE",112,90,0,1,203
1818235,1462416,2024-07-03,House,"House Appropriations: Re-report Bill As Committed",22,15,0,0,37
1818916,1445433,2024-05-21,House,"House Health: Adopt Amendment A04472",25,0,0,0,25
1818916,1445434,2024-05-21,House,"House Health: Report Bill As Amended",25,0,0,0,25
1818916,1456669,2024-06-12,House,"House Floor: HB 1963 PN 3147, 2023 A4926, MOTION TO APPEAL RULING OF THE CHAIR",102,99,0,2,203
1818916,1456670,2024-06-12,House,"House Floor: HB 1963 PN 3147, 2023 A4648",201,0,0,2,203
1818916,1456671,2024-06-12,House,"House Floor: HB 1963 PN 3147, 2023 A4861",201,0,0,2,203
1818916,1458876,2024-06-24,House,"House Appropriations: Re-report Bill As Committed",37,0,0,0,37
1818916,1459274,2024-06-24,House,"House Floor: HB 1963 PN 3323, FINAL PASSAGE",202,0,0,1,203
1820748,1410905,2024-03-19,House,"House Consumer Protection, Technology And Utilities: Report Bill As Committed",25,0,0,0,25
1820748,1416443,2024-03-27,House,"House Floor: HR 289 PN 2534",200,1,0,1,202
1820847,1412745,2024-03-20,House,"House Education: Report Bill As Committed",25,0,0,0,25
1820847,1422182,2024-04-08,House,"House Floor: HR 291 PN 2536",200,1,0,1,202
1820939,1445707,2024-05-21,House,"House Transportation: Report Bill As Amended",16,9,0,0,25
1820939,1445708,2024-05-21,House,"House Transportation: Adopt Amendment A04483",25,0,0,0,25
1820939,1445709,2024-05-21,House,"House Transportation: Adopt Amendment A04503",25,0,0,0,25
1823686,1378201,2024-02-07,House,"House Health: Report Bill As Committed",25,0,0,0,25
1823686,1440036,2024-05-07,House,"House Floor: HR 292 PN 2537",200,1,0,1,202
1823901,1421787,2024-04-08,Senate,"Senate Judiciary: Reported as Amended",14,0,0,0,14
1823901,1421788,2024-04-08,Senate,"Senate Judiciary: Adopt Amendment A03916",14,0,0,0,14
1823901,1436615,2024-04-30,Senate,"Senate Floor: SB 920 PN 1512, 2023 A4255, PENNYCUICK Amendment No. A-4255",28,22,0,0,50
1823901,1440637,2024-05-07,Senate,"Senate Floor: SB 920 PN 1568, Final Passage",50,0,0,0,50
1823901,1440638,2024-05-07,Senate,"Senate Appropriations: Re-Reported as Committed",24,0,0,0,24
1823901,1456682,2024-06-12,House,"House Judiciary: Report Bill As Committed",25,0,0,0,25
1823901,1468874,2024-10-23,House,"House Floor: SB 920 PN 1568, FINAL PASSAGE",202,0,0,1,203
1823901,1468875,2024-10-23,House,"House Appropriations: Re-report Bill As Committed",37,0,0,0,37
1827215,1378183,2024-02-07,Senate,"Senate Transportation: Reported as Committed",13,0,1,0,14
1827215,1411053,2024-03-19,Senate,"Senate Floor: SB 1047 PN 1334, Final Passage",49,0,0,1,50
1827978,1388807,2024-02-20,House,"House Housing And Community Development: Re-refer Bill To Another Committee",11,0,14,0,25
1827978,1454091,2024-06-05,House,"House Local Government: Adopt Amendment A04507",11,14,0,0,25
1827978,1454092,2024-06-05,House,"House Local Government: Adopt Amendment A04701",14,11,0,0,25
1827978,1454537,2024-06-05,House,"House Local Government: Adopt Amendment A04724",14,11,0,0,25
1827978,1454538,2024-06-05,House,"House Local Government: Adopt Amendment A04726",14,11,0,0,25
1827978,1454539,2024-06-05,House,"House Local Government: Report Bill As Amended",14,11,0,0,25
1828168,1456034,2024-06-11,House,"House Consumer Protection, Technology And Utilities: Adopt Amendment A04801",25,0,0,0,25
1828168,1456035,2024-06-11,House,"House Consumer Protection, Technology And Utilities: Report Bill As Amended",25,0,0,0,25
1828168,1461361,2024-06-28,House,"House Floor: HB 1977 PN 3301, 2023 A5183",100,102,0,1,203
1828168,1461362,2024-06-28,House,"House Rules: Re-report Bill As Committed",33,0,0,0,33
1828168,1461882,2024-07-01,House,"House Floor: HB 1977 PN 3301, FINAL PASSAGE",102,100,0,1,203
1828168,1461883,2024-07-01,House,"House Appropriations: Re-report Bill As Committed",37,0,0,0,37
1828221,1378164,2024-02-06,House,"House Tourism And Economic And Recreational Development: Report Bill As Committed",25,0,0,0,25
1828221,1410902,2024-03-19,House,"House Floor: HR 295 PN 2540",200,1,0,1,202
1828426,1378229,2024-02-07,House,"House Health: Report Bill As Committed",25,0,0,0,25
1828426,1427831,2024-04-16,House,"House Floor: HR 299 PN 2544",200,1,0,1,202
1828468,1410867,2024-03-19,House,"House Consumer Protection, Technology And Utilities: Report Bill As Committed",25,0,0,0,25
1828468,1429643,2024-04-17,House,"House Floor: HR 300 PN 2545",196,4,0,2,202
1828520,1378030,2024-02-07,House,"House Health: Report Bill As Committed",25,0,0,0,25
1828520,1448213,2024-05-22,House,"House Floor: HR 297 PN 2542",201,1,0,1,203
1828570,1378251,2024-02-07,House,"House Health: Report Bill As Committed",25,0,0,0,25
1828570,1446168,2024-05-21,House,"House Floor: HR 296 PN 2541",201,1,0,1,203
1828628,1410877,2024-03-19,House,"House State Government: Report Bill As Committed",24,1,0,0,25
1829588,1453007,2024-06-03,House,"House Education: Adopt Amendment A04581",25,0,0,0,25
1829588,1453008,2024-06-03,House,"House Education: Report Bill As Amended",14,11,0,0,25
1829588,1461388,2024-06-28,House,"House Floor: HB 1990 PN 3212, 2023 A5272",202,0,0,1,203
1829588,1461922,2024-07-01,House,"House Floor: HB 1990 PN 3442, FINAL PASSAGE",178,24,0,1,203
1829588,1461923,2024-07-01,House,"House Appropriations: Re-report Bill As Committed",37,0,0,0,37
1829588,1467733,2024-09-30,Senate,"Senate Education: Reported as Committed",8,2,1,0,11
1829708,1378324,2024-02-06,House,"House Tourism And Economic And Recreational Development: Report Bill As Committed",25,0,0,0,25
1829708,1415570,2024-03-26,House,"House Floor: HR 303 PN 2548",200,1,0,1,202
1830053,1378386,2024-02-06,House,"House Tourism And Economic And Recreational Development: Report Bill As Committed",25,0,0,0,25
1830053,1410994,2024-03-19,House,"House Floor: HR 305 PN 2550",200,1,0,1,202
1830266,1412401,2024-03-20,Senate,"Senate Finance: Reported as Committed",7,4,0,0,11
1830266,1452887,2024-06-03,Senate,"Senate Appropriations: Re-Reported as Committed",15,9,0,0,24
1830266,1453308,2024-06-04,Senate,"Senate Floor: SB 1051 PN 1346, Final Passage",29,21,0,0,50
1830266,1467915,2024-10-01,House,"House Finance: Report Bill As Amended",25,0,0,0,25
1830266,1467916,2024-10-01,House,"House Finance: Report Bill As Amended",25,0,0,0,25
1830266,1468375,2024-10-08,House,"House Floor: SB 1051 PN 1924, 2023 A5856",174,27,0,2,203
1830266,1468471,2024-10-09,House,"House Floor: SB 1051 PN 1948, FINAL PASSAGE",202,0,0,1,203
1830266,1468472,2024-10-09,House,"House Appropriations: Re-report Bill As Committed",37,0,0,0,37
1830266,1468576,2024-10-09,Senate,"Senate Floor: SB 1051 PN 1948, Concur in House Amendments",47,2,0,1,50
1830266,1468577,2024-10-09,Senate,"Senate Rules And Executive Nominations: Re-Reported as Committed",16,1,0,0,17
1830498,1467868,2024-10-01,House,"House Finance: Report Bill As Amended A05771",25,0,0,0,25
1830498,1467869,2024-10-01,House,"House Finance: Report Bill As Amended",25,0,0,0,25
1830498,1468427,2024-10-08,House,"House Floor: HB 1994 PN 3691, 2023 A5857",189,12,0,2,203
1831725,1375606,2024-02-05,Senate,"Senate Veterans Affairs And Emergency Preparedness: Reported as Committed",11,0,0,0,11
1831725,1410054,2024-03-18,Senate,"Senate Appropriations: Re-Reported as Committed",23,0,1,0,24
1831725,1411001,2024-03-19,Senate,"Senate Floor: SB 1054 PN 1348, 2023 A3636, MASTRIANO Amendment No. A-3636",49,0,0,1,50
1831725,1412233,2024-03-20,Senate,"Senate Floor: SB 1054 PN 1435, Final Passage",49,0,0,1,50
1835205,1416140,2024-03-27,House,"House Health: Re-report Bill As Committed",25,0,0,0,25
1835205,1441597,2024-05-08,House,"House Floor: HR 312 PN 2565",199,1,0,2,202
1835816,1378225,2024-02-07,Senate,"Senate Transportation: Reported as Committed",13,0,1,0,14
1835816,1410046,2024-03-18,Senate,"Senate Appropriations: Re-Reported as Committed",23,0,1,0,24
1835816,1411000,2024-03-19,Senate,"Senate Floor: SB 915 PN 1350, Final Passage",49,0,0,1,50
1835816,1439361,2024-05-06,House,"House Transportation: Report Bill As Committed",25,0,0,0,25
1836701,1376086,2024-02-05,Senate,"Senate State Government: Reported as Committed",8,3,0,0,11
1836701,1378443,2024-02-07,Senate,"Senate Floor: SR 234 PN 1354, 2023 A3447, Motion to Table BOSCOLA Amendment No. A-3447",27,22,0,1,50
1836701,1378444,2024-02-07,Senate,"Senate Floor: SR 234 PN 1354, 2023 A-3449, Motion to Table SCHWANK Amendment No. A-3449",27,22,0,1,50
1836701,1378445,2024-02-07,Senate,"Senate Floor: SR 234 PN 1354",28,21,0,1,50
1836775,1375646,2024-02-05,Senate,"Senate Environmental Resources And Energy: Reported as Committed",7,4,0,0,11
1836775,1467367,2024-09-17,Senate,"Senate Floor: SB 1058 PN 1355, Final Passage",27,22,0,1,50
1836775,1467368,2024-09-17,Senate,"Senate Appropriations: Re-Reported as Committed",15,9,0,0,24
1837166,1429421,2024-04-17,House,"House Judiciary: Adopt Amendment A04012",14,11,0,0,25
1837166,1429422,2024-04-17,House,"House Judiciary: To Table",11,14,0,0,25
1837166,1429423,2024-04-17,House,"House Judiciary: Report Bill As Amended",14,11,0,0,25
1837166,1461891,2024-07-01,House,"House Floor: HB 2012 PN 2971, 2023 A5238",102,100,0,1,203
1837166,1461892,2024-07-01,House,"House Floor: HB 2012 PN 2971, 2023 A5332",93,109,0,1,203
1837166,1461893,2024-07-01,House,"House Floor: HB 2012 PN 2971, 2023 A5333",96,106,0,1,203
1837166,1462134,2024-07-02,House,"House Appropriations: Re-report Bill As Committed",37,0,0,0,37
1837166,1462184,2024-07-02,House,"House Floor: HB 2012 PN 3461, FINAL PASSAGE",112,89,0,2,203
1837211,1456809,2024-06-12,House,"House Veterans Affairs And Emergency Preparedness: Report Bill As Committed",25,0,0,0,25
1837211,1462384,2024-07-02,House,"House Rules: Re-report Bill As Committed",33,0,0,0,33
1837256,1410839,2024-03-19,House,"House State Government: Report Bill As Committed",24,1,0,0,25
1837309,1410847,2024-03-19,House,"House State Government: Report Bill As Committed",24,1,0,0,25
1838421,1467556,2024-09-25,House,"House Judiciary: Adopt Amendment A05626",14,11,0,0,25
1838421,1467557,2024-09-25,House,"House Judiciary: Report Bill As Amended",14,11,0,0,25
1838551,1392526,2024-02-22,House,"House Agriculture And Rural Affairs: Report Bill As Committed",25,0,0,0,25
1838685,1410803,2024-03-19,House,"House State Government: Report Bill As Committed",22,3,0,0,25
1838685,1456590,2024-06-12,House,"House Floor: HR 317 PN 2585",113,88,0,2,203
1838824,1410907,2024-03-19,House,"House Consumer Protection, Technology And Utilities: Adopt Amendment A03519",24,1,0,0,25
1838824,1410908,2024-03-19,House,"House Consumer Protection, Technology And Utilities: Re-report Bill As Amended",21,4,0,0,25
1838824,1440268,2024-05-07,House,"House Floor: HB 2017 PN 2746, 2023 A4349",101,100,0,1,202
1838824,1440269,2024-05-07,House,"House Floor: HB 2017 PN 2746, MOTION TO TABLE AMENDMENTS",102,99,0,1,202
1838824,1441050,2024-05-08,House,"House Floor: HB 2017 PN 3072, FINAL PASSAGE",105,95,0,2,202
1838824,1441051,2024-05-08,House,"House Appropriations: Re-report Bill As Committed",22,15,0,0,37
1840043,1468139,2024-10-07,House,"House Education: Report Bill As Committed",15,10,0,0,25
1840043,1468815,2024-10-22,House,"House Floor: HR 318 PN 2593, 2023 A5858",100,102,0,1,203
1840043,1468816,2024-10-22,House,"House Floor: HR 318 PN 2593, 2023 A6006",105,97,0,1,203
1840043,1468869,2024-10-22,House,"House Floor: HR 318 PN 3788",152,50,0,1,203
1841843,1459720,2024-06-24,House,"House Appropriations: Report Bill As Committed",22,15,0,0,37
1841843,1460301,2024-06-26,House,"House Rules: Re-report Bill As Committed",18,15,0,0,33
1841843,1461130,2024-06-27,House,"House Floor: HB 2028 PN 2592, FINAL PASSAGE",164,38,0,1,203
1841843,1461131,2024-06-27,House,"House Appropriations: This amendment is not germane to the bill. A05261",22,15,0,0,37
1841843,1461132,2024-06-27,House,"House Appropriations: Re-report Bill As Committed",37,0,0,0,37
1844373,1436353,2024-04-30,Senate,"Senate Communications And Technology: Reported as Amended",10,1,0,0,11
1844373,1436354,2024-04-30,Senate,"Senate Communications And Technology: Adopt Amendment A04196",10,1,0,0,11
1844373,1440629,2024-05-08,Senate,"Senate Floor: SR 223 PN 1563",47,1,0,2,50
1844453,1454073,2024-06-05,House,"House Children And Youth: Adopt Amendment A04663",15,10,0,0,25
1844453,1454074,2024-06-05,House,"House Children And Youth: Report Bill As Amended",15,10,0,0,25
1844510,1412434,2024-03-20,Senate,"Senate Finance: Reported as Committed",10,1,0,0,11
1844510,1436036,2024-04-29,Senate,"Senate Floor: SB 1056 PN 1364, Final Passage",49,0,0,1,50
1844510,1436037,2024-04-29,Senate,"Senate Appropriations: Re-Reported as Committed",24,0,0,0,24
1844510,1468058,2024-10-02,House,"House Finance: Adopt Amendment A05760",14,11,0,0,25
1844510,1468059,2024-10-02,House,"House Finance: Re-report Bill As Committed",14,11,0,0,25
1844510,1468760,2024-10-21,House,"House Appropriations: Adopt Amendment A06057",22,15,0,0,37
1844510,1468761,2024-10-21,House,"House Appropriations: Re-report Bill As Amended",22,15,0,0,37
1844510,1468867,2024-10-22,House,"House Floor: SB 1056 PN 1970, FINAL PASSAGE",107,95,0,1,203
1847926,1458873,2024-06-24,House,"House State Government: Report Bill As Committed",16,9,0,0,25
1847926,1468080,2024-10-02,House,"House Floor: HR 323 PN 2610",105,97,0,1,203
1848065,1410081,2024-03-18,House,"House Transportation: Report Bill As Committed",25,0,0,0,25
1848752,1411770,2024-03-20,House,"House Finance: Adopt Amendment",25,0,0,0,25
1848752,1411771,2024-03-20,House,"House Finance: Report Bill As Amended",20,5,0,0,25
1848752,1441209,2024-05-08,House,"House Floor: HB 1958 PN 2757, 2023 A3865",103,97,0,2,202
1848752,1445641,2024-05-21,House,"House Appropriations: Re-report Bill As Committed",37,0,0,0,37
1848752,1447801,2024-05-22,House,"House Floor: HB 1958 PN 3077, FINAL PASSAGE",155,47,0,1,203
1850445,1454487,2024-06-05,House,"House Local Government: Adopt Amendment A04704",14,11,0,0,25
1850445,1454488,2024-06-05,House,"House Local Government: Adopt Amendment A04735",14,11,0,0,25
1850445,1454489,2024-06-05,House,"House Local Government: Adopt Amendment A04740",14,11,0,0,25
1850445,1454628,2024-06-05,House,"House Local Government: Report Bill As Amended",13,12,0,0,25
1851561,1446561,2024-05-21,House,"House Commerce: Report Bill As Committed",25,0,0,0,25
1851835,1416190,2024-03-27,House,"House Health: Report Bill As Committed",25,0,0,0,25
1851835,1416573,2024-03-27,House,"House Floor: HR 325 PN 2623",200,1,0,1,202
1852016,1411650,2024-03-20,Senate,"Senate Game And Fisheries: Reported as Amended",10,1,0,0,11
1852016,1411651,2024-03-20,Senate,"Senate Game And Fisheries: Adopt Amendment A03664",10,1,0,0,11
1852016,1411652,2024-03-20,Senate,"Senate Game And Fisheries: Adopt Amendment A03598",11,0,0,0,11
1852609,1413289,2024-03-20,House,"House Local Government: Report Bill As Committed",24,1,0,0,25
1852609,1425073,2024-04-10,House,"House Floor: HR 326 PN 2632",199,1,0,2,202
1852819,1414490,2024-03-25,House,"House Tourism And Economic And Recreational Development: Report Bill As Committed",25,0,0,0,25
1853741,1455907,2024-06-11,Senate,"Senate Health And Human Services: Reported as Committed",11,0,0,0,11
1853741,1461969,2024-07-01,Senate,"Senate Appropriations: Re-Reported as Committed",24,0,0,0,24
1853741,1462193,2024-07-02,Senate,"Senate Floor: SB 1080 PN 1396, Final Passage",50,0,0,0,50
1853741,1468073,2024-10-02,House,"House Health: Report Bill As Committed",24,1,0,0,25
1853741,1468271,2024-10-07,House,"House Floor: SB 1080 PN 1396, 2023 A5625",202,0,0,1,203
1853741,1468272,2024-10-07,House,"House Floor: SB 1080 PN 1396, 2023 A5826",202,0,0,1,203
1853741,1468314,2024-10-08,House,"House Floor: SB 1080 PN 1940, FINAL PASSAGE",200,1,0,2,203
1853741,1468315,2024-10-08,House,"House Appropriations: Re-report Bill As Committed",37,0,0,0,37
1853741,1468473,2024-10-09,Senate,"Senate Rules And Executive Nominations: Re-Reported as Committed",17,0,0,0,17
1853741,1468547,2024-10-09,Senate,"Senate Floor: SB 1080 PN 1940, Concur in House Amendments",49,0,0,1,50
1853877,1445470,2024-05-21,House,"House Commerce: Adopt Amendment A04475",25,0,0,0,25
1853877,1445471,2024-05-21,House,"House Commerce: Bring Up The Bill For Consideration",25,0,0,0,25
1853877,1445472,2024-05-21,House,"House Commerce: Report Bill As Amended",24,1,0,0,25
1853877,1461918,2024-07-01,House,"House Floor: HB 2064 PN 3137, 2023 A5381",201,1,0,1,203
1853877,1462178,2024-07-02,House,"House Floor: HB 2064 PN 3462, FINAL PASSAGE",152,49,0,2,203
1853877,1462179,2024-07-02,House,"House Appropriations: Re-report Bill As Committed",37,0,0,0,37
1854112,1412853,2024-03-20,House,"House Education: Report Bill As Committed",25,0,0,0,25
1854112,1422502,2024-04-09,House,"House Floor: HR 328 PN 2639",200,1,0,1,202
1854177,1412619,2024-03-20,House,"House Education: Report Bill As Committed",25,0,0,0,25
1854502,1453780,2024-06-04,House,"House Liquor Control: Adopt Amendment A04593",25,0,0,0,25
1854502,1453781,2024-06-04,House,"House Liquor Control: Adopt Amendment",25,0,0,0,25
1854607,1415292,2024-03-26,House,"House Judiciary: Report Bill As Committed",25,0,0,0,25
1857196,1414581,2024-03-25,House,"House Tourism And Economic And Recreational Development: Report Bill As Committed",25,0,0,0,25
1857196,1424238,2024-04-10,House,"House Floor: HR 331 PN 2659",101,99,0,2,202
1857881,1415214,2024-03-26,House,"House Judiciary: Report Bill As Committed",25,0,0,0,25
1857881,1427185,2024-04-15,House,"House Floor: HR 332 PN 2660",200,1,0,1,202
1858287,1410233,2024-03-18,House,"House Transportation: Report Bill As Committed",25,0,0,0,25
1858287,1424473,2024-04-10,House,"House Floor: HB 2055 PN 2651, FINAL PASSAGE",200,0,0,2,202
1858287,1424474,2024-04-10,House,"House Appropriations: Re-report Bill As Committed",37,0,0,0,37
1858287,1453818,2024-06-05,Senate,"Senate Transportation: Reported as Amended",14,0,0,0,14
1858287,1453819,2024-06-05,Senate,"Senate Transportation: Adopt Amendment A04576",14,0,0,0,14
1858287,1461162,2024-06-27,Senate,"Senate Floor: HB 2055 PN 3241, Motion to Table",49,0,0,1,50
1859325,1468549,2024-10-09,House,"House Commerce: Adopt Amendment A04829",14,11,0,0,25
1859325,1468550,2024-10-09,House,"House Commerce: Report Bill As Amended",14,11,0,0,25
1860127,1411627,2024-03-20,House,"House Veterans Affairs And Emergency Preparedness: Adopt Amendment A03652",25,0,0,0,25
1860127,1411628,2024-03-20,House,"House Veterans Affairs And Emergency Preparedness: Report Bill As Amended",25,0,0,0,25
1860127,1416317,2024-03-27,House,"House Floor: HR 335 PN 2759, 2023 A3744",201,0,0,1,202
1860127,1416318,2024-03-27,House,"House Floor: HR 335 PN 2822",201,0,0,1,202
1860278,1412019,2024-03-20,House,"House Veterans Affairs And Emergency Preparedness: Report Bill As Committed",25,0,0,0,25
1860278,1416653,2024-03-27,House,"House Floor: HR 336 PN 2669",201,0,0,1,202
1860367,1416116,2024-03-27,House,"House Health: Report Bill As Amended",23,2,0,0,25
1860367,1416117,2024-03-27,House,"House Health: Adopt Amendment A03752",23,2,0,0,25
1860367,1435973,2024-04-29,House,"House Floor: HB 2084 PN 2818, FINAL PASSAGE",200,1,0,1,202
1860367,1435974,2024-04-29,House,"House Appropriations: Re-report Bill As Committed",37,0,0,0,37
1860367,1467938,2024-10-01,Senate,"Senate Health And Human Services: Reported as Committed",10,0,1,0,11
1860367,1468251,2024-10-07,Senate,"Senate Appropriations: Re-Reported as Committed",23,0,1,0,24
1860367,1468532,2024-10-09,Senate,"Senate Floor: HB 2084 PN 2818, Final Passage",49,0,0,1,50
1861036,1439405,2024-05-06,House,"House Veterans Affairs And Emergency Preparedness: Report Bill As Committed",25,0,0,0,25
1861036,1452998,2024-06-03,House,"House Floor: HR 337 PN 2674",201,1,0,1,203
1861084,1445441,2024-05-21,House,"House Finance: Adopt Amendment A04512",25,0,0,0,25
1861084,1445442,2024-05-21,House,"House Finance: Report Bill As Amended",25,0,0,0,25
1861084,1462887,2024-07-10,House,"House Floor: HB 2092 PN 3143, 2023 A5475, MOTION TO APPEAL RULING OF THE CHAIR",102,100,0,1,203
1861084,1462960,2024-07-11,House,"House Appropriations: Re-report Bill As Committed",37,0,0,0,37
1861084,1463009,2024-07-11,House,"House Floor: HB 2092 PN 3143, FINAL PASSAGE",202,0,0,1,203
1861749,1468078,2024-10-02,House,"House Health: Report Bill As Committed",25,0,0,0,25
1861749,1468812,2024-10-22,House,"House Appropriations: Re-report Bill As Committed",37,0,0,0,37
1861749,1468848,2024-10-22,House,"House Floor: HB 2094 PN 2678, FINAL PASSAGE",202,0,0,1,203
1862539,1412389,2024-03-20,House,"House Finance: Report Bill As Amended",20,5,0,0,25
1862539,1412390,2024-03-20,House,"House Finance: Adopt Amendment",20,5,0,0,25
1862539,1468885,2024-10-23,House,"House Floor: HB 2085 PN 2758, FINAL PASSAGE",202,0,0,1,203
1862539,1468886,2024-10-23,House,"House Appropriations: Re-report Bill As Committed",37,0,0,0,37
1862601,1414461,2024-03-25,House,"House Insurance: Report Bill As Committed",25,0,0,0,25
1862601,1436110,2024-04-29,House,"House Floor: HB 2096 PN 2677, FINAL PASSAGE",201,0,0,1,202
1862601,1436111,2024-04-29,House,"House Appropriations: Re-report Bill As Committed",37,0,0,0,37
1862601,1456075,2024-06-11,Senate,"Senate Banking And Insurance: Reported as Committed",14,0,0,0,14
1862601,1461121,2024-06-27,Senate,"Senate Appropriations: Re-Reported as Committed",24,0,0,0,24
1862601,1461916,2024-07-01,Senate,"Senate Floor: HB 2096 PN 2677, Final Passage",50,0,0,0,50
1862632,1429322,2024-04-17,House,"House Health: Report Bill As Amended",23,2,0,0,25
1862632,1429323,2024-04-17,House,"House Health: Adopt Amendment A04007",24,1,0,0,25
1862632,1437257,2024-05-01,House,"House Floor: HB 2097 PN 2973, 2023 A4254",99,102,0,1,202
1862632,1439445,2024-05-06,House,"House Floor: HB 2097 PN 2973, FINAL PASSAGE",164,37,0,1,202
1862632,1439446,2024-05-06,House,"House Appropriations: Re-report Bill As Committed",25,12,0,0,37
1862730,1452623,2024-06-03,House,"House State Government: Report Bill As Committed",24,1,0,0,25
1862730,1461910,2024-07-01,House,"House Floor: HR 339 PN 2681",199,3,0,1,203
1862775,1422863,2024-04-09,Senate,"Senate Banking And Insurance: Reported as Committed",14,0,0,0,14
1862775,1436129,2024-04-29,Senate,"Senate Floor: SB 1092 PN 1405, Final Passage",49,0,0,1,50
1862775,1436130,2024-04-29,Senate,"Senate Appropriations: Re-Reported as Committed",24,0,0,0,24
1862775,1452586,2024-06-03,House,"House Insurance: Report Bill As Committed",25,0,0,0,25
1862775,1462431,2024-07-03,House,"House Floor: SB 1092 PN 1405, FINAL PASSAGE",202,0,0,1,203
1862775,1462432,2024-07-03,House,"House Appropriations: Re-report Bill As Committed",37,0,0,0,37
1863060,1410159,2024-03-18,Senate,"Senate Judiciary: Reported as Amended",14,0,0,0,14
1863060,1410160,2024-03-18,Senate,"Senate Judiciary: Adopt Amendment A03583",14,0,0,0,14
1863060,1412176,2024-03-20,Senate,"Senate Floor: SB 1111 PN 1429, Final Passage",49,0,0,1,50
1863060,1415224,2024-03-26,House,"House Judiciary: Report Bill As Committed",25,0,0,0,25
1863060,1424400,2024-04-10,House,"House Floor: SB 1111 PN 1429, FINAL PASSAGE",200,0,0,2,202
1863060,1424401,2024-04-10,House,"House Appropriations: Re-report Bill As Committed",37,0,0,0,37
1863093,1410051,2024-03-18,Senate,"Senate Veterans Affairs And Emergency Preparedness: Reported as Amended",11,0,0,0,11
1863093,1410052,2024-03-18,Senate,"Senate Veterans Affairs And Emergency Preparedness: Adopt Amendment A03638",11,0,0,0,11
1863093,1410053,2024-03-18,Senate,"Senate Veterans Affairs And Emergency Preparedness: Adopt Amendment A03595",11,0,0,0,11
1863093,1455704,2024-06-10,Senate,"Senate Appropriations: Re-Reported as Committed",24,0,0,0,24
1863093,1456624,2024-06-12,Senate,"Senate Floor: SB 1099 PN 1724, Final Passage",48,0,0,2,50
1863133,1410587,2024-03-18,Senate,"Senate Veterans Affairs And Emergency Preparedness: Reported as Amended",11,0,0,0,11
1863133,1410588,2024-03-18,Senate,"Senate Veterans Affairs And Emergency Preparedness: Adopt Amendment A03630",11,0,0,0,11
1863133,1421783,2024-04-08,Senate,"Senate Floor: SB 1101 PN 1427, Final Passage",48,0,0,2,50
1863133,1421784,2024-04-08,Senate,"Senate Appropriations: Re-Reported as Committed",24,0,0,0,24
1863166,1436558,2024-04-30,Senate,"Senate Education: Reported as Amended",7,4,0,0,11
1863166,1436559,2024-04-30,Senate,"Senate Education: Reported as Amended A04113",7,4,0,0,11
1863166,1452798,2024-06-03,Senate,"Senate Floor: SB 1104 PN 1565, Final Passage",29,21,0,0,50
1863166,1452799,2024-06-03,Senate,"Senate Appropriations: Re-Reported as Committed",15,9,0,0,24
1863172,1436524,2024-04-30,Senate,"Senate Education: Reported as Amended",7,4,0,0,11
1863172,1436525,2024-04-30,Senate,"Senate Education: Adopt Amendment A04115",7,4,0,0,11
1863172,1452785,2024-06-03,Senate,"Senate Floor: SB 1102 PN 1564, Final Passage",42,8,0,0,50
1863172,1452786,2024-06-03,Senate,"Senate Appropriations: Re-Reported as Committed",17,7,0,0,24
1863241,1416385,2024-03-27,House,"House Labor And Industry: Adopt Amendment A03780",11,14,0,0,25
1863241,1416386,2024-03-27,House,"House Labor And Industry: Report Bill As Committed",14,11,0,0,25
1863241,1436662,2024-04-30,House,"House Floor: HB 2104 PN 2687, 2023 A4191",102,98,0,2,202
1863241,1437254,2024-05-01,House,"House Floor: HB 2104 PN 3020, FINAL PASSAGE",102,99,0,1,202
1863241,1437255,2024-05-01,House,"House Appropriations: Re-report Bill As Committed",22,14,1,0,37
1863370,1416164,2024-03-27,House,"House Labor And Industry: Adopt Amendment A03741",14,11,0,0,25
1863370,1416165,2024-03-27,House,"House Labor And Industry: Report Bill As Amended",14,11,0,0,25
1863370,1436493,2024-04-30,House,"House Floor: HB 2105 PN 2820, 2023 A3910, MOTION TO TABLE",101,99,0,2,202
1863370,1437383,2024-05-01,House,"House Floor: HB 2105 PN 2820, FINAL PASSAGE",102,99,0,1,202
1863370,1437384,2024-05-01,House,"House Appropriations: Re-report Bill As Committed",22,14,1,0,37
1863442,1448233,2024-05-22,House,"House Game And Fisheries: Adopt Amendment A04453",13,11,1,0,25
1863442,1448234,2024-05-22,House,"House Game And Fisheries: Report Bill As Amended",13,11,1,0,25
1863442,1460400,2024-06-26,House,"House Floor: HB 2106 PN 3165, 2023 A4960",96,106,0,1,203
1863442,1460401,2024-06-26,House,"House Floor: HB 2106 PN 3165, 2023 A4962",101,101,0,1,203
1863442,1460402,2024-06-26,House,"House Floor: HB 2106 PN 3165, 2023 A4966",100,102,0,1,203
1863442,1460403,2024-06-26,House,"House Floor: HB 2106 PN 3165, 2023 A5161",111,91,0,1,203
1863442,1460983,2024-06-27,House,"House Appropriations: Adopt Amendment A05281",22,15,0,0,37
1863442,1460984,2024-06-27,House,"House Appropriations: Re-report Bill As Amended",37,0,0,0,37
1863442,1461150,2024-06-27,House,"House Floor: HB 2106 PN 3427, HB 2407",199,3,0,1,203
1863442,1461151,2024-06-27,House,"House Floor: HB 2106 PN 3427, FINAL PASSAGE",129,73,0,1,203
1863526,1447676,2024-05-22,House,"House Game And Fisheries: Report Bill As Committed",13,11,1,0,25
1863526,1459206,2024-06-24,House,"House Floor: HB 2107 PN 2691, 2023 A3873",100,102,0,1,203
1863526,1459207,2024-06-24,House,"House Floor: HB 2107 PN 2691, 2023 A3900",202,0,0,1,203
1863526,1460963,2024-06-27,House,"House Appropriations: Re-report Bill As Committed",37,0,0,0,37
1863526,1461191,2024-06-27,House,"House Floor: HB 2107 PN 3376, FINAL PASSAGE",164,38,0,1,203
1863554,1447891,2024-05-22,House,"House Game And Fisheries: Report Bill As Committed",13,11,1,0,25
1863554,1458889,2024-06-24,House,"House Floor: HB 2108 PN 2692, 2023 A3879",202,0,0,1,203
1863554,1458890,2024-06-24,House,"House Floor: HB 2108 PN 2692, 2023 A3894",93,109,0,1,203
1863554,1458891,2024-06-24,House,"House Floor: HB 2108 PN 2692, 2023 A4487",100,102,0,1,203
1863554,1458892,2024-06-24,House,"House Floor: HB 2108 PN 2692, 2023 A3904",202,0,0,1,203
1863554,1461015,2024-06-27,House,"House Floor: HB 2108 PN 3377, FINAL PASSAGE",132,70,0,1,203
1863554,1461016,2024-06-27,House,"House Appropriations: Re-report Bill As Committed",37,0,0,0,37
1864093,1412268,2024-03-20,House,"House Finance: Report Bill As Committed",25,0,0,0,25
1864093,1424667,2024-04-10,House,"House Floor: HB 2119 PN 2701, 2023 A3952, MOTION TO APPEAL RULING OF THE CHAIR",101,99,0,2,202
1864093,1426923,2024-04-15,House,"House Floor: HB 2119 PN 2701, FINAL PASSAGE",198,3,0,1,202
1864093,1426924,2024-04-15,House,"House Appropriations: Re-report Bill As Committed",22,15,0,0,37
1864555,1410153,2024-03-18,Senate,"Senate Veterans Affairs And Emergency Preparedness: Reported as Committed",7,4,0,0,11
1864555,1411052,2024-03-19,Senate,"Senate Floor: SR 251 PN 1424",27,22,0,1,50
1864593,1416249,2024-03-27,House,"House Health: Report Bill As Committed",25,0,0,0,25
1864593,1441430,2024-05-08,House,"House Floor: HR 341 PN 2717",199,1,0,2,202
1864708,1410125,2024-03-18,Senate,"Senate Judiciary: Reported as Committed",9,5,0,0,14
1864708,1411188,2024-03-19,Senate,"Senate Floor: SB 1120 PN 1425, 2023 A3634, BAKER Amendment No. A-3634",36,13,0,1,50
1864708,1423257,2024-04-09,Senate,"Senate Floor: SB 1120 PN 1436, Final Passage",34,16,0,0,50
1864764,1445724,2024-05-21,House,"House Commerce: Adopt Amendment A04225",25,0,0,0,25
1864764,1445725,2024-05-21,House,"House Commerce: Bring Up The Bill For Consideration",25,0,0,0,25
1864764,1445726,2024-05-21,House,"House Commerce: Report Bill As Amended",22,3,0,0,25
1864764,1461182,2024-06-27,House,"House Floor: HB 2132 PN 3138, 2023 A5227",202,0,0,1,203
1864764,1461183,2024-06-27,House,"House Appropriations: Re-report Bill As Committed",37,0,0,0,37
1864764,1461483,2024-06-28,House,"House Floor: HB 2132 PN 3436, FINAL PASSAGE",130,72,0,1,203
1864764,1462860,2024-07-10,Senate,"Senate Community, Economic And Recreational Development: Reported as Committed",14,0,0,0,14
1864764,1463014,2024-07-11,Senate,"Senate Floor: HB 2132 PN 3436, Re-referred to the Committee on Appropriations",49,0,0,1,50
1864764,1468256,2024-10-07,Senate,"Senate Appropriations: Re-Reported as Committed",23,0,1,0,24
1864764,1468328,2024-10-08,Senate,"Senate Rules And Executive Nominations: Re-Reported as Amended",16,1,0,0,17
1864764,1468329,2024-10-08,Senate,"Senate Rules And Executive Nominations: Adopt Amendment A05821",16,1,0,0,17
1864764,1468567,2024-10-09,Senate,"Senate Floor: HB 2132 PN 3739, Final Passage",48,1,0,1,50
1864764,1468719,2024-10-21,House,"House Rules: Re-report Bill As Committed",33,0,0,0,33
1864764,1468803,2024-10-21,House,"House Floor: HB 2132 PN 3739, CONCURRENCE",138,64,0,1,203
1864780,1410820,2024-03-19,House,"House State Government: Report Bill As Committed",15,10,0,0,25
1864780,1415550,2024-03-26,House,"House Floor: HR 344 PN 2707, 2023 A3657",99,102,0,1,202
1864780,1415551,2024-03-26,House,"House Floor: HR 344 PN 2707",103,98,0,1,202
1865116,1427295,2024-04-15,House,"House Appropriations: Report Resolution As Committed",37,0,0,0,37
1865116,1429668,2024-04-17,House,"House Floor: HR 346 PN 2734",105,95,0,2,202
1865260,1435989,2024-04-29,House,"House Judiciary: Report Bill As Committed",16,8,1,0,25
1865303,1411726,2024-03-20,House,"House Veterans Affairs And Emergency Preparedness: Report Bill As Committed",25,0,0,0,25
1865303,1414980,2024-03-25,House,"House Floor: HR 347 PN 2752, MOTION TO SUSPEND RULES",201,0,0,1,202
1865303,1414981,2024-03-25,House,"House Floor: HR 347 PN 2752",201,0,0,1,202
1865626,1436099,2024-04-29,House,"House Tourism And Economic And Recreational Development: Report Bill As Committed",25,0,0,0,25
1865626,1449004,2024-05-22,House,"House Floor: HR 348 PN 2764",200,2,0,1,203
1866210,1422291,2024-04-09,House,"House Consumer Protection, Technology And Utilities: Re-refer Bill To Another Committee",25,0,0,0,25
1866256,1416554,2024-03-27,House,"House Health: Report Bill As Committed",25,0,0,0,25
1866256,1430380,2024-04-17,House,"House Floor: HR 349 PN 2768",199,1,0,2,202
1866388,1435964,2024-04-16,House,"House Liquor Control: Adopt Amendment A03995",25,0,0,0,25
1866388,1435965,2024-04-16,House,"House Liquor Control: Report Bill As Amended",25,0,0,0,25
1866388,1436479,2024-04-30,House,"House Floor: HB 2150 PN 2951, 2023 A4072",92,108,0,2,202
1866388,1436480,2024-04-30,House,"House Floor: HB 2150 PN 2951, 2023 A4140",200,0,0,2,202
1866388,1437466,2024-05-01,House,"House Floor: HB 2150 PN 3019, FINAL PASSAGE",200,1,0,1,202
1866388,1437467,2024-05-01,House,"House Appropriations: Re-report Bill As Committed",36,0,1,0,37
1866691,1429503,2024-04-17,House,"House Labor And Industry: Adopt Amendment A03837",14,11,0,0,25
1866691,1429504,2024-04-17,House,"House Labor And Industry: To Table",14,11,0,0,25
1866691,1429505,2024-04-17,House,"House Labor And Industry: To Take Amendments off Table",11,14,0,0,25
1866691,1429506,2024-04-17,House,"House Labor And Industry: Report Bill As Amended",14,11,0,0,25
1866691,1456641,2024-06-12,House,"House Floor: HB 2153 PN 2969, 2023 A4086",86,115,0,2,203
1866691,1456642,2024-06-12,House,"House Floor: HB 2153 PN 2969, 2023 A4088",89,112,0,2,203
1866691,1456643,2024-06-12,House,"House Floor: HB 2153 PN 2969, 2023 A4089",81,120,0,2,203
1866691,1456644,2024-06-12,House,"House Floor: HB 2153 PN 2969, 2023 A4092",74,127,0,2,203
1866691,1456645,2024-06-12,House,"House Floor: HB 2153 PN 2969, 2023 A4119",70,131,0,2,203
1866691,1456646,2024-06-12,House,"House Floor: HB 2153 PN 2969, 2023 A4130",81,120,0,2,203
1866691,1456647,2024-06-12,House,"House Floor: HB 2153 PN 2969, 2023 A4537",84,117,0,2,203
1866691,1456648,2024-06-12,House,"House Floor: HB 2153 PN 2969, 2023 A4852",87,114,0,2,203
1866691,1458893,2024-06-24,House,"House Appropriations: Re-report Bill As Committed",25,12,0,0,37
1866691,1459270,2024-06-24,House,"House Floor: HB 2153 PN 2969, FINAL PASSAGE",125,77,0,1,203
1866691,1467877,2024-10-01,Senate,"Senate Labor And Industry: Reported as Amended",10,0,1,0,11
1866691,1467878,2024-10-01,Senate,"Senate Labor And Industry: Adopt Amendment A05595",10,0,1,0,11
1866699,1423049,2024-04-09,House,"House Consumer Protection, Technology And Utilities: Re-refer Bill To Another Committee",25,0,0,0,25
1866711,1440422,2024-05-07,Senate,"Senate Banking And Insurance: Reported as Committed",14,0,0,0,14
1866711,1452954,2024-06-03,Senate,"Senate Appropriations: Re-Reported as Committed",24,0,0,0,24
1866711,1453996,2024-06-05,Senate,"Senate Floor: SB 1084 PN 1440, Final Passage",50,0,0,0,50
1866711,1456622,2024-06-12,House,"House Commerce: Bring Up The Bill For Consideration",25,0,0,0,25
1866711,1456623,2024-06-12,House,"House Commerce: Report Bill As Committed",25,0,0,0,25
1866711,1459887,2024-06-25,House,"House Floor: SB 1084 PN 1440, 2023 A5131",100,102,0,1,203
1866711,1460221,2024-06-26,House,"House Floor: SB 1084 PN 1440, FINAL PASSAGE",202,0,0,1,203
1866711,1460222,2024-06-26,House,"House Appropriations: Re-report Bill As Committed",37,0,0,0,37
1866720,1449337,2024-05-22,House,"House Local Government: Adopt Amendment A04429",25,0,0,0,25
1866720,1449338,2024-05-22,House,"House Local Government: Report Bill As Amended",15,10,0,0,25
1867055,1435963,2024-04-29,House,"House Tourism And Economic And Recreational Development: Report Bill As Committed",25,0,0,0,25
1867055,1439746,2024-05-06,House,"House Floor: HR 352 PN 2795",132,69,0,1,202
1867063,1439380,2024-05-06,House,"House Children And Youth: Re-refer Bill To Another Committee",24,0,1,0,25
1867103,1467561,2024-09-25,House,"House Judiciary: Adopt Amendment A05641",14,11,0,0,25
1867103,1467562,2024-09-25,House,"House Judiciary: Report Bill As Amended",14,11,0,0,25
1867119,1440226,2024-05-07,Senate,"Senate Appropriations: Reported as Committed",24,0,0,0,24
1867119,1458909,2024-06-24,Senate,"Senate Appropriations: Adopt Amendment A04892",24,0,0,0,24
1867119,1458910,2024-06-24,Senate,"Senate Appropriations: Re-Reported as Amended",24,0,0,0,24
1867119,1460118,2024-06-25,Senate,"Senate Floor: SB 1006 PN 1762, Final Passage",49,1,0,0,50
1867119,1460319,2024-06-26,House,"House Appropriations: Report Bill As Committed",37,0,0,0,37
1867119,1462750,2024-07-09,House,"House Floor: SB 1006 PN 1762, FINAL PASSAGE",193,9,0,1,203
1867119,1462751,2024-07-09,House,"House Appropriations: Re-report Bill As Committed",37,0,0,0,37
1867127,1440278,2024-05-07,Senate,"Senate Appropriations: Reported as Committed",24,0,0,0,24
1867127,1458903,2024-06-24,Senate,"Senate Appropriations: Adopt Amendment A04893",24,0,0,0,24
1867127,1458904,2024-06-24,Senate,"Senate Appropriations: Re-Reported as Amended",24,0,0,0,24
1867127,1460031,2024-06-25,Senate,"Senate Floor: SB 1008 PN 1764, Final Passage",50,0,0,0,50
1867127,1460330,2024-06-26,House,"House Appropriations: Report Bill As Committed",37,0,0,0,37
1867127,1462831,2024-07-09,House,"House Floor: SB 1008 PN 1764, FINAL PASSAGE",175,27,0,1,203
1867127,1462832,2024-07-09,House,"House Appropriations: Re-report Bill As Committed",37,0,0,0,37
1867137,1439812,2024-05-06,Senate,"Senate Rules And Executive Nominations: Reported as Committed",16,0,1,0,17
1867137,1440067,2024-05-07,Senate,"Senate Floor: SR 252 PN 1456",48,2,0,0,50
1867150,1440182,2024-05-07,Senate,"Senate Appropriations: Reported as Committed",24,0,0,0,24
1867150,1458894,2024-06-24,Senate,"Senate Appropriations: Re-Reported as Committed",24,0,0,0,24
1867150,1459784,2024-06-25,Senate,"Senate Floor: SB 1001 PN 1446, Final Passage",49,1,0,0,50
1867150,1460295,2024-06-26,House,"House Appropriations: Report Bill As Committed",37,0,0,0,37
1867150,1460979,2024-06-27,House,"House Floor: SB 1001 PN 1446, SECOND CONSIDERATION",202,0,0,1,203
1867150,1462995,2024-07-11,House,"House Floor: SB 1001 PN 1817, FINAL PASSAGE",122,80,0,1,203
1867150,1462996,2024-07-11,House,"House Appropriations: Re-report Bill As Amended",22,15,0,0,37
1867150,1462997,2024-07-11,House,"House Appropriations: Adopt Amendment A05527",22,15,0,0,37
1867150,1462998,2024-07-11,Senate,"Senate Rules And Executive Nominations: Re-Reported as Committed",17,0,0,0,17
1867150,1463034,2024-07-11,Senate,"Senate Floor: SB 1001 PN 1817, Concur in House Amendments",44,5,0,1,50
1867163,1440653,2024-05-07,Senate,"Senate Appropriations: Reported as Committed",24,0,0,0,24
1867163,1458924,2024-06-24,Senate,"Senate Appropriations: Adopt Amendment A04901",24,0,0,0,24
1867163,1458925,2024-06-24,Senate,"Senate Appropriations: Re-Reported as Amended",24,0,0,0,24
1867163,1460125,2024-06-25,Senate,"Senate Floor: SB 1002 PN 1759, Final Passage",49,1,0,0,50
1867163,1460324,2024-06-26,House,"House Appropriations: Report Bill As Committed",37,0,0,0,37
1867163,1462767,2024-07-09,House,"House Floor: SB 1002 PN 1759, FINAL PASSAGE",184,18,0,1,203
1867163,1462768,2024-07-09,House,"House Appropriations: Re-report Bill As Committed",37,0,0,0,37
1867175,1440285,2024-05-07,Senate,"Senate Appropriations: Reported as Committed",24,0,0,0,24
1867175,1458922,2024-06-24,Senate,"Senate Appropriations: Re-Reported as Committed",24,0,0,0,24
1867175,1460122,2024-06-25,Senate,"Senate Floor: SB 1005 PN 1450, Final Passage",49,1,0,0,50
1867175,1460327,2024-06-26,House,"House Appropriations: Report Bill As Committed",37,0,0,0,37
1867175,1462821,2024-07-09,House,"House Floor: SB 1005 PN 1450, FINAL PASSAGE",184,18,0,1,203
1867175,1462822,2024-07-09,House,"House Appropriations: Re-report Bill As Committed",37,0,0,0,37
1867190,1440298,2024-05-07,Senate,"Senate Appropriations: Reported as Committed",24,0,0,0,24
1867190,1458917,2024-06-24,Senate,"Senate Appropriations: Adopt Amendment A04542",24,0,0,0,24
1867190,1458918,2024-06-24,Senate,"Senate Appropriations: Re-Reported as Amended",24,0,0,0,24
1867190,1460119,2024-06-25,Senate,"Senate Floor: SB 1004 PN 1761, Final Passage",50,0,0,0,50
1867190,1460325,2024-06-26,House,"House Appropriations: Report Bill As Committed",37,0,0,0,37
1867190,1462825,2024-07-09,House,"House Floor: SB 1004 PN 1761, FINAL PASSAGE",201,1,0,1,203
1867190,1462826,2024-07-09,House,"House Appropriations: Re-report Bill As Committed",37,0,0,0,37
1867203,1440655,2024-05-07,Senate,"Senate Appropriations: Reported as Committed",24,0,0,0,24
1867203,1458905,2024-06-24,Senate,"Senate Appropriations: Adopt Amendment A04905",24,0,0,0,24
1867203,1458906,2024-06-24,Senate,"Senate Appropriations: Re-Reported as Amended",24,0,0,0,24
1867203,1460126,2024-06-25,Senate,"Senate Floor: SB 1009 PN 1765, Final Passage",49,1,0,0,50
1867203,1460334,2024-06-26,House,"House Appropriations: Report Bill As Committed",37,0,0,0,37
1867203,1462783,2024-07-09,House,"House Appropriations: Re-report Bill As Amended",37,0,0,0,37
1867203,1462784,2024-07-09,House,"House Appropriations: Adopt Amendment A05493",37,0,0,0,37
1867203,1462785,2024-07-09,House,"House Appropriations: Re-report Bill As Committed",37,0,0,0,37
1867203,1462880,2024-07-10,House,"House Appropriations: Adopt Amendment A05502",37,0,0,0,37
1867203,1462881,2024-07-10,House,"House Appropriations: Re-report Bill As Amended",37,0,0,0,37
1867203,1462999,2024-07-11,House,"House Floor: SB 1009 PN 1813, FINAL PASSAGE",173,29,0,1,203
1867203,1463000,2024-07-11,Senate,"Senate Rules And Executive Nominations: Re-Reported as Committed",17,0,0,0,17
1867203,1463058,2024-07-11,Senate,"Senate Floor: SB 1009 PN 1813, Concur in House Amendments",48,1,0,1,50
1867227,1440324,2024-05-07,Senate,"Senate Appropriations: Reported as Committed",24,0,0,0,24
1867227,1458919,2024-06-24,Senate,"Senate Appropriations: Adopt Amendment A04910",24,0,0,0,24
1867227,1458920,2024-06-24,Senate,"Senate Appropriations: Re-Reported as Amended",24,0,0,0,24
1867227,1460124,2024-06-25,Senate,"Senate Floor: SB 1003 PN 1760, Final Passage",49,1,0,0,50
1867227,1460322,2024-06-26,House,"House Appropriations: Report Bill As Committed",37,0,0,0,37
1867227,1462757,2024-07-09,House,"House Floor: SB 1003 PN 1760, FINAL PASSAGE",180,22,0,1,203
1867227,1462758,2024-07-09,House,"House Appropriations: Re-report Bill As Committed",37,0,0,0,37
1867236,1440291,2024-05-07,Senate,"Senate Appropriations: Reported as Committed",24,0,0,0,24
1867236,1458911,2024-06-24,Senate,"Senate Appropriations: Adopt Amendment A04949",24,0,0,0,24
1867236,1458912,2024-06-24,Senate,"Senate Appropriations: Re-Reported as Amended",24,0,0,0,24
1867236,1460121,2024-06-25,Senate,"Senate Floor: SB 1010 PN 1766, Final Passage",49,1,0,0,50
1867236,1460320,2024-06-26,House,"House Appropriations: Report Bill As Committed",37,0,0,0,37
1867236,1462823,2024-07-09,House,"House Floor: SB 1010 PN 1766, FINAL PASSAGE",196,6,0,1,203
1867236,1462824,2024-07-09,House,"House Appropriations: Re-report Bill As Committed",37,0,0,0,37
1867249,1440351,2024-05-07,Senate,"Senate Appropriations: Reported as Committed",24,0,0,0,24
1867249,1458914,2024-06-24,Senate,"Senate Appropriations: Adopt Amendment A04890",24,0,0,0,24
1867249,1458915,2024-06-24,Senate,"Senate Appropriations: Re-Reported as Amended",24,0,0,0,24
1867249,1460128,2024-06-25,Senate,"Senate Floor: SB 1007 PN 1763, Final Passage",49,1,0,0,50
1867249,1460331,2024-06-26,House,"House Appropriations: Report Bill As Committed",37,0,0,0,37
1867249,1462759,2024-07-09,House,"House Floor: SB 1007 PN 1763, FINAL PASSAGE",195,7,0,1,203
1867249,1462760,2024-07-09,House,"House Appropriations: Re-report Bill As Committed",37,0,0,0,37
1867368,1435962,2024-04-29,House,"House Tourism And Economic And Recreational Development: Report Bill As Committed",25,0,0,0,25
1867368,1468067,2024-10-02,House,"House Floor: HR 359 PN 2799",201,1,0,1,203
1867464,1467736,2024-09-30,House,"House Consumer Protection, Technology And Utilities: Report Bill As Committed",25,0,0,0,25
1867464,1468227,2024-10-07,House,"House Floor: HR 358 PN 2798",169,33,0,1,203
1867549,1460972,2024-06-26,House,"House Local Government: Adopt Amendment A04994",25,0,0,0,25
1867549,1461165,2024-06-26,House,"House Local Government: Report Bill As Amended",25,0,0,0,25
1867549,1462721,2024-07-08,House,"House Rules: Re-report Bill As Committed",33,0,0,0,33
1867549,1462738,2024-07-09,House,"House Appropriations: Re-report Bill As Committed",37,0,0,0,37
1867549,1462806,2024-07-09,House,"House Floor: HB 2160 PN 3411, FINAL PASSAGE",197,5,0,1,203
1867549,1467332,2024-09-17,Senate,"Senate Local Government: Reported as Committed",11,0,0,0,11
1867549,1468836,2024-10-22,Senate,"Senate Floor: HB 2160 PN 3411, Final Passage",50,0,0,0,50
1867549,1468837,2024-10-22,Senate,"Senate Appropriations: Re-Reported as Committed",24,0,0,0,24
1867711,1425573,2024-03-27,House,"House Floor: UNCONTESTED CALENDAR",201,0,0,1,202
1867736,1425556,2024-03-27,House,"House Floor: UNCONTESTED CALENDAR",201,0,0,1,202
1867756,1425581,2024-03-27,House,"House Floor: UNCONTESTED CALENDAR",201,0,0,1,202
1867779,1425579,2024-03-27,House,"House Floor: UNCONTESTED CALENDAR",201,0,0,1,202
1867801,1427005,2024-04-15,House,"House Transportation: Report Bill As Committed",25,0,0,0,25
1867801,1429480,2024-04-17,House,"House Floor: HB 2161 PN 2794, FINAL PASSAGE",105,95,0,2,202
1867801,1429481,2024-04-17,House,"House Appropriations: Re-report Bill As Committed",37,0,0,0,37
1867801,1459785,2024-06-25,Senate,"Senate Transportation: Reported as Committed",14,0,0,0,14
1867824,1425503,2024-03-27,House,"House Floor: UNCONTESTED CALENDAR",201,0,0,1,202
1867842,1425602,2024-03-27,House,"House Floor: UNCONTESTED CALENDAR",201,0,0,1,202
1867867,1456699,2024-06-12,House,"House Judiciary: Adopt Amendment A04924",25,0,0,0,25
1867867,1456700,2024-06-12,House,"House Judiciary: Report Bill As Amended",14,11,0,0,25
1867867,1462138,2024-07-02,House,"House Rules: Re-report Bill As Committed",18,15,0,0,33
1867867,1462428,2024-07-03,House,"House Floor: HB 2162 PN 3319, FINAL PASSAGE",141,61,0,1,203
1867867,1462429,2024-07-03,House,"House Appropriations: Re-report Bill As Committed",37,0,0,0,37
1867926,1461084,2024-06-26,House,"House Local Government: Adopt Amendment A05071",25,0,0,0,25
1867926,1461085,2024-06-26,House,"House Local Government: Report Bill As Amended",25,0,0,0,25
1868113,1435953,2024-04-29,House,"House Tourism And Economic And Recreational Development: Report Bill As Committed",25,0,0,0,25
1868162,1421792,2024-04-08,Senate,"Senate Judiciary: Reported as Amended",9,5,0,0,14
1868162,1421793,2024-04-08,Senate,"Senate Judiciary: Adopt Amendment A03907",9,5,0,0,14
1868162,1424172,2024-04-10,Senate,"Senate Floor: SB 1127 PN 1513, Final Passage",34,16,0,0,50
1868210,1449388,2024-05-22,House,"House Local Government: Adopt Amendment A04468",25,0,0,0,25
1868210,1449389,2024-05-22,House,"House Local Government: Report Bill As Amended",25,0,0,0,25
1868210,1456810,2024-06-12,House,"House Floor: HB 2166 PN 3163, FINAL PASSAGE",102,99,0,2,203
1868210,1456811,2024-06-12,House,"House Appropriations: Re-report Bill As Committed",37,0,0,0,37
1868252,1435992,2024-04-29,House,"House Human Services: Report Bill As Committed",16,9,0,0,25
1868252,1453269,2024-06-04,House,"House Floor: HB 2137 PN 2823, 2023 A4677",112,90,0,1,203
1868252,1453971,2024-06-05,House,"House Floor: HB 2137 PN 3230, FINAL PASSAGE",123,79,0,1,203
1868252,1453972,2024-06-05,House,"House Appropriations: Re-report Bill As Committed",37,0,0,0,37
1868433,1468544,2024-10-09,Senate,"Senate Transportation: Reported as Amended",10,4,0,0,14
1868433,1468545,2024-10-09,Senate,"Senate Transportation: Adopt Amendment A05851",12,2,0,0,14
1868450,1422397,2024-04-09,Senate,"Senate Local Government: Reported as Committed",11,0,0,0,11
1868450,1436089,2024-04-29,Senate,"Senate Appropriations: Re-Reported as Committed",24,0,0,0,24
1868450,1440574,2024-05-07,Senate,"Senate Floor: SB 1134 PN 1582, Final Passage",50,0,0,0,50
1868450,1467623,2024-09-25,House,"House Local Government: Report Bill As Committed",25,0,0,0,25
1868450,1468901,2024-10-23,House,"House Floor: SB 1134 PN 1582, FINAL PASSAGE",200,2,0,1,203
1868450,1468902,2024-10-23,House,"House Appropriations: Re-report Bill As Committed",37,0,0,0,37
1868487,1422319,2024-04-09,Senate,"Senate Local Government: Reported as Committed",11,0,0,0,11
1868487,1436083,2024-04-29,Senate,"Senate Appropriations: Re-Reported as Committed",24,0,0,0,24
1868487,1440272,2024-05-07,Senate,"Senate Floor: SB 1133 PN 1581, Final Passage",50,0,0,0,50
1868487,1467624,2024-09-25,House,"House Local Government: Report Bill As Committed",25,0,0,0,25
1868487,1468878,2024-10-23,House,"House Floor: SB 1133 PN 1581, FINAL PASSAGE",200,2,0,1,203
1868487,1468879,2024-10-23,House,"House Appropriations: Re-report Bill As Committed",37,0,0,0,37
1868543,1436757,2024-04-30,Senate,"Senate State Government: Reported as Committed",11,0,0,0,11
1868582,1422364,2024-04-09,Senate,"Senate Local Government: Reported as Committed",11,0,0,0,11
1868582,1436039,2024-04-29,Senate,"Senate Appropriations: Re-Reported as Committed",24,0,0,0,24
1868582,1440378,2024-05-07,Senate,"Senate Floor: SB 1132 PN 1580, Final Passage",50,0,0,0,50
1868582,1467648,2024-09-25,House,"House Local Government: Report Bill As Committed",25,0,0,0,25
1868582,1468872,2024-10-23,House,"House Appropriations: Re-report Bill As Committed",37,0,0,0,37
1868582,1468903,2024-10-23,House,"House Floor: SB 1132 PN 1580, FINAL PASSAGE",200,2,0,1,203
1868602,1455908,2024-06-11,Senate,"Senate Labor And Industry: Reported as Amended",8,0,3,0,11
1868602,1455909,2024-06-11,Senate,"Senate Labor And Industry: Adopt Amendment A04812",9,2,0,0,11
1868621,1424039,2024-04-10,Senate,"Senate Labor And Industry: Reported as Committed",11,0,0,0,11
1868621,1436092,2024-04-29,Senate,"Senate Appropriations: Re-Reported as Committed",18,6,0,0,24
1868621,1437170,2024-05-01,Senate,"Senate Floor: SB 1109 PN 1461, 2023 A4216, WILLIAMS, L. Amendment No. A-4216",23,27,0,0,50
1868621,1437171,2024-05-01,Senate,"Senate Floor: SB 1109 PN 1461, 2023 A4216, Final Passage",31,19,0,0,50
1868621,1453926,2024-06-05,House,"House Labor And Industry: Report Bill As Amended",23,2,0,0,25
1868621,1453927,2024-06-05,House,"House Labor And Industry: Adopt Amendment A04717",14,11,0,0,25
1868895,1445431,2024-05-21,House,"House Health: Report Bill As Amended",14,11,0,0,25
1868895,1445432,2024-05-21,House,"House Health: Adopt Amendment A04496",14,11,0,0,25
1868895,1454031,2024-06-05,House,"House Floor: HB 2127 PN 3148, 2023 A4651",202,0,0,1,203
1868895,1455736,2024-06-10,House,"House Floor: HB 2127 PN 3258, FINAL PASSAGE",201,0,0,2,203
1868895,1455737,2024-06-10,House,"House Appropriations: Re-report Bill As Committed",37,0,0,0,37
1868895,1467940,2024-10-01,Senate,"Senate Health And Human Services: Reported as Amended",10,0,1,0,11
1868895,1467941,2024-10-01,Senate,"Senate Health And Human Services: Adopt Amendment A05737",10,0,1,0,11
1868895,1468172,2024-10-07,Senate,"Senate Appropriations: Re-Reported as Committed",23,0,1,0,24
1868895,1468330,2024-10-08,Senate,"Senate Floor: HB 2127 PN 3690, Final Passage",50,0,0,0,50
1868895,1468506,2024-10-09,House,"House Floor: HB 2127 PN 3690, CONCURRENCE",199,3,0,1,203
1868895,1468507,2024-10-09,House,"House Rules: Re-report Bill As Committed",33,0,0,0,33
1868905,1439400,2024-05-06,House,"House Insurance: Adopt Amendment A03992",25,0,0,0,25
1868905,1439401,2024-05-06,House,"House Insurance: Report Bill As Amended",24,1,0,0,25
1868905,1445644,2024-05-21,House,"House Appropriations: Re-report Bill As Committed",37,0,0,0,37
1868905,1446154,2024-05-21,House,"House Floor: HB 2138 PN 3055, FINAL PASSAGE",154,48,0,1,203
1868915,1427878,2024-04-16,House,"House Commerce: Bring Up The Bill For Consideration",25,0,0,0,25
1868915,1427879,2024-04-16,House,"House Commerce: Report Bill As Committed",14,11,0,0,25
1868915,1437526,2024-05-01,House,"House Floor: HB 2174 PN 2838, 2023 A4234",201,0,0,1,202
1868915,1439376,2024-05-06,House,"House Appropriations: Re-report Bill As Committed",22,15,0,0,37
1868915,1439567,2024-05-06,House,"House Floor: HB 2174 PN 3039, FINAL PASSAGE",109,92,0,1,202
1868924,1435956,2024-04-29,House,"House State Government: Adopt Amendment A04135",25,0,0,0,25
1868924,1435957,2024-04-29,House,"House State Government: Report Bill As Amended",24,1,0,0,25
1868924,1439756,2024-05-06,House,"House Floor: HR 365 PN 2995",199,2,0,1,202
1868935,1436041,2024-04-29,House,"House Human Services: Adopt Amendment A04122",15,0,10,0,25
1868935,1436042,2024-04-29,House,"House Human Services: Report Bill As Amended",25,0,0,0,25
1868935,1457188,2024-06-12,House,"House Floor: HR 366 PN 2998",200,1,0,2,203
1869071,1456030,2024-06-11,House,"House Children And Youth: Adopt Amendment A04859",15,9,1,0,25
1869071,1456031,2024-06-11,House,"House Children And Youth: Report Bill As Committed",15,9,1,0,25
1869071,1461335,2024-06-28,House,"House Floor: HB 2175 PN 3305, 2023 A5232",100,102,0,1,203
1869071,1461336,2024-06-28,House,"House Floor: HB 2175 PN 3305, 2023 A5233",100,102,0,1,203
1869071,1461337,2024-06-28,House,"House Rules: Re-report Bill As Committed",18,15,0,0,33
1869071,1461881,2024-07-01,House,"House Appropriations: Re-report Bill As Committed",37,0,0,0,37
1869071,1461943,2024-07-01,House,"House Floor: HB 2175 PN 3305, FINAL PASSAGE",111,91,0,1,203
1869159,1429471,2024-04-17,House,"House Health: Report Bill As Committed",25,0,0,0,25
1869173,1456568,2024-06-12,House,"House Health: Report Bill As Amended",24,0,0,0,24
1869173,1456569,2024-06-12,House,"House Health: Adopt Amendment A04888",24,0,0,0,24
1869173,1460975,2024-06-27,House,"House Rules: Re-report Bill As Committed",33,0,0,0,33
1869173,1461108,2024-06-27,House,"House Floor: HB 1993 PN 3317, 2023 A5243",202,0,0,1,203
1869173,1461109,2024-06-27,House,"House Floor: HB 1993 PN 3317, 2023 A5205",100,102,0,1,203
1869173,1461110,2024-06-27,House,"House Appropriations: Re-report Bill As Committed",37,0,0,0,37
1869173,1461351,2024-06-28,House,"House Floor: HB 1993 PN 3435, FINAL PASSAGE",198,4,0,1,203
1869173,1462711,2024-07-08,Senate,"Senate Health And Human Services: Reported as Amended",11,0,0,0,11
1869173,1462712,2024-07-08,Senate,"Senate Health And Human Services: Motion to Revert to Prior Printers Number 2883",11,0,0,0,11
1869173,1462752,2024-07-09,Senate,"Senate Floor: HB 1993 PN 2833, 2023 A5498, WARD, J. Amendment No. A-5498",49,0,0,1,50
1869173,1462861,2024-07-10,Senate,"Senate Appropriations: Adopt Amendment A05509",23,0,1,0,24
1869173,1462862,2024-07-10,Senate,"Senate Appropriations: Re-Reported as Amended",23,0,1,0,24
1869173,1462896,2024-07-10,Senate,"Senate Floor: HB 1993 PN 3499, Final Passage",48,1,0,1,50
1869173,1462947,2024-07-11,House,"House Rules: Re-report Bill As Committed",33,0,0,0,33
1869173,1462979,2024-07-11,House,"House Floor: HB 1993 PN 3499, CONCURRENCE",172,30,0,1,203
1869806,1426915,2024-04-15,House,"House Professional Licensure: Report Bill As Committed",25,0,0,0,25
1869806,1426916,2024-04-15,House,"House Professional Licensure: Report Bill As Committed",25,0,0,0,25
1869806,1429649,2024-04-17,House,"House Floor: HR 369 PN 2851",199,1,0,2,202
1869810,1467788,2024-09-30,House,"House Consumer Protection, Technology And Utilities: Report Bill As Committed",25,0,0,0,25
1869810,1468051,2024-10-02,House,"House Floor: HR 372 PN 2854",200,2,0,1,203
1869815,1446188,2024-05-21,House,"House Transportation: Report Bill As Amended",25,0,0,0,25
1869815,1446189,2024-05-21,House,"House Transportation: Adopt Amendment A04491",25,0,0,0,25
1869815,1456014,2024-06-11,House,"House Floor: HB 2182 PN 3145, FINAL PASSAGE",201,0,0,2,203
1869815,1456015,2024-06-11,House,"House Appropriations: Re-report Bill As Committed",37,0,0,0,37
1869815,1459839,2024-06-25,Senate,"Senate Transportation: Reported as Committed",14,0,0,0,14
1869815,1460998,2024-06-27,Senate,"Senate Appropriations: Re-Reported as Committed",24,0,0,0,24
1869815,1462805,2024-07-09,Senate,"Senate Floor: HB 2182 PN 3145, Final Passage",49,0,0,1,50
1869831,1422548,2024-04-09,Senate,"Senate Veterans Affairs And Emergency Preparedness: Reported as Committed",11,0,0,0,11
1869831,1435970,2024-04-29,Senate,"Senate Appropriations: Re-Reported as Committed",24,0,0,0,24
1869831,1439411,2024-05-06,Senate,"Senate Floor: SB 1139 PN 1473, Final Passage",48,0,0,2,50
1869841,1460296,2024-06-26,Senate,"Senate Transportation: Reported as Amended",14,0,0,0,14
1869841,1460297,2024-06-26,Senate,"Senate Transportation: Adopt Amendment A05160",14,0,0,0,14
1869841,1462729,2024-07-08,Senate,"Senate Floor: SB 1118 PN 1781, Motion to Consider Bill on Second Consideration",48,0,0,2,50
1869841,1462803,2024-07-09,Senate,"Senate Floor: SB 1118 PN 1781, Re-referred to the Committee on Appropriations",49,0,0,1,50
1869841,1463007,2024-07-11,Senate,"Senate Floor: SB 1118 PN 1781, Final Passage",49,0,0,1,50
1869841,1463008,2024-07-11,Senate,"Senate Appropriations: Re-Reported as Committed",23,0,1,0,24
1869841,1468085,2024-10-02,House,"House Judiciary: Report Bill As Committed",25,0,0,0,25
1869841,1468245,2024-10-07,House,"House Floor: SB 1118 PN 1781, 2023 A5922",102,100,0,1,203
1869841,1468417,2024-10-08,House,"House Appropriations: Adopt Amendment A05946",22,15,0,0,37
1869841,1468418,2024-10-08,House,"House Appropriations: Re-report Bill As Amended",37,0,0,0,37
1869841,1468476,2024-10-09,House,"House Floor: SB 1118 PN 1945, FINAL PASSAGE",199,3,0,1,203
1869841,1468477,2024-10-09,Senate,"Senate Rules And Executive Nominations: Re-Reported as Committed",17,0,0,0,17
1869841,1468560,2024-10-09,Senate,"Senate Floor: SB 1118 PN 1945, Concur in House Amendments",49,0,0,1,50
1869846,1421827,2024-04-08,House,"House Transportation: Report Bill As Amended",25,0,0,0,25
1869846,1421828,2024-04-08,House,"House Transportation: Adopt Amendment A03889",25,0,0,0,25
1869846,1436055,2024-04-29,House,"House Floor: HB 2177 PN 2867, FINAL PASSAGE",201,0,0,1,202
1869846,1436056,2024-04-29,House,"House Appropriations: Re-report Bill As Committed",37,0,0,0,37
1869846,1468811,2024-10-09,Senate,"Senate Transportation: Reported as Committed",14,0,0,0,14
1869846,1468845,2024-10-22,Senate,"Senate Appropriations: Re-Reported as Committed",24,0,0,0,24
1869907,1452914,2024-06-03,House,"House Education: Adopt Amendment A04608",23,2,0,0,25
1869907,1452915,2024-06-03,House,"House Education: Report Bill As Amended",21,4,0,0,25
1869907,1461188,2024-06-27,House,"House Floor: HB 2185 PN 3213, FINAL PASSAGE",182,20,0,1,203
1869907,1461189,2024-06-27,House,"House Appropriations: Re-report Bill As Committed",37,0,0,0,37
1869907,1468203,2024-10-07,Senate,"Senate Education: Reported as Amended",10,1,0,0,11
1869907,1468204,2024-10-07,Senate,"Senate Education: Adopt Amendment A05874",10,1,0,0,11
1869907,1468316,2024-10-08,Senate,"Senate Appropriations: Re-Reported as Committed",24,0,0,0,24
1869907,1468769,2024-10-21,Senate,"Senate Floor: HB 2185 PN 3727, Final Passage",48,0,0,2,50
1869907,1468813,2024-10-22,House,"House Rules: Re-report Bill As Committed",33,0,0,0,33
1869907,1468849,2024-10-22,House,"House Floor: HB 2185 PN 3727, CONCURRENCE",168,34,0,1,203
1869937,1421750,2024-04-08,House,"House Human Services: Adopt Amendment",22,3,0,0,25
1869937,1421751,2024-04-08,House,"House Human Services: Report Bill As Amended",25,0,0,0,25
1869937,1424692,2024-04-10,House,"House Floor: HR 373 PN 2868",199,1,0,2,202
1869977,1429499,2024-04-17,House,"House Health: Report Bill As Committed",25,0,0,0,25
1869977,1436541,2024-04-30,House,"House Floor: HR 370 PN 2852",199,1,0,2,202
1870212,1436033,2024-04-16,House,"House Liquor Control: Adopt Amendment A03954",25,0,0,0,25
1870212,1436034,2024-04-16,House,"House Liquor Control: Report Bill As Amended",25,0,0,0,25
1870329,1467781,2024-09-30,House,"House Consumer Protection, Technology And Utilities: Report Bill As Committed",25,0,0,0,25
1870329,1467928,2024-10-01,House,"House Floor: HB 2189 PN 2859, 2023 A5649",110,92,0,1,203
1870329,1467929,2024-10-01,House,"House Floor: HB 2189 PN 2859, 2023 A5755",103,99,0,1,203
1870329,1468081,2024-10-02,House,"House Floor: HB 2189 PN 3697, FINAL PASSAGE",120,82,0,1,203
1870329,1468082,2024-10-02,House,"House Appropriations: Re-report Bill As Committed",37,0,0,0,37
1870329,1468173,2024-10-07,Senate,"Senate Consumer Protection And Professional Licensure: Adopt Amendment A05903",14,0,0,0,14
1870329,1468174,2024-10-07,Senate,"Senate Consumer Protection And Professional Licensure: Reported as Amended A05903",14,0,0,0,14
1870433,1455910,2024-06-11,Senate,"Senate Transportation: Reported as Amended",14,0,0,0,14
1870433,1455911,2024-06-11,Senate,"Senate Transportation: Adopt Amendment A04691",14,0,0,0,14
1870433,1459768,2024-06-25,Senate,"Senate Appropriations: Re-Reported as Committed",24,0,0,0,24
1870433,1462183,2024-07-02,Senate,"Senate Floor: SB 1129 PN 1718, Final Passage",50,0,0,0,50
1870447,1422877,2024-04-09,Senate,"Senate Transportation: Reported as Committed",14,0,0,0,14
1870447,1436365,2024-04-29,Senate,"Senate Floor: SB 1144 PN 1484, Final Passage",49,0,0,1,50
1870447,1460165,2024-06-26,House,"House Transportation: Report Bill As Amended",25,0,0,0,25
1870447,1460166,2024-06-26,House,"House Transportation: Adopt Amendment A05120",25,0,0,0,25
1870447,1462131,2024-07-01,House,"House Appropriations: Adopt Amendment A05338",37,0,0,0,37
1870447,1462132,2024-07-01,House,"House Appropriations: Re-report Bill As Amended",37,0,0,0,37
1870447,1462157,2024-07-02,House,"House Floor: SB 1144 PN 1801, 2023 A5417",201,0,0,2,203
1870447,1462186,2024-07-02,House,"House Floor: SB 1144 PN 1806, FINAL PASSAGE",201,0,0,2,203
1870447,1462411,2024-07-03,Senate,"Senate Rules And Executive Nominations: Re-Reported as Committed",17,0,0,0,17
1870447,1462716,2024-07-08,Senate,"Senate Floor: SB 1144 PN 1806, Concur in House Amendments",49,0,0,1,50
1870452,1422283,2024-04-09,House,"House State Government: Report Bill As Committed",17,8,0,0,25
1870452,1429735,2024-04-17,House,"House Floor: HR 376 PN 2866",196,4,0,2,202
1870454,1423182,2024-04-09,House,"House State Government: Report Bill As Committed",24,1,0,0,25
1870454,1429387,2024-04-17,House,"House Floor: HR 374 PN 2864",102,98,0,2,202
1870460,1456755,2024-06-11,Senate,"Senate Community, Economic And Recreational Development: Reported as Amended A04310",14,0,0,0,14
1870460,1456756,2024-06-11,Senate,"Senate Community, Economic And Recreational Development: Adopt Amendment A04310",14,0,0,0,14
1870460,1458908,2024-06-24,Senate,"Senate Appropriations: Re-Reported as Committed",24,0,0,0,24
1870460,1459808,2024-06-25,Senate,"Senate Floor: SB 1121 PN 1723, Final Passage",50,0,0,0,50
1870460,1459809,2024-06-25,Senate,"Senate Floor: SB 1121 PN 1723, Final Passage-Reconsidered",49,1,0,0,50
1870467,1462137,2024-07-02,House,"House Veterans Affairs And Emergency Preparedness: Report Bill As Committed",25,0,0,0,25
1870467,1462766,2024-07-09,House,"House Floor: HR 375 PN 2865",202,0,0,1,203
1870468,1422315,2024-04-09,Senate,"Senate Veterans Affairs And Emergency Preparedness: Reported as Committed",11,0,0,0,11
1870483,1454008,2024-06-05,Senate,"Senate Transportation: Reported as Committed",9,5,0,0,14
1870483,1459723,2024-06-24,Senate,"Senate Floor: SR 258 PN 1505",31,19,0,0,50
1870529,1422864,2024-04-09,Senate,"Senate Transportation: Reported as Committed",14,0,0,0,14
1870529,1435969,2024-04-29,Senate,"Senate Appropriations: Re-Reported as Committed",24,0,0,0,24
1870529,1440693,2024-05-08,Senate,"Senate Floor: SB 916 PN 1510, Final Passage",48,0,0,2,50
1870529,1460162,2024-06-26,House,"House Transportation: Report Bill As Amended",25,0,0,0,25
1870529,1460163,2024-06-26,House,"House Transportation: Adopt Amendment A05093",25,0,0,0,25
1870529,1462162,2024-07-02,House,"House Floor: SB 916 PN 1786, FINAL PASSAGE",200,1,0,2,203
1870529,1462163,2024-07-02,House,"House Appropriations: Re-report Bill As Committed",37,0,0,0,37
1870529,1462436,2024-07-03,Senate,"Senate Floor: SB 916 PN 1786, Concur in House Amendments",49,0,0,1,50
1870529,1462437,2024-07-03,Senate,"Senate Rules And Executive Nominations: Re-Reported as Committed",17,0,0,0,17
1870549,1467323,2024-09-17,Senate,"Senate Local Government: Reported as Amended",11,0,0,0,11
1870549,1467324,2024-09-17,Senate,"Senate Local Government: Adopt Amendment A05603",11,0,0,0,11
1870549,1467813,2024-09-30,Senate,"Senate Appropriations: Re-Reported as Committed",23,0,1,0,24
1870549,1468165,2024-10-07,Senate,"Senate Floor: SB 1131 PN 1887, Final Passage",48,0,0,2,50
1870615,1426995,2024-04-15,House,"House Veterans Affairs And Emergency Preparedness: Report Bill As Committed",25,0,0,0,25
1870615,1430158,2024-04-17,House,"House Floor: HR 377 PN 2872",199,1,0,2,202
1870661,1445415,2024-05-21,House,"House Commerce: Bring Up The Bill For Consideration",25,0,0,0,25
1870661,1445416,2024-05-21,House,"House Commerce: Adopt Amendment A04461",25,0,0,0,25
1870661,1445417,2024-05-21,House,"House Commerce: Report Bill As Amended",14,11,0,0,25
1870661,1455722,2024-06-10,House,"House Floor: HB 2196 PN 3139, 2023 A4776",98,103,0,2,203
1870661,1455723,2024-06-10,House,"House Floor: HB 2196 PN 3139, 2023 A4779",200,1,0,2,203
1870674,1427089,2024-04-15,House,"House Floor: UNCONTESTED CALENDAR",201,0,0,1,202
1870701,1429468,2024-04-17,House,"House Finance: Report Bill As Committed",25,0,0,0,25
1870754,1452860,2024-06-03,House,"House Judiciary: Report Bill As Committed",25,0,0,0,25
1870818,1426988,2024-04-15,House,"House Transportation: Report Bill As Committed",25,0,0,0,25
1870818,1429410,2024-04-17,House,"House Floor: HR 380 PN 2894",200,0,0,2,202
1870844,1456631,2024-06-12,House,"House Judiciary: Adopt Amendment A04914",15,10,0,0,25
1870844,1456632,2024-06-12,House,"House Judiciary: Report Bill As Amended",14,11,0,0,25
1870844,1460225,2024-06-26,House,"House Floor: HB 2198 PN 3320, 2023 A5165, MOTION TO APPEAL RULING OF THE CHAIR",102,100,0,1,203
1870844,1460226,2024-06-26,House,"House Rules: Re-report Bill As Committed",18,15,0,0,33
1870844,1460960,2024-06-27,House,"House Appropriations: Re-report Bill As Committed",37,0,0,0,37
1870844,1461186,2024-06-27,House,"House Floor: HB 2198 PN 3320, FINAL PASSAGE",137,65,0,1,203
1870924,1429258,2024-04-17,House,"House Labor And Industry: Re-refer Bill To Another Committee",25,0,0,0,25
1870924,1435971,2024-04-29,House,"House State Government: Report Bill As Committed",24,1,0,0,25
1871015,1436103,2024-04-29,House,"House State Government: Report Bill As Committed",24,1,0,0,25
1871015,1440681,2024-05-07,House,"House Floor: HR 385 PN 2918",200,1,0,1,202
1871061,1426922,2024-04-15,House,"House Professional Licensure: Report Bill As Committed",25,0,0,0,25
1871061,1436446,2024-04-30,House,"House Floor: HB 2200 PN 2889, FINAL PASSAGE",200,0,0,2,202
1871061,1436447,2024-04-30,House,"House Appropriations: Re-report Bill As Committed",37,0,0,0,37
1871061,1461897,2024-07-01,Senate,"Senate Consumer Protection And Professional Licensure: Reported as Committed",14,0,0,0,14
1871061,1462150,2024-07-02,Senate,"Senate Appropriations: Re-Reported as Committed",24,0,0,0,24
1871061,1462406,2024-07-03,Senate,"Senate Floor: HB 2200 PN 2889, Final Passage",49,0,0,1,50
1871091,1427774,2024-04-16,House,"House Commerce: Bring Up The Bill For Consideration",25,0,0,0,25
1871091,1427775,2024-04-16,House,"House Commerce: Adopt Amendment A04024",25,0,0,0,25
1871091,1427776,2024-04-16,House,"House Commerce: Adopt Amendment A04033",25,0,0,0,25
1871091,1427777,2024-04-16,House,"House Commerce: Adopt Amendment A04051",25,0,0,0,25
1871091,1427778,2024-04-16,House,"House Commerce: Report Bill As Amended",19,6,0,0,25
1871091,1436636,2024-04-30,House,"House Floor: HB 2202 PN 2950, MOTION TO TABLE AMENDMENTS",101,99,0,2,202
1871091,1437426,2024-05-01,House,"House Floor: HB 2202 PN 2950, FINAL PASSAGE",104,97,0,1,202
1871091,1437427,2024-05-01,House,"House Appropriations: Re-report Bill As Committed",22,14,1,0,37
1871114,1459728,2024-06-24,House,"House Appropriations: Report Bill As Committed",22,15,0,0,37
1871114,1461025,2024-06-27,House,"House Rules: Re-report Bill As Committed",33,0,0,0,33
1871119,1459712,2024-06-24,House,"House Appropriations: Report Bill As Committed",22,15,0,0,37
1871119,1461013,2024-06-27,House,"House Rules: Re-report Bill As Committed",33,0,0,0,33
1871128,1459719,2024-06-24,House,"House Appropriations: Report Bill As Committed",22,15,0,0,37
1871128,1461028,2024-06-27,House,"House Rules: Re-report Bill As Committed",33,0,0,0,33
1871134,1459791,2024-06-24,House,"House Appropriations: Report Bill As Committed",22,15,0,0,37
1871134,1461033,2024-06-27,House,"House Rules: Re-report Bill As Committed",33,0,0,0,33
1871140,1426970,2024-04-15,House,"House Transportation: Report Bill As Committed",25,0,0,0,25
1871140,1468728,2024-10-21,House,"House Floor: HB 2203 PN 2902, FINAL PASSAGE",202,0,0,1,203
1871140,1468729,2024-10-21,House,"House Appropriations: Re-report Bill As Committed",37,0,0,0,37
1871145,1459666,2024-06-24,House,"House Appropriations: Report Bill As Committed",22,15,0,0,37
1871145,1460168,2024-06-26,House,"House Rules: Re-report Bill As Committed",18,15,0,0,33
1871150,1459714,2024-06-24,House,"House Appropriations: Report Bill As Committed",22,15,0,0,37
1871150,1461181,2024-06-27,House,"House Rules: Re-report Bill As Committed",33,0,0,0,33
1871157,1459729,2024-06-24,House,"House Appropriations: Adopt Amendment A05072",22,15,0,0,37
1871157,1459730,2024-06-24,House,"House Appropriations: Report Bill As Amended",22,15,0,0,37
1871157,1461167,2024-06-27,House,"House Floor: HB 2328 PN 3383, 2023 A5172",100,102,0,1,203
1871157,1461168,2024-06-27,House,"House Appropriations: Re-report Bill As Committed",37,0,0,0,37
1871157,1461169,2024-06-27,House,"House Rules: Re-report Bill As Committed",18,15,0,0,33
1871157,1461488,2024-06-28,House,"House Floor: HB 2328 PN 3383, FINAL PASSAGE",167,35,0,1,203
1871157,1467316,2024-09-16,Senate,"Senate Appropriations: Adopt Amendment A05591",23,0,1,0,24
1871157,1467317,2024-09-16,Senate,"Senate Appropriations: Reported as Amended",23,0,1,0,24
1871157,1467440,2024-09-18,Senate,"Senate Floor: HB 2328 PN 3602, Final Passage",47,2,0,1,50
1871157,1467840,2024-09-30,House,"House Floor: HB 2328 PN 3602, CONCURRENCE",195,7,0,1,203
1871157,1467841,2024-09-30,House,"House Rules: Re-report Bill As Committed",32,0,0,0,32
1871161,1459837,2024-06-24,House,"House Appropriations: Adopt Amendment A05121",22,15,0,0,37
1871161,1459838,2024-06-24,House,"House Appropriations: Report Bill As Amended",22,15,0,0,37
1871161,1461010,2024-06-27,House,"House Rules: Re-report Bill As Committed",33,0,0,0,33
1871168,1459725,2024-06-24,House,"House Appropriations: Report Bill As Committed",37,0,0,0,37
1871168,1461164,2024-06-27,House,"House Rules: Re-report Bill As Committed",33,0,0,0,33
1871172,1459292,2024-06-24,House,"House Appropriations: Adopt Amendment A05052",22,15,0,0,37
1871172,1459293,2024-06-24,House,"House Appropriations: Report Bill As Amended",22,15,0,0,37
1871172,1461023,2024-06-27,House,"House Rules: Re-report Bill As Committed",33,0,0,0,33
1871179,1459620,2024-06-24,House,"House Appropriations: Adopt Amendment A05114",37,0,0,0,37
1871179,1459621,2024-06-24,House,"House Appropriations: Report Bill As Amended",22,15,0,0,37
1871179,1461159,2024-06-27,House,"House Rules: Re-report Bill As Committed",33,0,0,0,33
1871183,1459760,2024-06-24,House,"House Appropriations: Report Bill As Committed",22,15,0,0,37
1871183,1461012,2024-06-27,House,"House Rules: Re-report Bill As Committed",33,0,0,0,33
1871189,1459241,2024-06-24,House,"House Appropriations: Report Bill As Committed",22,15,0,0,37
1871189,1461163,2024-06-27,House,"House Rules: Re-report Bill As Committed",33,0,0,0,33
1871229,1426899,2024-04-15,House,"House Veterans Affairs And Emergency Preparedness: Report Bill As Committed",25,0,0,0,25
1871511,1468206,2024-10-07,House,"House Consumer Protection, Technology And Utilities: Report Bill As Committed",25,0,0,0,25
1871875,1429756,2024-04-17,House,"House Judiciary: Report Bill As Committed",14,11,0,0,25
1871875,1436887,2024-04-30,House,"House Floor: HR 394 PN 2928, 2023 A4121",200,0,0,2,202
1871875,1436888,2024-04-30,House,"House Floor: HR 394 PN 2928, 2023 A4129",198,2,0,2,202
1871875,1436889,2024-04-30,House,"House Floor: HR 394 PN 2928, 2023 A4197",99,101,0,2,202
1871875,1436890,2024-04-30,House,"House Floor: HR 394 PN 2928, 2023 A4199",183,17,0,2,202
1871875,1436891,2024-04-30,House,"House Floor: HR 394 PN 3017",168,32,0,2,202
1871946,1429326,2024-04-17,House,"House Labor And Industry: Adopt Amendment A04035",25,0,0,0,25
1871946,1429327,2024-04-17,House,"House Labor And Industry: Report Bill As Amended",14,11,0,0,25
1871975,1439409,2024-05-06,House,"House Children And Youth: Report Bill As Committed",24,1,0,0,25
1872008,1429758,2024-04-17,House,"House Judiciary: Report Bill As Committed",15,10,0,0,25
1872008,1440157,2024-05-07,House,"House Floor: HB 2206 PN 2923, FINAL PASSAGE",101,100,0,1,202
1872008,1440158,2024-05-07,House,"House Appropriations: Re-report Bill As Committed",22,14,1,0,37
1872191,1436396,2024-04-30,House,"House Health: Report Bill As Amended",24,1,0,0,25
1872191,1436397,2024-04-30,House,"House Health: Adopt Amendment A04224",25,0,0,0,25
1872191,1441123,2024-05-08,House,"House Floor: HB 2208 PN 3014, 2023 A4325",200,0,0,2,202
1872191,1441124,2024-05-08,House,"House Floor: HB 2208 PN 3014, 2023 A4396",200,0,0,2,202
1872191,1445695,2024-05-21,House,"House Appropriations: Re-report Bill As Committed",37,0,0,0,37
1872191,1446155,2024-05-21,House,"House Floor: HB 2208 PN 3078, FINAL PASSAGE",196,6,0,1,203
1872281,1453288,2024-06-04,House,"House Liquor Control: Report Bill As Committed",25,0,0,0,25
1872361,1429538,2024-04-17,House,"House Health: Report Bill As Committed",25,0,0,0,25
1872361,1436867,2024-04-30,House,"House Floor: HR 395 PN 2937",198,2,0,2,202
1872473,1436378,2024-04-30,House,"House Health: Report Bill As Committed",25,0,0,0,25
1872473,1447978,2024-05-22,House,"House Floor: HR 397 PN 2949",201,1,0,1,203
1872525,1452583,2024-06-03,House,"House State Government: Re-report Bill As Committed",25,0,0,0,25
1872525,1460321,2024-06-26,House,"House Floor: HB 2216 PN 2947, 2023 A5159",201,0,0,2,203
1872525,1461142,2024-06-27,House,"House Floor: HB 2216 PN 3419, FINAL PASSAGE",201,0,0,2,203
1872525,1461143,2024-06-27,House,"House Appropriations: Re-report Bill As Committed",37,0,0,0,37
1872525,1462714,2024-07-08,Senate,"Senate State Government: Reported as Amended",11,0,0,0,11
1872525,1462715,2024-07-08,Senate,"Senate State Government: Adopt Amendment A05452",7,4,0,0,11
1872525,1462837,2024-07-09,Senate,"Senate Floor: HB 2216 PN 3493, 2023 A5491, PITTMAN Amendment No. A-5491",48,1,0,1,50
1872525,1462930,2024-07-10,Senate,"Senate Floor: HB 2216 PN 3498, Final Passage",47,2,0,1,50
1872525,1462948,2024-07-11,House,"House Rules: Re-report Bill As Committed",33,0,0,0,33
1872525,1463010,2024-07-11,House,"House Floor: HB 2216 PN 3498, CONCURRENCE",201,0,0,2,203
1872769,1452578,2024-06-03,House,"House State Government: Report Bill As Committed",24,1,0,0,25
1872769,1462123,2024-07-01,House,"House Floor: HR 398 PN 2957",179,23,0,1,203
1872784,1468267,2024-10-07,House,"House Transportation: Report Bill As Amended",24,1,0,0,25
1872784,1468268,2024-10-07,House,"House Transportation: Adopt Amendment A05837",25,0,0,0,25
1872808,1439889,2024-05-07,House,"House Professional Licensure: Report Bill As Committed",25,0,0,0,25
1872808,1448019,2024-05-22,House,"House Floor: HB 2220 PN 2956, FINAL PASSAGE",202,0,0,1,203
1872808,1448020,2024-05-22,House,"House Appropriations: Re-report Bill As Committed",37,0,0,0,37
1872818,1455920,2024-06-11,Senate,"Senate Veterans Affairs And Emergency Preparedness: Reported as Committed",10,0,0,0,10
1872818,1462119,2024-07-01,Senate,"Senate Appropriations: Re-Reported as Committed",24,0,0,0,24
1872818,1462946,2024-07-10,Senate,"Senate Floor: SB 1160 PN 1524, Final Passage",49,0,0,1,50
1872818,1468143,2024-10-07,House,"House Veterans Affairs And Emergency Preparedness: Report Bill As Committed",25,0,0,0,25
1872818,1468826,2024-10-22,House,"House Appropriations: Re-report Bill As Committed",37,0,0,0,37
1872818,1468858,2024-10-22,House,"House Floor: SB 1160 PN 1524, FINAL PASSAGE",202,0,0,1,203
1872914,1436442,2024-04-30,House,"House Agriculture And Rural Affairs: Report Bill As Committed",25,0,0,0,25
1873047,1457084,2024-06-12,House,"House Finance: Report Bill As Amended",14,11,0,0,25
1873047,1457085,2024-06-12,House,"House Finance: Adopt Amendment A04833",11,14,0,0,25
1873047,1457086,2024-06-12,House,"House Finance: Adopt Amendment A04845",11,14,0,0,25
1873047,1457087,2024-06-12,House,"House Finance: Adopt Amendment A04931",25,0,0,0,25
1873047,1457088,2024-06-12,House,"House Finance: Adopt Amendment A04942",14,11,0,0,25
1873047,1457089,2024-06-12,House,"House Finance: To Table",11,14,0,0,25
1873092,1436670,2024-04-30,House,"House Agriculture And Rural Affairs: Report Bill As Committed",22,3,0,0,25
1873092,1441273,2024-05-08,House,"House Floor: HB 2225 PN 2965, FINAL PASSAGE",121,79,0,2,202
1873092,1450739,2024-05-08,House,"House Appropriations: Re-report Bill As Committed",22,15,0,0,37
1873129,1436335,2024-04-30,House,"House Agriculture And Rural Affairs: Report Bill As Committed",25,0,0,0,25
1873129,1457024,2024-06-12,House,"House Floor: HR 400 PN 2967",200,1,0,2,203
1873139,1435959,2024-04-29,House,"House Judiciary: Adopt Amendment A04103",14,11,0,0,25
1873139,1435960,2024-04-29,House,"House Judiciary: Report Bill As Amended",14,11,0,0,25
1873156,1439368,2024-05-06,House,"House Agriculture And Rural Affairs: Report Bill As Committed",19,0,6,0,25
1873156,1453076,2024-06-03,House,"House Floor: HR 402 PN 2979",201,1,0,1,203
1873500,1439373,2024-05-06,House,"House Veterans Affairs And Emergency Preparedness: Report Bill As Committed",25,0,0,0,25
1873649,1454002,2024-06-05,Senate,"Senate Transportation: Reported as Amended",14,0,0,0,14
1873649,1454003,2024-06-05,Senate,"Senate Transportation: Adopt Amendment A04564",14,0,0,0,14
1873649,1459499,2024-06-24,Senate,"Senate Appropriations: Re-Reported as Committed",24,0,0,0,24
1873649,1460228,2024-06-26,Senate,"Senate Floor: SB 1147 PN 1682, Final Passage",50,0,0,0,50
1873649,1467731,2024-09-30,House,"House Transportation: Report Bill As Amended",25,0,0,0,25
1873649,1467732,2024-09-30,House,"House Transportation: Adopt Amendment A05688",25,0,0,0,25
1873649,1468558,2024-10-09,House,"House Floor: SB 1147 PN 1915, FINAL PASSAGE",201,1,0,1,203
1873649,1468559,2024-10-09,House,"House Appropriations: Re-report Bill As Committed",37,0,0,0,37
1873704,1453366,2024-06-04,Senate,"Senate State Government: Reported as Committed",11,0,0,0,11
1873704,1455690,2024-06-10,Senate,"Senate Appropriations: Re-Reported as Committed",24,0,0,0,24
1873704,1456577,2024-06-12,Senate,"Senate Floor: SB 1138 PN 1725, Final Passage",48,0,0,2,50
1873704,1459049,2024-06-24,House,"House State Government: Report Bill As Committed",25,0,0,0,25
1873704,1461310,2024-06-27,House,"House Appropriations: Re-report Bill As Committed",37,0,0,0,37
1873704,1461379,2024-06-28,House,"House Floor: SB 1138 PN 1725, FINAL PASSAGE",202,0,0,1,203
1873743,1436514,2024-04-30,Senate,"Senate Consumer Protection And Professional Licensure: Reported as Committed",14,0,0,0,14
1873743,1440487,2024-05-07,Senate,"Senate Appropriations: Re-Reported as Committed",24,0,0,0,24
1873743,1454078,2024-06-05,Senate,"Senate Floor: SB 1165 PN 1534, Final Passage",46,4,0,0,50
1873743,1456582,2024-06-12,House,"House Professional Licensure: Report Bill As Committed",25,0,0,0,25
1873791,1467729,2024-09-30,Senate,"Senate Education: Reported as Amended",10,0,1,0,11
1873791,1467730,2024-09-30,Senate,"Senate Education: Adopt Amendment A05712",10,0,1,0,11
1873791,1467892,2024-10-01,Senate,"Senate Appropriations: Re-Reported as Committed",23,0,1,0,24
1873791,1468278,2024-10-07,Senate,"Senate Floor: SB 1176 PN 1911, Final Passage",47,1,0,2,50
1873799,1436106,2024-04-29,House,"House Judiciary: Report Bill As Committed",14,11,0,0,25
1873802,1436398,2024-04-30,Senate,"Senate Education: Reported as Committed",8,3,0,0,11
1873802,1455695,2024-06-10,Senate,"Senate Appropriations: Re-Reported as Committed",15,9,0,0,24
1873802,1458974,2024-06-24,Senate,"Senate Floor: SB 1157 PN 1536, Final Passage",28,22,0,0,50
1873806,1454028,2024-06-05,Senate,"Senate Labor And Industry: Reported as Committed",7,4,0,0,11
1873806,1461942,2024-07-01,Senate,"Senate Appropriations: Re-Reported as Committed",15,9,0,0,24
1873806,1462152,2024-07-02,Senate,"Senate Floor: SB 1177 PN 1550, Final Passage",28,22,0,0,50
1873815,1457105,2024-06-12,Senate,"Senate Education: Reported as Committed",8,3,0,0,11
1873827,1436351,2024-04-30,Senate,"Senate Consumer Protection And Professional Licensure: Reported as Committed",13,1,0,0,14
1873827,1440611,2024-05-07,Senate,"Senate Appropriations: Re-Reported as Committed",24,0,0,0,24
1873827,1453306,2024-06-04,Senate,"Senate Floor: SB 1173 PN 1672, Final Passage",49,1,0,0,50
1873827,1460187,2024-06-26,House,"House Professional Licensure: Report Bill As Amended",25,0,0,0,25
1873827,1460188,2024-06-26,House,"House Professional Licensure: Adopt Amendment A05182",25,0,0,0,25
1873827,1461920,2024-07-01,House,"House Floor: SB 1173 PN 1782, FINAL PASSAGE",202,0,0,1,203
1873827,1461921,2024-07-01,House,"House Appropriations: Re-report Bill As Committed",37,0,0,0,37
1873827,1462148,2024-07-02,Senate,"Senate Floor: SB 1173 PN 1782, Concur in House Amendments",49,1,0,0,50
1873827,1462149,2024-07-02,Senate,"Senate Rules And Executive Nominations: Re-Reported as Committed",17,0,0,0,17
1873847,1456063,2024-06-11,House,"House Housing And Community Development: Report Bill As Committed",25,0,0,0,25
1873847,1461885,2024-07-01,House,"House Rules: Re-report Bill As Committed",33,0,0,0,33
1873847,1461945,2024-07-01,House,"House Floor: HB 2232 PN 2986, 2023 A4998",129,73,0,1,203
1873847,1462143,2024-07-02,House,"House Appropriations: Re-report Bill As Committed",37,0,0,0,37
1873847,1462195,2024-07-02,House,"House Floor: HB 2232 PN 3463, FINAL PASSAGE",102,99,0,2,203
1873857,1456707,2024-06-12,Senate,"Senate Education: Reported as Committed",8,3,0,0,11
1873862,1457059,2024-06-12,Senate,"Senate Education: Reported as Amended",7,4,0,0,11
1873862,1457060,2024-06-12,Senate,"Senate Education: Adopt Amendment A04911",8,3,0,0,11
1873862,1460304,2024-06-26,Senate,"Senate Floor: SB 913 PN 1727, 2023 A5214, LANGERHOLC Amendment No. A-5214",28,22,0,0,50
1873862,1460305,2024-06-26,Senate,"Senate Appropriations: Re-Reported as Committed",15,8,1,0,24
1873862,1461194,2024-06-27,Senate,"Senate Floor: SB 913 PN 1788, Final Passage",28,21,0,1,50
1873865,1436625,2024-04-30,Senate,"Senate Consumer Protection And Professional Licensure: Reported as Committed",10,4,0,0,14
1873865,1468468,2024-10-09,House,"House Appropriations: Re-report Bill As Committed",37,0,0,0,37
1873871,1437512,2024-05-01,Senate,"Senate Finance: Reported as Amended",11,0,0,0,11
1873871,1437513,2024-05-01,Senate,"Senate Finance: Adopt Amendment A04151",11,0,0,0,11
1873871,1452789,2024-06-03,Senate,"Senate Appropriations: Re-Reported as Committed",24,0,0,0,24
1873871,1453240,2024-06-04,Senate,"Senate Floor: SB 1149 PN 1576, Final Passage",50,0,0,0,50
1874208,1439518,2024-05-06,House,"House Insurance: Adopt Amendment A04257",14,11,0,0,25
1874208,1439519,2024-05-06,House,"House Insurance: Report Bill As Committed",14,11,0,0,25
1874208,1453356,2024-06-04,House,"House Floor: HB 2234 PN 3056, 2023 A4680",101,101,0,1,203
1874208,1453357,2024-06-04,House,"House Floor: HB 2234 PN 3056, 2023 A4697",100,102,0,1,203
1874208,1453975,2024-06-05,House,"House Floor: HB 2234 PN 3056, FINAL PASSAGE",106,96,0,1,203
1874208,1453976,2024-06-05,House,"House Appropriations: Re-report Bill As Committed",22,15,0,0,37
1874228,1439426,2024-05-06,House,"House Transportation: Report Bill As Amended",25,0,0,0,25
1874228,1439427,2024-05-06,House,"House Transportation: Adopt Amendment A04311",25,0,0,0,25
1874228,1448154,2024-05-22,House,"House Floor: HB 2233 PN 3052, 2023 A4519",201,1,0,1,203
1874228,1452599,2024-06-03,House,"House Appropriations: Re-report Bill As Committed",37,0,0,0,37
1874228,1452891,2024-06-03,House,"House Floor: HB 2233 PN 3164, FINAL PASSAGE",198,4,0,1,203
1874228,1459819,2024-06-25,Senate,"Senate Transportation: Reported as Committed",14,0,0,0,14
1874228,1460328,2024-06-26,Senate,"Senate Floor: HB 2233 PN 3164, Motion to agree to the bill on second consideration",49,0,0,1,50
1874228,1462145,2024-07-02,Senate,"Senate Floor: HB 2233 PN 3164, Final Passage",50,0,0,0,50
1874228,1462146,2024-07-02,Senate,"Senate Appropriations: Re-Reported as Committed",24,0,0,0,24
1874250,1435954,2024-04-29,House,"House State Government: Report Bill As Committed",24,1,0,0,25
1874250,1446157,2024-05-21,House,"House Floor: HR 406 PN 2981",201,1,0,1,203
1874279,1436403,2024-04-30,House,"House Labor And Industry: Adopt Amendment A04152",11,14,0,0,25
1874279,1436404,2024-04-30,House,"House Labor And Industry: Adopt Amendment A04153",11,14,0,0,25
1874279,1436405,2024-04-30,House,"House Labor And Industry: Report Bill As Amended",14,11,0,0,25
1874279,1453170,2024-06-04,House,"House Floor: HB 2235 PN 2989, 2023 A4660",114,88,0,1,203
1874279,1454017,2024-06-05,House,"House Floor: HB 2235 PN 3240, FINAL PASSAGE",120,82,0,1,203
1874279,1454018,2024-06-05,House,"House Appropriations: Re-report Bill As Committed",23,14,0,0,37
1874322,1453934,2024-06-05,House,"House Labor And Industry: Adopt Amendment A04672",11,14,0,0,25
1874322,1453935,2024-06-05,House,"House Labor And Industry: Report Bill As Committed",14,11,0,0,25
1874322,1458921,2024-06-24,House,"House Floor: HR 407 PN 2992",200,2,0,1,203
1874425,1455942,2024-06-11,House,"House Environmental Resources And Energy: Report Bill As Committed",14,11,0,0,25
1874455,1436528,2024-04-30,House,"House Health: Report Bill As Committed",25,0,0,0,25
1874455,1441406,2024-05-08,House,"House Floor: HR 409 PN 2993",179,21,0,2,202
1874771,1440309,2024-05-07,House,"House State Government: Report Bill As Committed",25,0,0,0,25
1874771,1441230,2024-05-08,House,"House Floor: HR 410 PN 3002",200,0,0,2,202
1874777,1436539,2024-04-30,Senate,"Senate Education: Reported as Committed",8,3,0,0,11
1874777,1455693,2024-06-10,Senate,"Senate Appropriations: Re-Reported as Committed",19,5,0,0,24
1874777,1456244,2024-06-11,Senate,"Senate Floor: SB 1150 PN 1711, Final Passage",49,0,0,1,50
1874777,1460197,2024-06-26,House,"House Education: Report Bill As Committed",25,0,0,0,25
1874777,1462971,2024-07-11,House,"House Appropriations: Re-report Bill As Amended",37,0,0,0,37
1874777,1462972,2024-07-11,House,"House Appropriations: Adopt Amendment A05528",37,0,0,0,37
1874777,1463022,2024-07-11,House,"House Floor: SB 1150 PN 1818, FINAL PASSAGE",202,0,0,1,203
1874777,1463023,2024-07-11,Senate,"Senate Floor: SB 1150 PN 1818, Concur in House Amendments",49,0,0,1,50
1874777,1463024,2024-07-11,Senate,"Senate Rules And Executive Nominations: Re-Reported as Committed",17,0,0,0,17
1874780,1436366,2024-04-30,Senate,"Senate Education: Reported as Committed",7,4,0,0,11
1874780,1455707,2024-06-10,Senate,"Senate Floor: SB 1155 PN 1560, 2023 A4850, ARGALL Amendment No. A-4850",29,21,0,0,50
1874780,1455708,2024-06-10,Senate,"Senate Appropriations: Re-Reported as Committed",20,4,0,0,24
1874780,1456104,2024-06-11,Senate,"Senate Floor: SB 1155 PN 1714, Final Passage",28,21,0,1,50
1874783,1467635,2024-09-25,House,"House Local Government: Report Bill As Committed",14,11,0,0,25
1874788,1436460,2024-04-30,Senate,"Senate Education: Reported as Committed",7,4,0,0,11
1874788,1455702,2024-06-10,Senate,"Senate Floor: SB 1153 PN 1558, Final Passage",50,0,0,0,50
1874788,1455703,2024-06-10,Senate,"Senate Appropriations: Re-Reported as Committed",24,0,0,0,24
1874791,1436510,2024-04-30,Senate,"Senate Education: Reported as Committed",8,3,0,0,11
1874791,1455696,2024-06-10,Senate,"Senate Appropriations: Re-Reported as Committed",19,5,0,0,24
1874791,1456250,2024-06-11,Senate,"Senate Floor: SB 1151 PN 1712, Final Passage",48,1,0,1,50
1874794,1436543,2024-04-30,Senate,"Senate Education: Reported as Committed",6,5,0,0,11
1874794,1455691,2024-06-10,Senate,"Senate Floor: SB 1154 PN 1559, 2023 A4868, AUMENT Amendment No. A-4868",29,21,0,0,50
1874794,1455692,2024-06-10,Senate,"Senate Appropriations: Re-Reported as Committed",15,9,0,0,24
1874794,1456071,2024-06-11,Senate,"Senate Floor: SB 1154 PN 1713, Final Passage",28,21,0,1,50
1874794,1462835,2024-07-09,House,"House Education: Report Bill As Committed",25,0,0,0,25
1874794,1462870,2024-07-10,House,"House Floor: SB 1154 PN 1713, 2023 A5499",95,107,0,1,203
1874794,1462981,2024-07-11,House,"House Floor: SB 1154 PN 1819, FINAL PASSAGE",188,14,0,1,203
1874794,1462982,2024-07-11,House,"House Appropriations: Re-report Bill As Amended",37,0,0,0,37
1874794,1462983,2024-07-11,House,"House Appropriations: Adopt Amendment A05529",37,0,0,0,37
1874794,1463054,2024-07-11,Senate,"Senate Floor: SB 1154 PN 1819, Concur in House Amendments",37,12,0,1,50
1874794,1463055,2024-07-11,Senate,"Senate Floor: SB 1154 PN 1819, Concur in House Amendments Reconsideration",38,11,0,1,50
1874794,1463056,2024-07-11,Senate,"Senate Rules And Executive Nominations: Re-Reported as Committed",15,2,0,0,17
1874795,1436523,2024-04-30,Senate,"Senate Education: Reported as Committed",8,3,0,0,11
1874795,1455711,2024-06-10,Senate,"Senate Floor: SB 1152 PN 1557, Final Passage",47,3,0,0,50
1874795,1455712,2024-06-10,Senate,"Senate Appropriations: Re-Reported as Committed",21,3,0,0,24
1874820,1445619,2024-05-21,House,"House Tourism And Economic And Recreational Development: Report Bill As Committed",25,0,0,0,25
1874820,1463012,2024-07-11,House,"House Floor: HR 411 PN 3003",200,2,0,1,203
1874840,1453114,2024-06-04,House,"House Environmental Resources And Energy: Adopt Amendment A04649",14,11,0,0,25
1874840,1453115,2024-06-04,House,"House Environmental Resources And Energy: Report Bill As Amended",14,11,0,0,25
1874840,1462393,2024-07-03,House,"House Rules: Re-report Bill As Committed",18,15,0,0,33
1874840,1462719,2024-07-08,House,"House Floor: HB 2241 PN 3223, FINAL PASSAGE",115,86,0,2,203
1874840,1462720,2024-07-08,House,"House Appropriations: Re-report Bill As Committed",37,0,0,0,37
1874897,1439906,2024-05-07,House,"House Labor And Industry: Adopt Amendment A04323",11,14,0,0,25
1874897,1439907,2024-05-07,House,"House Labor And Industry: Report Bill As Committed",14,11,0,0,25
1874950,1436654,2024-04-30,House,"House Health: Report Bill As Committed",14,11,0,0,25
1874950,1439421,2024-05-06,House,"House Floor: HR 413 PN 3011",130,71,0,1,202
1875021,1437510,2024-05-01,House,"House Appropriations: Report Bill As Committed",36,0,1,0,37
1875021,1440613,2024-05-07,House,"House Floor: HR 414 PN 3025",199,2,0,1,202
1875171,1439367,2024-05-06,House,"House Transportation: Report Bill As Committed",25,0,0,0,25
1875171,1452597,2024-06-03,House,"House Appropriations: Re-report Bill As Committed",37,0,0,0,37
1875171,1452886,2024-06-03,House,"House Floor: HB 2251 PN 3023, FINAL PASSAGE",201,1,0,1,203
1875196,1456072,2024-06-11,House,"House Housing And Community Development: Adopt Amendment A04815",25,0,0,0,25
1875196,1456073,2024-06-11,House,"House Housing And Community Development: Report Bill As Amended",25,0,0,0,25
1875297,1453097,2024-06-04,Senate,"Senate State Government: Reported as Committed",7,4,0,0,11
1875297,1459326,2024-06-24,Senate,"Senate Appropriations: Re-Reported as Committed",15,9,0,0,24
1875297,1462120,2024-07-01,Senate,"Senate Floor: SB 1183 PN 1572, 2023 A-4706, Motion to Table MUTH Amendment No. A-4706",28,22,0,0,50
1875297,1462121,2024-07-01,Senate,"Senate Floor: SB 1183 PN 1572, 2023 A-5383, Motion to Table MUTH Amendment No. A-5383",28,22,0,0,50
1875297,1462122,2024-07-01,Senate,"Senate Floor: SB 1183 PN 1572, Final Passage",28,22,0,0,50
1875336,1439402,2024-05-06,House,"House Veterans Affairs And Emergency Preparedness: Report Bill As Committed",25,0,0,0,25
1875626,1458874,2024-06-24,House,"House Judiciary: Report Bill As Committed",25,0,0,0,25
1875788,1445518,2024-05-21,House,"House Tourism And Economic And Recreational Development: Report Bill As Amended",25,0,0,0,25
1875788,1445519,2024-05-21,House,"House Tourism And Economic And Recreational Development: Adopt Amendment A04498",25,0,0,0,25
1875788,1452633,2024-06-03,House,"House Floor: HR 417 PN 3146",200,2,0,1,203
1875926,1454150,2024-06-05,House,"House Local Government: Report Bill As Committed",25,0,0,0,25
1875926,1460950,2024-06-27,House,"House Rules: Re-report Bill As Committed",33,0,0,0,33
1875926,1461139,2024-06-27,House,"House Floor: HB 2265 PN 3043, 2023 A5128",202,0,0,1,203
1875926,1461140,2024-06-27,House,"House Appropriations: Report Bill As Committed",37,0,0,0,37
1875926,1461376,2024-06-28,House,"House Floor: HB 2265 PN 3437, FINAL PASSAGE",192,10,0,1,203
1875926,1467327,2024-09-17,Senate,"Senate Local Government: Reported as Committed",11,0,0,0,11
1875926,1468839,2024-10-22,Senate,"Senate Floor: HB 2265 PN 3437, Final Passage",49,1,0,0,50
1875926,1468840,2024-10-22,Senate,"Senate Appropriations: Re-Reported as Committed",24,0,0,0,24
1875935,1458951,2024-06-24,House,"House Transportation: Report Bill As Amended",25,0,0,0,25
1875935,1458952,2024-06-24,House,"House Transportation: Adopt Amendment A05057",25,0,0,0,25
1875935,1458953,2024-06-24,House,"House Transportation: Adopt Amendment A05063",25,0,0,0,25
1875935,1461050,2024-06-27,House,"House Floor: HB 2266 PN 3364, 2023 A5251",202,0,0,1,203
1875935,1461051,2024-06-27,House,"House Rules: Re-report Bill As Committed",33,0,0,0,33
1875935,1461312,2024-06-27,House,"House Appropriations: Re-report Bill As Committed",37,0,0,0,37
1875935,1461355,2024-06-28,House,"House Floor: HB 2266 PN 3438, FINAL PASSAGE",177,25,0,1,203
1875935,1462130,2024-07-01,Senate,"Senate Transportation: Reported as Committed",14,0,0,0,14
1875935,1468479,2024-10-09,Senate,"Senate Appropriations: Re-Reported as Committed",22,2,0,0,24
1875935,1468561,2024-10-09,Senate,"Senate Floor: HB 2266 PN 3438, Final Passage",48,1,0,1,50
1876006,1455870,2024-06-11,House,"House Insurance: Adopt Amendment A04605",24,0,1,0,25
1876006,1455871,2024-06-11,House,"House Insurance: Report Bill As Amended",24,0,1,0,25
1876006,1459788,2024-06-25,House,"House Rules: Re-report Bill As Committed",33,0,0,0,33
1876006,1460236,2024-06-26,House,"House Floor: HB 2268 PN 3289, FINAL PASSAGE",181,21,0,1,203
1876006,1460237,2024-06-26,House,"House Appropriations: Re-report Bill As Committed",37,0,0,0,37
1876006,1468200,2024-10-07,Senate,"Senate Banking And Insurance: Reported as Committed",14,0,0,0,14
1876006,1468317,2024-10-08,Senate,"Senate Appropriations: Re-Reported as Committed",24,0,0,0,24
1876006,1468508,2024-10-09,Senate,"Senate Floor: HB 2268 PN 3289, Final Passage",49,0,0,1,50
1876024,1445426,2024-05-21,House,"House Health: Report Bill As Committed",25,0,0,0,25
1876024,1452991,2024-06-03,House,"House Floor: HR 419 PN 3049",201,1,0,1,203
1876043,1456174,2024-06-11,Senate,"Senate Veterans Affairs And Emergency Preparedness: Reported as Amended",10,0,0,0,10
1876043,1456175,2024-06-11,Senate,"Senate Veterans Affairs And Emergency Preparedness: Adopt Amendment A04794",10,0,0,0,10
1876043,1456176,2024-06-11,Senate,"Senate Veterans Affairs And Emergency Preparedness: Adopt Amendment A04867",10,0,0,0,10
1876133,1456557,2024-06-12,House,"House Judiciary: Adopt Amendment A04945",17,8,0,0,25
1876133,1456558,2024-06-12,House,"House Judiciary: Report Bill As Amended",17,8,0,0,25
1876133,1461888,2024-07-01,House,"House Rules: Re-report Bill As Committed",23,10,0,0,33
1876133,1462151,2024-07-02,House,"House Appropriations: Re-report Bill As Committed",37,0,0,0,37
1876133,1462199,2024-07-02,House,"House Floor: HB 2269 PN 3321, FINAL PASSAGE",133,68,0,2,203
1876187,1452579,2024-06-03,House,"House State Government: Report Bill As Committed",15,10,0,0,25
1876343,1456146,2024-06-11,House,"House Housing And Community Development: Adopt Amendment A04640",25,0,0,0,25
1876343,1456147,2024-06-11,House,"House Housing And Community Development: Report Bill As Amended",25,0,0,0,25
1876343,1462403,2024-07-03,House,"House Floor: HR 425 PN 3293",142,60,0,1,203
1876360,1445620,2024-05-21,House,"House Tourism And Economic And Recreational Development: Report Bill As Committed",25,0,0,0,25
1876736,1445493,2024-05-21,House,"House Tourism And Economic And Recreational Development: Report Bill As Committed",25,0,0,0,25
1876736,1454143,2024-06-05,House,"House Floor: HR 429 PN 3073",199,3,0,1,203
1877025,1445797,2024-05-21,House,"House Tourism And Economic And Recreational Development: Report Bill As Committed",16,9,0,0,25
1877092,1445487,2024-05-21,House,"House Health: Report Bill As Committed",25,0,0,0,25
1877128,1440764,2024-05-08,House,"House Rules: Report Bill As Committed",18,14,1,0,33
1877616,1453852,2024-06-05,House,"House Health: Report Bill As Amended",22,3,0,0,25
1877616,1453853,2024-06-05,House,"House Health: Adopt Amendment A04586",25,0,0,0,25
1877616,1461348,2024-06-28,House,"House Floor: HB 2283 PN 3246, 2023 A5262",202,0,0,1,203
1877616,1461349,2024-06-28,House,"House Rules: Re-report Bill As Committed",33,0,0,0,33
1877616,1461906,2024-07-01,House,"House Floor: HB 2283 PN 3443, FINAL PASSAGE",153,49,0,1,203
1877616,1461907,2024-07-01,House,"House Appropriations: Re-report Bill As Committed",22,15,0,0,37
1877616,1468253,2024-10-07,Senate,"Senate Health And Human Services: Reported as Committed",11,0,0,0,11
1877740,1468092,2024-10-02,House,"House Health: Report Bill As Committed",25,0,0,0,25
1877766,1445411,2024-05-21,House,"House Health: Report Bill As Committed",25,0,0,0,25
1877766,1461333,2024-06-27,House,"House Floor: HR 433 PN 3099",201,1,0,1,203
1877793,1459744,2024-06-25,House,"House Agriculture And Rural Affairs: Report Bill As Committed",25,0,0,0,25
1877793,1462423,2024-07-03,House,"House Rules: Re-report Bill As Committed",33,0,0,0,33
1877793,1462717,2024-07-08,House,"House Floor: HB 2286 PN 3093, FINAL PASSAGE",201,0,0,2,203
1877793,1462718,2024-07-08,House,"House Appropriations: Re-report Bill As Committed",37,0,0,0,37
1877941,1460965,2024-06-26,House,"House Local Government: Adopt Amendment A05170",25,0,0,0,25
1877941,1460966,2024-06-26,House,"House Local Government: Adopt Amendment",25,0,0,0,25
1877941,1461400,2024-06-28,House,"House Floor: HB 2288 PN 3413, 2023 A5290",202,0,0,1,203
1877941,1461401,2024-06-28,House,"House Rules: Re-report Bill As Committed",33,0,0,0,33
1877941,1461874,2024-07-01,House,"House Appropriations: Re-report Bill As Committed",37,0,0,0,37
1877941,1461938,2024-07-01,House,"House Floor: HB 2288 PN 3444, FINAL PASSAGE",195,7,0,1,203
1877941,1467333,2024-09-17,Senate,"Senate Local Government: Reported as Committed",11,0,0,0,11
1877941,1467818,2024-09-30,Senate,"Senate Floor: HB 2288 PN 3444, Final Passage",46,2,0,2,50
1877941,1467819,2024-09-30,Senate,"Senate Appropriations: Re-Reported as Committed",23,0,1,0,24
1877976,1456169,2024-06-11,Senate,"Senate Veterans Affairs And Emergency Preparedness: Reported as Committed",10,0,0,0,10
1877976,1459776,2024-06-25,Senate,"Senate Appropriations: Adopt Amendment A05000",24,0,0,0,24
1877976,1459777,2024-06-25,Senate,"Senate Appropriations: Re-Reported as Amended",24,0,0,0,24
1877976,1460310,2024-06-26,Senate,"Senate Floor: SB 1192 PN 1779, Final Passage",50,0,0,0,50
1878180,1453795,2024-06-05,House,"House Labor And Industry: Adopt Amendment A04668",11,14,0,0,25
1878180,1453796,2024-06-05,House,"House Labor And Industry: Re-report Bill As Committed",14,11,0,0,25
1878180,1459407,2024-06-24,House,"House Floor: HR 436 PN 3123, 2023 A4900",200,2,0,1,203
1878180,1459408,2024-06-24,House,"House Floor: HR 436 PN 3375",201,1,0,1,203
1878196,1445842,2024-05-21,House,"House Tourism And Economic And Recreational Development: Report Bill As Committed",25,0,0,0,25
1878277,1452572,2024-06-03,House,"House State Government: Report Bill As Committed",14,11,0,0,25
1878505,1456650,2024-06-12,House,"House Professional Licensure: Adopt Amendment A04862",25,0,0,0,25
1878505,1456651,2024-06-12,House,"House Professional Licensure: Report Bill As Amended",25,0,0,0,25
1878505,1467899,2024-10-01,House,"House Floor: HB 2294 PN 3314, FINAL PASSAGE",202,0,0,1,203
1878505,1467900,2024-10-01,House,"House Appropriations: Re-report Bill As Committed",37,0,0,0,37
1878505,1468171,2024-10-07,Senate,"Senate Consumer Protection And Professional Licensure: Reported as Committed",14,0,0,0,14
1878505,1468463,2024-10-09,Senate,"Senate Appropriations: Re-Reported as Committed",24,0,0,0,24
1878521,1456664,2024-06-12,House,"House Professional Licensure: Adopt Amendment A04863",25,0,0,0,25
1878521,1456665,2024-06-12,House,"House Professional Licensure: Report Bill As Amended",25,0,0,0,25
1878521,1467921,2024-10-01,House,"House Floor: HB 2295 PN 3315, FINAL PASSAGE",202,0,0,1,203
1878521,1467922,2024-10-01,House,"House Appropriations: Re-report Bill As Committed",37,0,0,0,37
1878521,1468176,2024-10-07,Senate,"Senate Consumer Protection And Professional Licensure: Reported as Amended A05765",14,0,0,0,14
1878521,1468177,2024-10-07,Senate,"Senate Consumer Protection And Professional Licensure: Adopt Amendment A05765",14,0,0,0,14
1878521,1468455,2024-10-09,Senate,"Senate Appropriations: Re-Reported as Committed",24,0,0,0,24
1878675,1445572,2024-05-21,House,"House Transportation: Report Bill As Committed",25,0,0,0,25
1878675,1456562,2024-06-12,House,"House Appropriations: Re-report Bill As Committed",37,0,0,0,37
1878675,1456968,2024-06-12,House,"House Floor: HB 2301 PN 3113, FINAL PASSAGE",190,11,0,2,203
1878675,1460217,2024-06-26,Senate,"Senate Transportation: Reported as Amended",13,1,0,0,14
1878675,1460218,2024-06-26,Senate,"Senate Transportation: Adopt Amendment A05226",14,0,0,0,14
1878675,1461115,2024-06-27,Senate,"Senate Appropriations: Re-Reported as Committed",24,0,0,0,24
1878675,1462383,2024-07-02,Senate,"Senate Floor: HB 2301 PN 3405, Final Passage",49,1,0,0,50
1878675,1462401,2024-07-03,House,"House Floor: HB 2301 PN 3405, CONCURRENCE",202,0,0,1,203
1878675,1462402,2024-07-03,House,"House Rules: Re-report Bill As Committed",33,0,0,0,33
1878746,1452632,2024-06-03,House,"House State Government: Report Bill As Committed",23,2,0,0,25
1878746,1453252,2024-06-04,House,"House Floor: HR 439 PN 3125, 2023 A4675",191,11,0,1,203
1878746,1453253,2024-06-04,House,"House Floor: HR 439 PN 3225",189,13,0,1,203
1878988,1445490,2024-05-21,House,"House Health: Report Bill As Committed",25,0,0,0,25
1878988,1448839,2024-05-22,House,"House Floor: HR 440 PN 3102",201,1,0,1,203
1879277,1455917,2024-06-11,Senate,"Senate Transportation: Reported as Amended",14,0,0,0,14
1879277,1455918,2024-06-11,Senate,"Senate Transportation: Adopt Amendment A04839",14,0,0,0,14
1879283,1446167,2024-05-21,House,"House Housing And Community Development: Report Bill As Committed",23,2,1,0,26
1879283,1454097,2024-06-05,House,"House Floor: HR 442 PN 3116",198,4,0,1,203
1879295,1468480,2024-10-09,Senate,"Senate Education: Reported as Amended",7,4,0,0,11
1879295,1468481,2024-10-09,Senate,"Senate Education: Adopt Amendment A05962",7,4,0,0,11
1879309,1468647,2024-10-08,Senate,"Senate Game And Fisheries: Reported as Committed",11,0,0,0,11
1879318,1453244,2024-06-04,Senate,"Senate Agriculture And Rural Affairs: Reported as Committed",7,4,0,0,11
1879319,1454131,2024-06-05,House,"House Rules: Re-report Bill As Committed",18,15,0,0,33
1879400,1468010,2024-10-01,House,"House Commerce: Re-refer Bill To Another Committee",11,14,0,0,25
1879400,1468011,2024-10-01,House,"House Commerce: Report Bill As Committed",24,1,0,0,25
1879466,1452575,2024-06-03,House,"House State Government: Report Bill As Committed",14,11,0,0,25
1879466,1461103,2024-06-27,House,"House Appropriations: Re-report Bill As Committed",37,0,0,0,37
1879466,1461463,2024-06-28,House,"House Floor: HB 2308 PN 3129, FINAL PASSAGE",110,92,0,1,203
1879491,1452593,2024-06-03,House,"House Agriculture And Rural Affairs: Report Bill As Committed",24,0,1,0,25
1879491,1455720,2024-06-10,House,"House Floor: HB 2309 PN 3130, 2023 A4787",201,0,0,2,203
1879491,1455940,2024-06-11,House,"House Floor: HB 2309 PN 3281, FINAL PASSAGE",201,0,0,2,203
1879491,1455941,2024-06-11,House,"House Appropriations: Re-report Bill As Committed",37,0,0,0,37
1879520,1454057,2024-06-05,House,"House Health: Report Bill As Committed",25,0,0,0,25
1879520,1462735,2024-07-08,House,"House Floor: HR 446 PN 3132",200,1,0,2,203
1879547,1445824,2024-05-21,House,"House Transportation: Report Bill As Committed",25,0,0,0,25
1879547,1452595,2024-06-03,House,"House Floor: HR 444 PN 3128",163,39,0,1,203
1879572,1452870,2024-06-03,House,"House Agriculture And Rural Affairs: Report Bill As Committed",24,0,1,0,25
1879572,1461347,2024-06-27,House,"House Floor: HR 445 PN 3131",200,2,0,1,203
1879573,1452702,2024-06-03,House,"House Agriculture And Rural Affairs: Report Bill As Committed",20,4,1,0,25
1879573,1455721,2024-06-10,House,"House Floor: HB 2310 PN 3140, 2023 A4788",99,102,0,2,203
1879573,1455994,2024-06-11,House,"House Floor: HB 2310 PN 3140, FINAL PASSAGE",162,39,0,2,203
1879573,1455995,2024-06-11,House,"House Appropriations: Re-report Bill As Committed",37,0,0,0,37
1879573,1460273,2024-06-26,Senate,"Senate Agriculture And Rural Affairs: Reported as Amended",10,1,0,0,11
1879573,1463044,2024-07-11,House,"House Floor: HB 2310 PN 3506, CONCURRENCE",125,77,0,1,203
1879573,1463045,2024-07-11,Senate,"Senate Floor: HB 2310 PN 3506, Final Passage",45,4,0,1,50
1879573,1463046,2024-07-11,Senate,"Senate Appropriations: Adopt Amendment A05537",23,0,1,0,24
1879573,1463047,2024-07-11,Senate,"Senate Appropriations: Re-Reported as Amended",23,0,1,0,24
1879573,1463048,2024-07-11,House,"House Rules: Re-report Bill As Committed",18,15,0,0,33
1879670,1458882,2024-06-24,House,"House Education: Adopt Amendment A05067",11,14,0,0,25
1879670,1458883,2024-06-24,House,"House Education: Adopt Amendment A05050",14,11,0,0,25
1879670,1458884,2024-06-24,House,"House Education: Report Bill As Amended",14,11,0,0,25
1879765,1447768,2024-05-22,House,"House Game And Fisheries: Report Bill As Committed",24,0,1,0,25
1879765,1459112,2024-06-24,House,"House Floor: HB 2314 PN 3151, 2023 A4818",100,102,0,1,203
1879765,1459113,2024-06-24,House,"House Floor: HB 2314 PN 3151, 2023 A4832",100,102,0,1,203
1879765,1459114,2024-06-24,House,"House Floor: HB 2314 PN 3151, 2023 A4837",100,102,0,1,203
1879765,1459115,2024-06-24,House,"House Floor: HB 2314 PN 3151, 2023 A4841",202,0,0,1,203
1879765,1459116,2024-06-24,House,"House Floor: HB 2314 PN 3151, 2023 A4866",100,102,0,1,203
1879765,1459874,2024-06-25,House,"House Appropriations: Re-report Bill As Committed",37,0,0,0,37
1879893,1454109,2024-06-05,House,"House Local Government: Report Bill As Committed",24,1,0,0,25
1879893,1456592,2024-06-12,House,"House Floor: HR 449 PN 3158",200,1,0,2,203
1880048,1459818,2024-06-25,House,"House Labor And Industry: Report Bill As Committed",25,0,0,0,25
1880048,1461925,2024-07-01,House,"House Floor: HR 451 PN 3169",199,3,0,1,203
1880128,1454006,2024-06-05,House,"House Tourism And Economic And Recreational Development: Report Bill As Committed",25,0,0,0,25
1880161,1456583,2024-06-12,House,"House Health: Report Bill As Committed",20,4,0,0,24
1880161,1461915,2024-07-01,House,"House Rules: Re-report Bill As Committed",33,0,0,0,33
1880161,1462962,2024-07-11,House,"House Appropriations: Re-report Bill As Committed",37,0,0,0,37
1880161,1463011,2024-07-11,House,"House Floor: HB 2339 PN 3172, FINAL PASSAGE",168,34,0,1,203
1880309,1456055,2024-06-11,House,"House Consumer Protection, Technology And Utilities: Adopt Amendment",25,0,0,0,25
1880309,1456056,2024-06-11,House,"House Consumer Protection, Technology And Utilities: Report Bill As Amended",25,0,0,0,25
1880309,1458980,2024-06-24,House,"House Floor: HB 2338 PN 3302, 2023 A4973",100,102,0,1,203
1880309,1458981,2024-06-24,House,"House Floor: HB 2338 PN 3302, 2023 A4974",100,102,0,1,203
1880309,1458982,2024-06-24,House,"House Rules: Re-report Bill As Committed",33,0,0,0,33
1880309,1459726,2024-06-25,House,"House Appropriations: Re-report Bill As Committed",23,0,14,0,37
1880309,1459815,2024-06-25,House,"House Floor: HB 2338 PN 3302, FINAL PASSAGE",107,95,0,1,203
1880336,1460158,2024-06-26,House,"House Health: Report Bill As Amended",16,9,0,0,25
1880336,1460159,2024-06-26,House,"House Health: Adopt Amendment A05080",16,9,0,0,25
1880336,1461919,2024-07-01,House,"House Rules: Re-report Bill As Committed",18,15,0,0,33
1880336,1462882,2024-07-10,House,"House Floor: HB 2344 PN 3406, 2023 A5307",148,54,0,1,203
1880336,1462883,2024-07-10,House,"House Floor: HB 2344 PN 3406, 2023 A5310",202,0,0,1,203
1880336,1462884,2024-07-10,House,"House Floor: HB 2344 PN 3406, 2023 A5314",201,1,0,1,203
1880336,1462885,2024-07-10,House,"House Floor: HB 2344 PN 3406, 2023 A5495",150,52,0,1,203
1880336,1462886,2024-07-10,House,"House Floor: HB 2344 PN 3406, MOTION TO TABLE AMENDMENTS",102,100,0,1,203
1880336,1462965,2024-07-11,House,"House Floor: HB 2344 PN 3503, FINAL PASSAGE",114,88,0,1,203
1880336,1462966,2024-07-11,House,"House Appropriations: Re-report Bill As Committed",22,15,0,0,37
1880336,1468248,2024-10-07,Senate,"Senate Health And Human Services: Reported as Amended",11,0,0,0,11
1880336,1468249,2024-10-07,Senate,"Senate Health And Human Services: Adopt Amendment A05867",11,0,0,0,11
1880501,1457192,2024-06-12,House,"House Aging And Older Adult Services: Report Bill As Committed",25,0,0,0,25
1880501,1460978,2024-06-27,House,"House Floor: HR 453 PN 3186",201,1,0,1,203
1880554,1458987,2024-06-24,House,"House State Government: Adopt Amendment A05069",25,0,0,0,25
1880554,1458988,2024-06-24,House,"House State Government: Report Bill As Amended",22,3,0,0,25
1880562,1455879,2024-06-11,House,"House Housing And Community Development: Adopt Amendment A04713",25,0,0,0,25
1880562,1455880,2024-06-11,House,"House Housing And Community Development: Report Bill As Amended",25,0,0,0,25
1880643,1452936,2024-06-03,House,"House Agriculture And Rural Affairs: Adopt Amendment A04609",24,0,1,0,25
1880643,1452937,2024-06-03,House,"House Agriculture And Rural Affairs: Adopt Amendment A04600",24,0,1,0,25
1880643,1452938,2024-06-03,House,"House Agriculture And Rural Affairs: Report Bill As Amended",23,1,1,0,25
1880663,1453187,2024-06-04,Senate,"Senate Agriculture And Rural Affairs: Reported as Committed",11,0,0,0,11
1880673,1453202,2024-06-04,Senate,"Senate Judiciary: Reported as Amended",14,0,0,0,14
1880673,1453203,2024-06-04,Senate,"Senate Judiciary: Adopt Amendment A04678",14,0,0,0,14
1880673,1455844,2024-06-10,Senate,"Senate Floor: SB 1213 PN 1679, Final Passage",50,0,0,0,50
1880673,1468076,2024-10-02,House,"House Judiciary: Adopt Amendment A05795",11,14,0,0,25
1880673,1468077,2024-10-02,House,"House Judiciary: Report Bill As Committed",25,0,0,0,25
1880673,1468273,2024-10-07,House,"House Floor: SB 1213 PN 1679, 2023 A5836",202,0,0,1,203
1880673,1468274,2024-10-07,House,"House Floor: SB 1213 PN 1679, 2023 A5915, MOTION TO SUSPEND RULES",101,101,0,1,203
1880673,1468309,2024-10-08,House,"House Appropriations: Adopt Amendment A05948",22,15,0,0,37
1880673,1468421,2024-10-08,House,"House Appropriations: Re-report Bill As Amended",37,0,0,0,37
1880673,1468467,2024-10-09,House,"House Floor: SB 1213 PN 1946, FINAL PASSAGE",202,0,0,1,203
1880673,1468562,2024-10-09,Senate,"Senate Floor: SB 1213 PN 1946, Concur in House Amendments",49,0,0,1,50
1880673,1468563,2024-10-09,Senate,"Senate Rules And Executive Nominations: Re-Reported as Committed",17,0,0,0,17
1880707,1455915,2024-06-11,Senate,"Senate Labor And Industry: Reported as Amended",11,0,0,0,11
1880707,1455916,2024-06-11,Senate,"Senate Labor And Industry: Adopt Amendment A04927",11,0,0,0,11
1880707,1467381,2024-09-17,Senate,"Senate Floor: SB 1230 PN 1722, 2023 A5609, BAKER Amendment No. A-5609",48,1,0,1,50
1880707,1468376,2024-10-08,Senate,"Senate Appropriations: Re-Reported as Committed",24,0,0,0,24
1880707,1468575,2024-10-09,Senate,"Senate Floor: SB 1230 PN 1891, Final Passage",49,0,0,1,50
1880707,1468744,2024-10-21,House,"House Labor And Industry: Adopt Amendment A06018",11,14,0,0,25
1880707,1468745,2024-10-21,House,"House Labor And Industry: To Table",11,14,0,0,25
1880707,1468746,2024-10-21,House,"House Labor And Industry: Report Bill As Committed",14,11,0,0,25
1880707,1468821,2024-10-22,House,"House Floor: SB 1230 PN 1891, 2023 A6029",113,89,0,1,203
1880707,1468822,2024-10-22,House,"House Floor: SB 1230 PN 1891, 2023 A6039",94,108,0,1,203
1880707,1468888,2024-10-23,House,"House Floor: SB 1230 PN 1971, FINAL PASSAGE",137,65,0,1,203
1880707,1468889,2024-10-23,House,"House Appropriations: Re-report Bill As Committed",37,0,0,0,37
1880759,1459844,2024-06-25,Senate,"Senate Judiciary: Reported as Amended",8,6,0,0,14
1880759,1459845,2024-06-25,Senate,"Senate Judiciary: Adopt Amendment A05110",9,5,0,0,14
1880767,1460287,2024-06-26,Senate,"Senate Law And Justice: Reported as Committed",11,0,0,0,11
1880767,1461111,2024-06-27,Senate,"Senate Appropriations: Re-Reported as Committed",24,0,0,0,24
1880767,1461927,2024-07-01,Senate,"Senate Floor: SB 1228 PN 1651, Final Passage",50,0,0,0,50
1880767,1468062,2024-10-02,House,"House Judiciary: Report Bill As Committed",25,0,0,0,25
1880776,1459724,2024-06-25,House,"House Labor And Industry: Report Bill As Committed",14,11,0,0,25
1880799,1452612,2024-06-03,House,"House Agriculture And Rural Affairs: Report Bill As Committed",20,4,1,0,25
1880799,1455972,2024-06-11,House,"House Floor: HB 2357 PN 3192, 2023 A4857",100,101,0,2,203
1880799,1455973,2024-06-11,House,"House Floor: HB 2357 PN 3192, 2023 A4880, MOTION TO APPEAL RULING OF THE CHAIR",101,100,0,2,203
1880799,1456561,2024-06-12,House,"House Appropriations: Re-report Bill As Committed",37,0,0,0,37
1880799,1456818,2024-06-12,House,"House Floor: HB 2357 PN 3192, FINAL PASSAGE",171,30,0,2,203
1880799,1459117,2024-06-24,Senate,"Senate Agriculture And Rural Affairs: Reported as Committed",9,2,0,0,11
1880888,1459737,2024-06-25,House,"House Labor And Industry: Adopt Amendment A05022",11,14,0,0,25
1880888,1459738,2024-06-25,House,"House Labor And Industry: Report Bill As Committed",14,11,0,0,25
1880946,1467867,2024-10-01,Senate,"Senate State Government: Reported as Committed",7,4,0,0,11
1880946,1468440,2024-10-08,Senate,"Senate Floor: SB 1235 PN 1656, Final Passage",28,22,0,0,50
1880995,1456578,2024-06-12,House,"House Health: Report Bill As Amended",24,0,0,0,24
1880995,1456579,2024-06-12,House,"House Health: Adopt Amendment A04851",24,0,0,0,24
1881003,1455678,2024-06-10,House,"House Transportation: Report Bill As Amended",25,0,0,0,25
1881003,1455679,2024-06-10,House,"House Transportation: Adopt Amendment A04802",25,0,0,0,25
1881003,1461620,2024-06-28,House,"House Floor: HB 2364 PN 3275, 2023 A4957",202,0,0,1,203
1881003,1461621,2024-06-28,House,"House Rules: Re-report Bill As Committed",33,0,0,0,33
1881003,1461902,2024-07-01,House,"House Floor: HB 2364 PN 3445, FINAL PASSAGE",202,0,0,1,203
1881003,1461903,2024-07-01,House,"House Appropriations: Re-report Bill As Committed",37,0,0,0,37
1881007,1459865,2024-06-25,Senate,"Senate Finance: Reported as Amended",8,3,0,0,11
1881007,1459866,2024-06-25,Senate,"Senate Finance: Adopt Amendment A05156",10,1,0,0,11
1881011,1453913,2024-06-05,Senate,"Senate Labor And Industry: Reported as Committed",11,0,0,0,11
1881011,1459305,2024-06-24,Senate,"Senate Appropriations: Re-Reported as Committed",24,0,0,0,24
1881011,1462734,2024-07-08,Senate,"Senate Floor: SB 1232 PN 1667, 2023 A5480, LAUGHLIN Amendment No. A-5480",47,2,0,1,50
1881011,1462933,2024-07-10,Senate,"Senate Floor: SB 1232 PN 1812, Final Passage",49,0,0,1,50
1881011,1468144,2024-10-07,House,"House Labor And Industry: Report Bill As Committed",25,0,0,0,25
1881011,1468446,2024-10-08,House,"House Floor: SB 1232 PN 1812, 2023 A5834",201,0,0,2,203
1881011,1468533,2024-10-09,House,"House Floor: SB 1232 PN 1949, FINAL PASSAGE",202,0,0,1,203
1881011,1468534,2024-10-09,House,"House Appropriations: Re-report Bill As Committed",37,0,0,0,37
1881011,1468736,2024-10-21,Senate,"Senate Rules And Executive Nominations: Re-Reported as Committed",17,0,0,0,17
1881011,1468859,2024-10-22,Senate,"Senate Floor: SB 1232 PN 1949, Concur in House Amendments",50,0,0,0,50
1881036,1452634,2024-06-03,House,"House Floor: UNCONTESTED CALENDAR SUP A",202,0,0,1,203
1881044,1453186,2024-06-04,Senate,"Senate Judiciary: Reported as Committed",13,1,0,0,14
1881044,1456711,2024-06-12,Senate,"Senate Floor: SB 1236 PN 1726, Final Passage",48,0,0,2,50
1881044,1461065,2024-06-27,House,"House Judiciary: Report Bill As Committed",25,0,0,0,25
1881044,1462710,2024-07-08,House,"House Floor: SB 1236 PN 1726, MOTION TO TABLE AMENDMENTS",102,99,0,2,203
1881044,1462743,2024-07-09,House,"House Floor: SB 1236 PN 1726, FINAL PASSAGE",202,0,0,1,203
1881044,1462744,2024-07-09,House,"House Appropriations: Re-report Bill As Committed",37,0,0,0,37
1881054,1453094,2024-06-04,Senate,"Senate Judiciary: Reported as Committed",14,0,0,0,14
1881054,1455699,2024-06-10,Senate,"Senate Appropriations: Re-Reported as Committed",24,0,0,0,24
1881054,1459498,2024-06-24,Senate,"Senate Floor: SB 1231 PN 1666, Final Passage",50,0,0,0,50
1881054,1461014,2024-06-27,House,"House Judiciary: Report Bill As Committed",25,0,0,0,25
1881054,1462421,2024-07-03,House,"House Floor: SB 1231 PN 1666, FINAL PASSAGE",202,0,0,1,203
1881054,1462422,2024-07-03,House,"House Appropriations: Re-report Bill As Committed",37,0,0,0,37
1881135,1453249,2024-06-04,House,"House Education: Re-refer Bill To Another Committee",11,14,0,0,25
1881135,1453250,2024-06-04,House,"House Education: Report Bill As Committed",14,11,0,0,25
1881135,1454033,2024-06-05,House,"House Floor: HB 2370 PN 3196, SECOND CONSIDERATION",104,98,0,1,203
1881135,1454490,2024-06-05,House,"House Rules: Re-report Bill As Committed",18,15,0,0,33
1881135,1455683,2024-06-10,House,"House Appropriations: Re-report Bill As Committed",22,15,0,0,37
1881135,1455738,2024-06-10,House,"House Floor: HB 2370 PN 3196, FINAL PASSAGE",107,94,0,2,203
1881171,1461275,2024-06-26,House,"House Local Government: Report Bill As Committed",25,0,0,0,25
1881191,1454125,2024-06-05,House,"House Tourism And Economic And Recreational Development: Report Bill As Committed",25,0,0,0,25
1881191,1462978,2024-07-11,House,"House Floor: HR 460 PN 3217",200,2,0,1,203
1881232,1454108,2024-06-05,House,"House Tourism And Economic And Recreational Development: Report Bill As Committed",25,0,0,0,25
1881232,1461465,2024-06-28,House,"House Floor: HR 461 PN 3218",201,1,0,1,203
1881317,1454058,2024-06-05,House,"House Tourism And Economic And Recreational Development: Report Bill As Committed",25,0,0,0,25
1881363,1456586,2024-06-12,House,"House Health: Report Bill As Committed",24,0,0,0,24
1881363,1460191,2024-06-26,House,"House Floor: HR 464 PN 3239",201,1,0,1,203
1881386,1457162,2024-06-12,House,"House Aging And Older Adult Services: Report Bill As Committed",25,0,0,0,25
1881386,1461338,2024-06-28,House,"House Rules: Re-report Bill As Committed",33,0,0,0,33
1881386,1461875,2024-07-01,House,"House Appropriations: Re-report Bill As Committed",37,0,0,0,37
1881386,1462128,2024-07-01,House,"House Floor: HB 2378 PN 3228, FINAL PASSAGE",200,2,0,1,203
1881386,1467966,2024-10-01,Senate,"Senate Aging And Youth: Reported as Committed",9,0,2,0,11
1881386,1468827,2024-10-22,Senate,"Senate Appropriations: Re-Reported as Committed",24,0,0,0,24
1881386,1468857,2024-10-22,Senate,"Senate Floor: HB 2378 PN 3228, Final Passage",50,0,0,0,50
1881399,1454090,2024-06-05,House,"House Tourism And Economic And Recreational Development: Report Bill As Committed",25,0,0,0,25
1881399,1456587,2024-06-12,House,"House Floor: HR 463 PN 3227",198,3,0,2,203
1881436,1456000,2024-06-11,House,"House Finance: Report Bill As Committed",23,2,0,0,25
1881436,1461328,2024-06-28,House,"House Floor: HB 2358 PN 3226, 2023 A5297",100,102,0,1,203
1881436,1461329,2024-06-28,House,"House Rules: Re-report Bill As Committed",33,0,0,0,33
1881436,1461886,2024-07-01,House,"House Floor: HB 2358 PN 3226, FINAL PASSAGE",126,76,0,1,203
1881436,1461887,2024-07-01,House,"House Appropriations: Re-report Bill As Committed",22,15,0,0,37
1881468,1456719,2024-06-12,House,"House Professional Licensure: Adopt Amendment A04930",25,0,0,0,25
1881468,1456720,2024-06-12,House,"House Professional Licensure: Report Bill As Amended",25,0,0,0,25
1881468,1459810,2024-06-25,House,"House Rules: Re-report Bill As Committed",33,0,0,0,33
1881468,1460314,2024-06-26,House,"House Floor: HB 2381 PN 3316, FINAL PASSAGE",177,25,0,1,203
1881468,1460315,2024-06-26,House,"House Appropriations: Re-report Bill As Committed",37,0,0,0,37
1881468,1467359,2024-09-17,Senate,"Senate Consumer Protection And Professional Licensure: Reported as Amended A05599",14,0,0,0,14
1881468,1467360,2024-09-17,Senate,"Senate Consumer Protection And Professional Licensure: Adopt Amendment A05599",14,0,0,0,14
1881468,1467822,2024-09-30,Senate,"Senate Appropriations: Re-Reported as Committed",23,0,1,0,24
1881468,1468491,2024-10-09,Senate,"Senate Floor: HB 2381 PN 3615, Final Passage",49,0,0,1,50
1881468,1468753,2024-10-21,House,"House Floor: HB 2381 PN 3615, CONCURRENCE",201,1,0,1,203
1881468,1468754,2024-10-21,House,"House Rules: Re-report Bill As Committed",33,0,0,0,33
1881478,1455677,2024-06-10,House,"House Transportation: Report Bill As Committed",25,0,0,0,25
1881478,1459764,2024-06-25,House,"House Floor: HR 465 PN 3229",201,1,0,1,203
1881489,1460253,2024-06-26,House,"House Health: Re-report Bill As Amended",25,0,0,0,25
1881489,1460254,2024-06-26,House,"House Health: Adopt Amendment A05085",25,0,0,0,25
1881497,1457128,2024-06-12,House,"House Aging And Older Adult Services: Report Bill As Committed",24,1,0,0,25
1881497,1462755,2024-07-09,House,"House Floor: HB 2383 PN 3243, 2023 A5193",202,0,0,1,203
1881497,1462756,2024-07-09,House,"House Rules: Re-report Bill As Committed",33,0,0,0,33
1881497,1462856,2024-07-10,House,"House Appropriations: Re-report Bill As Committed",37,0,0,0,37
1881497,1462908,2024-07-10,House,"House Floor: HB 2383 PN 3494, FINAL PASSAGE",158,44,0,1,203
1881497,1467763,2024-09-30,Senate,"Senate Education: Reported as Amended",9,1,1,0,11
1881497,1467764,2024-09-30,Senate,"Senate Education: Adopt Amendment A05706",10,0,1,0,11
1881497,1468250,2024-10-07,Senate,"Senate Appropriations: Re-Reported as Committed",23,0,1,0,24
1881497,1468438,2024-10-08,Senate,"Senate Floor: HB 2383 PN 3666, Final Passage",49,1,0,0,50
1881497,1468502,2024-10-09,House,"House Floor: HB 2383 PN 3666, CONCURRENCE",169,33,0,1,203
1881497,1468503,2024-10-09,House,"House Rules: Re-report Bill As Committed",33,0,0,0,33
1881540,1455875,2024-06-11,House,"House Environmental Resources And Energy: Adopt Amendment A04825",25,0,0,0,25
1881540,1455876,2024-06-11,House,"House Environmental Resources And Energy: Adopt Amendment A04872",11,14,0,0,25
1881540,1455877,2024-06-11,House,"House Environmental Resources And Energy: Report Bill As Amended",14,11,0,0,25
1881549,1457160,2024-06-12,House,"House Aging And Older Adult Services: Report Bill As Committed",24,1,0,0,25
1881549,1460155,2024-06-26,House,"House Rules: Re-report Bill As Committed",33,0,0,0,33
1881549,1460973,2024-06-27,House,"House Appropriations: Re-report Bill As Committed",37,0,0,0,37
1881549,1461137,2024-06-27,House,"House Floor: HB 2400 PN 3251, FINAL PASSAGE",168,34,0,1,203
1881556,1459109,2024-06-24,House,"House Education: Adopt Amendment A05098",25,0,0,0,25
1881556,1459110,2024-06-24,House,"House Education: Report Bill As Amended",25,0,0,0,25
1881561,1457193,2024-06-12,House,"House Aging And Older Adult Services: Report Bill As Committed",25,0,0,0,25
1881581,1456156,2024-06-11,House,"House Housing And Community Development: Report Bill As Committed",14,11,0,0,25
1881585,1455894,2024-06-11,Senate,"Senate Banking And Insurance: Reported as Amended",14,0,0,0,14
1881585,1455895,2024-06-11,Senate,"Senate Banking And Insurance: Adopt Amendment A04826",14,0,0,0,14
1881585,1458923,2024-06-24,Senate,"Senate Appropriations: Re-Reported as Committed",24,0,0,0,24
1881585,1460139,2024-06-25,Senate,"Senate Floor: SB 1241 PN 1716, Final Passage",50,0,0,0,50
1881585,1467742,2024-09-30,House,"House Insurance: Adopt Amendment A05583",25,0,0,0,25
1881585,1467743,2024-09-30,House,"House Insurance: Report Bill As Amended",25,0,0,0,25
1881585,1468307,2024-10-08,House,"House Appropriations: Re-report Bill As Committed",37,0,0,0,37
1881585,1468420,2024-10-08,House,"House Floor: SB 1241 PN 1914, FINAL PASSAGE",201,0,0,2,203
1881585,1468474,2024-10-09,Senate,"Senate Rules And Executive Nominations: Re-Reported as Committed",17,0,0,0,17
1881585,1468564,2024-10-09,Senate,"Senate Floor: SB 1241 PN 1914, Concur in House Amendments",49,0,0,1,50
1881595,1460326,2024-06-25,House,"House Tourism And Economic And Recreational Development: Report Bill As Committed",25,0,0,0,25
1881595,1461940,2024-07-01,House,"House Floor: HR 470 PN 3268",199,3,0,1,203
1881708,1455675,2024-06-10,House,"House Transportation: Report Bill As Amended",25,0,0,0,25
1881708,1455676,2024-06-10,House,"House Transportation: Adopt Amendment A04847",25,0,0,0,25
1881708,1462200,2024-07-02,House,"House Rules: Re-report Bill As Committed",33,0,0,0,33
1881739,1467855,2024-10-01,House,"House Environmental Resources And Energy: Adopt Amendment A05730",25,0,0,0,25
1881739,1467856,2024-10-01,House,"House Environmental Resources And Energy: Report Bill As Amended",23,2,0,0,25
1881739,1468574,2024-10-09,House,"House Floor: HB 2393 PN 3688, 2023 A5954",199,3,0,1,203
1881739,1468794,2024-10-21,House,"House Floor: HB 2393 PN 3756, FINAL PASSAGE",188,14,0,1,203
1881739,1468795,2024-10-21,House,"House Appropriations: Re-report Bill As Committed",26,11,0,0,37
1881769,1467325,2024-09-17,Senate,"Senate Consumer Protection And Professional Licensure: Reported as Amended A05610",14,0,0,0,14
1881769,1467326,2024-09-17,Senate,"Senate Consumer Protection And Professional Licensure: Adopt Amendment A05610",14,0,0,0,14
1881769,1467814,2024-09-30,Senate,"Senate Floor: SB 1237 PN 1889, 2023 A5684, BAKER Amendment No. A-5684",48,0,0,2,50
1881769,1467815,2024-09-30,Senate,"Senate Appropriations: Re-Reported as Committed",23,0,1,0,24
1881769,1467952,2024-10-01,Senate,"Senate Floor: SB 1237 PN 1917, Final Passage",48,0,0,2,50
1881769,1468146,2024-10-07,House,"House Consumer Protection, Technology And Utilities: Report Bill As Committed",25,0,0,0,25
1881769,1468437,2024-10-08,House,"House Floor: SB 1237 PN 1917, 2023 A5868",201,0,0,2,203
1881769,1468824,2024-10-22,House,"House Floor: SB 1237 PN 1950, FINAL PASSAGE",196,6,0,1,203
1881769,1468825,2024-10-22,House,"House Appropriations: Re-report Bill As Committed",37,0,0,0,37
1881769,1468854,2024-10-22,Senate,"Senate Floor: SB 1237 PN 1950, Concur in House Amendments",50,0,0,0,50
1881769,1468855,2024-10-22,Senate,"Senate Rules And Executive Nominations: Re-Reported as Committed",17,0,0,0,17
1881804,1456576,2024-06-12,House,"House Health: Report Bill As Committed",24,0,0,0,24
1881804,1461332,2024-06-28,House,"House Floor: HR 471 PN 3269",201,1,0,1,203
1881840,1455714,2024-06-10,House,"House Floor: UNCONTESTED CALENDAR SUP A",201,0,0,2,203
1881909,1461019,2024-06-27,Senate,"Senate Consumer Protection And Professional Licensure: Reported as Committed",14,0,0,0,14
1881909,1462732,2024-07-08,Senate,"Senate Appropriations: Re-Reported as Committed",22,0,2,0,24
1881909,1462802,2024-07-09,Senate,"Senate Floor: SB 1242 PN 1701, Final Passage",46,3,0,1,50
1881909,1467757,2024-09-30,House,"House Education: Re-refer Bill To Another Committee",25,0,0,0,25
1881913,1456767,2024-06-12,Senate,"Senate Education: Reported as Committed",8,3,0,0,11
1881916,1455913,2024-06-11,Senate,"Senate Transportation: Reported as Amended",14,0,0,0,14
1881916,1455914,2024-06-11,Senate,"Senate Transportation: Adopt Amendment A04849",14,0,0,0,14
1881916,1460208,2024-06-26,Senate,"Senate Floor: SB 1246 PN 1780, Final Passage",50,0,0,0,50
1881916,1460209,2024-06-26,Senate,"Senate Appropriations: Re-Reported as Committed",23,0,1,0,24
1881916,1461973,2024-07-01,House,"House Transportation: Report Bill As Committed",25,0,0,0,25
1881916,1462185,2024-07-02,House,"House Floor: SB 1246 PN 1780, 2023 A5342",171,30,0,2,203
1881916,1462412,2024-07-03,House,"House Floor: SB 1246 PN 1805, FINAL PASSAGE",140,62,0,1,203
1881916,1462413,2024-07-03,House,"House Appropriations: Re-report Bill As Committed",37,0,0,0,37
1881916,1463001,2024-07-11,Senate,"Senate Floor: SB 1246 PN 1805, Concur in House Amendments",48,1,0,1,50
1881916,1463002,2024-07-11,Senate,"Senate Rules And Executive Nominations: Re-Reported as Committed",17,0,0,0,17
1881919,1460169,2024-06-26,House,"House Education: Adopt Amendment A05195",15,10,0,0,25
1881919,1460170,2024-06-26,House,"House Education: Report Bill As Amended",14,11,0,0,25
1881919,1461384,2024-06-28,House,"House Rules: Re-report Bill As Committed",18,15,0,0,33
1881927,1455905,2024-06-11,Senate,"Senate Labor And Industry: Reported as Committed",11,0,0,0,11
1881928,1456696,2024-06-12,Senate,"Senate Consumer Protection And Professional Licensure: Reported as Committed",9,2,3,0,14
1881930,1456766,2024-06-12,Senate,"Senate Consumer Protection And Professional Licensure: Reported as Committed",11,0,3,0,14
1881936,1455872,2024-06-11,House,"House Consumer Protection, Technology And Utilities: Adopt Amendment",25,0,0,0,25
1881936,1455873,2024-06-11,House,"House Consumer Protection, Technology And Utilities: Report Bill As Amended",24,1,0,0,25
1882033,1456814,2024-06-12,House,"House Human Services: Report Bill As Committed",25,0,0,0,25
1882033,1460160,2024-06-26,House,"House Rules: Re-report Bill As Committed",33,0,0,0,33
1882033,1460343,2024-06-26,House,"House Floor: HB 2403 PN 3284, 2023 A5169, MOTION TO APPEAL RULING OF THE CHAIR",102,100,0,1,203
1882033,1460989,2024-06-27,House,"House Appropriations: Re-report Bill As Committed",37,0,0,0,37
1882033,1461154,2024-06-27,House,"House Floor: HB 2403 PN 3284, FINAL PASSAGE",202,0,0,1,203
1882047,1456726,2024-06-12,House,"House Finance: Report Bill As Committed",14,11,0,0,25
1882078,1456598,2024-06-12,House,"House Health: Report Bill As Committed",24,0,0,0,24
1882078,1459772,2024-06-25,House,"House Floor: HR 476 PN 3286",201,1,0,1,203
1882080,1455981,2024-06-11,Senate,"Senate Community, Economic And Recreational Development: Reported as Committed",9,5,0,0,14
1882087,1459215,2024-06-24,House,"House Veterans Affairs And Emergency Preparedness: Adopt Amendment A05041",23,2,0,0,25
1882087,1459216,2024-06-24,House,"House Veterans Affairs And Emergency Preparedness: Report Bill As Amended",23,2,0,0,25
1882087,1460234,2024-06-26,House,"House Floor: HB 2407 PN 3366, 2023 A5149",102,100,0,1,203
1882087,1460235,2024-06-26,House,"House Rules: Re-report Bill As Committed",33,0,0,0,33
1882087,1460986,2024-06-27,House,"House Appropriations: Adopt Amendment A05294",22,15,0,0,37
1882087,1460987,2024-06-27,House,"House Appropriations: Re-report Bill As Amended",22,15,0,0,37
1882087,1461156,2024-06-27,House,"House Floor: HB 2407 PN 3428, FINAL PASSAGE",102,100,0,1,203
1882087,1468413,2024-10-08,Senate,"Senate Veterans Affairs And Emergency Preparedness: Reported as Amended",11,0,0,0,11
1882087,1468414,2024-10-08,Senate,"Senate Veterans Affairs And Emergency Preparedness: Adopt Amendment A05945",11,0,0,0,11
1882087,1468415,2024-10-08,Senate,"Senate Veterans Affairs And Emergency Preparedness: Adopt Amendment A05942",11,0,0,0,11
1882091,1460164,2024-06-26,House,"House Transportation: Re-refer Bill To Another Committee",25,0,0,0,25
1882127,1459769,2024-06-25,House,"House Labor And Industry: Adopt Amendment A05091",14,11,0,0,25
1882127,1459770,2024-06-25,House,"House Labor And Industry: Report Bill As Amended",14,11,0,0,25
1882127,1468428,2024-10-08,House,"House Floor: HB 2412 PN 3390, FINAL PASSAGE",116,85,0,2,203
1882127,1468429,2024-10-08,House,"House Appropriations: Re-report Bill As Committed",37,0,0,0,37
1882233,1459439,2024-06-24,House,"House Judiciary: Adopt Amendment A04989",25,0,0,0,25
1882233,1459440,2024-06-24,House,"House Judiciary: Report Bill As Amended",25,0,0,0,25
1882233,1460302,2024-06-26,House,"House Rules: Re-report Bill As Committed",33,0,0,0,33
1882233,1461088,2024-06-27,House,"House Floor: HB 2413 PN 3374, FINAL PASSAGE",202,0,0,1,203
1882233,1461089,2024-06-27,House,"House Appropriations: Re-report Bill As Committed",37,0,0,0,37
1882273,1467280,2024-09-05,House,"House Veterans Affairs And Emergency Preparedness: Adopt Amendment A05573",25,0,0,0,25
1882273,1467281,2024-09-05,House,"House Veterans Affairs And Emergency Preparedness: Report Bill As Amended",24,1,0,0,25
1882286,1461113,2024-06-27,Senate,"Senate Consumer Protection And Professional Licensure: Reported as Amended",14,0,0,0,14
1882286,1461114,2024-06-27,Senate,"Senate Consumer Protection And Professional Licensure: Adopt Amendment A05192",14,0,0,0,14
1882286,1461934,2024-07-01,Senate,"Senate Floor: SB 1255 PN 1790, Motion to Consider Bill on Second Consideration",50,0,0,0,50
1882286,1462194,2024-07-02,Senate,"Senate Floor: SB 1255 PN 1790, Re-referred to the Committee on Appropriations",50,0,0,0,50
1882286,1467312,2024-09-16,Senate,"Senate Appropriations: Re-Reported as Committed",23,0,1,0,24
1882286,1467320,2024-09-16,Senate,"Senate Floor: SB 1255 PN 1790, Final Passage",48,0,0,2,50
1882286,1468027,2024-10-02,House,"House Professional Licensure: Report Bill As Committed",25,0,0,0,25
1882416,1459778,2024-06-25,House,"House Agriculture And Rural Affairs: Adopt Amendment A05116",25,0,0,0,25
1882416,1459779,2024-06-25,House,"House Agriculture And Rural Affairs: To Table",11,13,1,0,25
1882416,1459780,2024-06-25,House,"House Agriculture And Rural Affairs: Report Bill As Amended",13,11,1,0,25
1882416,1461490,2024-06-28,House,"House Floor: HB 2420 PN 3382, 2023 A5288",101,101,0,1,203
1882416,1461491,2024-06-28,House,"House Rules: Re-report Bill As Committed",18,15,0,0,33
1882416,1461900,2024-07-01,House,"House Floor: HB 2420 PN 3382, FINAL PASSAGE",145,57,0,1,203
1882416,1461901,2024-07-01,House,"House Appropriations: Re-report Bill As Committed",22,15,0,0,37
1882563,1468093,2024-10-02,House,"House Health: Report Bill As Committed",25,0,0,0,25
1882621,1460232,2024-06-26,House,"House Health: Report Bill As Committed",25,0,0,0,25
1882621,1462198,2024-07-02,House,"House Floor: HR 480 PN 3346",200,1,0,2,203
1882643,1462201,2024-07-02,House,"House Veterans Affairs And Emergency Preparedness: Report Bill As Committed",25,0,0,0,25
1882670,1460161,2024-06-26,House,"House Health: Report Bill As Committed",24,1,0,0,25
1882670,1461402,2024-06-28,House,"House Floor: HR 483 PN 3348",199,3,0,1,203
1882674,1459743,2024-06-25,House,"House Appropriations: Report Bill As Committed",22,15,0,0,37
1882674,1461176,2024-06-27,House,"House Floor: HB 2425 PN 3335, 2023 A5184",100,102,0,1,203
1882674,1461177,2024-06-27,House,"House Appropriations: Re-report Bill As Amended",37,0,0,0,37
1882674,1461178,2024-06-27,House,"House Appropriations: Adopt Amendment A05317",37,0,0,0,37
1882674,1461179,2024-06-27,House,"House Rules: Re-report Bill As Committed",18,15,0,0,33
1882674,1461487,2024-06-28,House,"House Floor: HB 2425 PN 3440, FINAL PASSAGE",137,65,0,1,203
1882680,1459128,2024-06-24,House,"House Transportation: Report Bill As Committed",25,0,0,0,25
1882680,1462425,2024-07-03,House,"House Rules: Re-report Bill As Committed",33,0,0,0,33
1882680,1462723,2024-07-08,House,"House Floor: HB 2426 PN 3336, FINAL PASSAGE",201,0,0,2,203
1882680,1462724,2024-07-08,House,"House Appropriations: Re-report Bill As Committed",37,0,0,0,37
1882680,1468734,2024-10-21,Senate,"Senate Transportation: Reported as Committed",14,0,0,0,14
1882680,1468829,2024-10-22,Senate,"Senate Appropriations: Re-Reported as Committed",24,0,0,0,24
1882686,1458878,2024-06-24,House,"House Transportation: Report Bill As Amended",13,12,0,0,25
1882686,1458879,2024-06-24,House,"House Transportation: Adopt Amendment A05048",25,0,0,0,25
1882689,1458872,2024-06-24,House,"House Transportation: Report Bill As Committed",25,0,0,0,25
1882700,1459732,2024-06-25,Senate,"Senate State Government: Reported as Committed",9,2,0,0,11
1882700,1460229,2024-06-26,Senate,"Senate Appropriations: Re-Reported as Committed",19,4,1,0,24
1882700,1460980,2024-06-27,Senate,"Senate Floor: SB 1260 PN 1738, Final Passage",41,7,0,2,50
1882711,1459032,2024-06-24,House,"House Judiciary: Report Bill As Committed",25,0,0,0,25
1882711,1461381,2024-06-28,House,"House Rules: Re-report Bill As Committed",33,0,0,0,33
1882711,1461873,2024-07-01,House,"House Appropriations: Re-report Bill As Committed",22,15,0,0,37
1882711,1461932,2024-07-01,House,"House Floor: HB 2429 PN 3343, FINAL PASSAGE",102,100,0,1,203
1882929,1458886,2024-06-24,House,"House State Government: Adopt Amendment A05095",9,16,0,0,25
1882929,1458887,2024-06-24,House,"House State Government: Report Bill As Committed",17,8,0,0,25
1882929,1461412,2024-06-28,House,"House Rules: Re-report Bill As Committed",33,0,0,0,33
1882929,1461876,2024-07-01,House,"House Appropriations: Re-report Bill As Committed",37,0,0,0,37
1882929,1461939,2024-07-01,House,"House Floor: HB 2433 PN 3351, FINAL PASSAGE",126,76,0,1,203
1882961,1460283,2024-06-26,House,"House Health: Report Bill As Committed",25,0,0,0,25
1882983,1460231,2024-06-26,House,"House Health: Report Bill As Committed",25,0,0,0,25
1882983,1462753,2024-07-09,House,"House Floor: HR 484 PN 3357",201,1,0,1,203
1882997,1458907,2024-06-24,Senate,"Senate Appropriations: Reported as Committed",24,0,0,0,24
1883002,1460127,2024-06-25,Senate,"Senate Education: Reported as Committed",11,0,0,0,11
1883002,1461924,2024-07-01,Senate,"Senate Appropriations: Re-Reported as Committed",24,0,0,0,24
1883004,1458916,2024-06-24,Senate,"Senate Appropriations: Reported as Committed",24,0,0,0,24
1883026,1458871,2024-06-24,House,"House Education: Report Bill As Committed",25,0,0,0,25
1883026,1462863,2024-07-09,House,"House Floor: HR 481 PN 3356",201,1,0,1,203
1883061,1460171,2024-06-26,House,"House Transportation: Re-refer Bill To Another Committee",25,0,0,0,25
1883068,1462136,2024-07-02,House,"House Veterans Affairs And Emergency Preparedness: Report Bill As Committed",25,0,0,0,25
1883082,1458902,2024-06-24,Senate,"Senate Agriculture And Rural Affairs: Reported as Committed",9,2,0,0,11
1883082,1462127,2024-07-01,Senate,"Senate Appropriations: Re-Reported as Committed",21,3,0,0,24
1883092,1459883,2024-06-25,Senate,"Senate Education: Reported as Amended",10,1,0,0,11
1883092,1459884,2024-06-25,Senate,"Senate Education: Adopt Amendment A05134",11,0,0,0,11
1883092,1462032,2024-07-01,Senate,"Senate Appropriations: Re-Reported as Committed",22,2,0,0,24
1883092,1462154,2024-07-02,Senate,"Senate Floor: SB 1207 PN 1771, 2023 A5264, AUMENT Amendment No. A-5264",50,0,0,0,50
1883092,1462430,2024-07-03,Senate,"Senate Floor: SB 1207 PN 1803, Final Passage",45,5,0,0,50
1883116,1459763,2024-06-25,Senate,"Senate Education: Reported as Committed",7,4,0,0,11
1883117,1459882,2024-06-25,Senate,"Senate State Government: Reported as Committed",7,4,0,0,11
1883118,1460156,2024-06-26,Senate,"Senate Veterans Affairs And Emergency Preparedness: Reported as Committed",7,4,0,0,11
1883118,1467321,2024-09-16,Senate,"Senate Floor: SR 311 PN 1755",45,3,0,2,50
1883118,1467322,2024-09-16,Senate,"Senate Floor: SR 311 PN 1755, Reconsideration",44,4,0,2,50
1883122,1461190,2024-06-26,House,"House Local Government: Report Bill As Committed",24,1,0,0,25
1883122,1468819,2024-10-22,House,"House Floor: HR 488 PN 3368",201,1,0,1,203
1883123,1460213,2024-06-26,House,"House Education: Report Bill As Committed",15,10,0,0,25
1883123,1461339,2024-06-28,House,"House Rules: Re-report Bill As Committed",18,15,0,0,33
1883123,1461904,2024-07-01,House,"House Floor: HB 2180 PN 3361, FINAL PASSAGE",118,84,0,1,203
1883123,1461905,2024-07-01,House,"House Appropriations: Re-report Bill As Committed",22,15,0,0,37
1883252,1460184,2024-06-26,Senate,"Senate Labor And Industry: Reported as Committed",10,0,1,0,11
1883252,1462733,2024-07-08,Senate,"Senate Appropriations: Re-Reported as Committed",22,0,2,0,24
1883252,1462888,2024-07-10,Senate,"Senate Floor: SB 1274 PN 1773, Final Passage",49,0,0,1,50
1883252,1468151,2024-10-07,House,"House Labor And Industry: Report Bill As Committed",21,4,0,0,25
1883252,1468325,2024-10-08,House,"House Floor: SB 1274 PN 1773, 2023 A5748",201,0,0,2,203
1883252,1468461,2024-10-09,House,"House Floor: SB 1274 PN 1951, FINAL PASSAGE",202,0,0,1,203
1883252,1468554,2024-10-09,Senate,"Senate Floor: SB 1274 PN 1951, Concur in House Amendments",49,0,0,1,50
1883252,1468555,2024-10-09,Senate,"Senate Rules And Executive Nominations: Re-Reported as Committed",17,0,0,0,17
1883252,1468967,2024-10-09,House,"House Appropriations: Re-report Bill As Committed",37,0,0,0,37
1883254,1462192,2024-07-02,House,"House State Government: Report Bill As Committed",14,11,0,0,25
1883254,1467838,2024-09-30,House,"House Floor: HB 2450 PN 3401, 2023 A5385",99,103,0,1,203
1883254,1467839,2024-09-30,House,"House Floor: HB 2450 PN 3401, 2023 A5391",99,103,0,1,203
1883254,1467864,2024-10-01,House,"House Appropriations: Re-report Bill As Committed",37,0,0,0,37
1883254,1467981,2024-10-01,House,"House Floor: HB 2450 PN 3401, FINAL PASSAGE",108,94,0,1,203
1883269,1467651,2024-09-25,House,"House Local Government: Report Bill As Committed",25,0,0,0,25
1883301,1461356,2024-06-28,House,"House Agriculture And Rural Affairs: Adopt Amendment A05257",24,1,0,0,25
1883301,1461357,2024-06-28,House,"House Agriculture And Rural Affairs: Report Bill As Amended",22,3,0,0,25
1883301,1462176,2024-07-02,House,"House Rules: Re-report Bill As Committed",33,0,0,0,33
1883301,1462396,2024-07-03,House,"House Floor: HB 2451 PN 3441, FINAL PASSAGE",166,36,0,1,203
1883301,1462397,2024-07-03,House,"House Appropriations: Re-report Bill As Committed",22,15,0,0,37
1883301,1468224,2024-10-07,Senate,"Senate Agriculture And Rural Affairs: Reported as Committed",8,3,0,0,11
1883311,1467274,2024-09-05,House,"House Veterans Affairs And Emergency Preparedness: Report Bill As Amended",24,1,0,0,25
1883311,1467275,2024-09-05,House,"House Veterans Affairs And Emergency Preparedness: Adopt Amendment A05248",25,0,0,0,25
1883391,1460167,2024-06-26,House,"House Transportation: Report Bill As Committed",25,0,0,0,25
1883391,1461935,2024-07-01,House,"House Floor: HB 2453 PN 3393, 2023 A5252",202,0,0,1,203
1883391,1461936,2024-07-01,House,"House Floor: HB 2453 PN 3393, 2023 A5319",202,0,0,1,203
1883391,1461937,2024-07-01,House,"House Rules: Re-report Bill As Committed",33,0,0,0,33
1883441,1467879,2024-10-01,Senate,"Senate State Government: Reported as Committed",10,1,0,0,11
1883441,1468255,2024-10-07,Senate,"Senate Appropriations: Re-Reported as Committed",23,0,1,0,24
1883441,1468435,2024-10-08,Senate,"Senate Floor: SB 1277 PN 1784, Final Passage",47,3,0,0,50
1883450,1462400,2024-07-03,Senate,"Senate Finance: Reported as Committed",7,4,0,0,11
1883470,1467625,2024-09-25,House,"House Local Government: Report Bill As Committed",14,11,0,0,25
1883618,1468814,2024-10-22,House,"House Children And Youth: Report Bill As Committed",15,10,0,0,25
1883628,1467835,2024-09-30,House,"House Tourism And Economic And Recreational Development: Report Bill As Committed",25,0,0,0,25
1883887,1467328,2024-09-17,Senate,"Senate Veterans Affairs And Emergency Preparedness: Reported as Committed",6,4,0,0,10
1883888,1468422,2024-10-08,Senate,"Senate Rules And Executive Nominations: Reported as Committed",17,0,0,0,17
1883888,1468648,2024-10-09,Senate,"Senate Floor: SR 312 PN 1794",49,0,0,1,50
1883918,1462190,2024-07-02,House,"House State Government: Appeal the Ruling of the Chair",14,11,0,0,25
1883918,1462191,2024-07-02,House,"House State Government: Report Bill As Committed",14,11,0,0,25
1883918,1462725,2024-07-08,House,"House Rules: Re-report Bill As Committed",19,14,0,0,33
1883918,1462796,2024-07-09,House,"House Floor: HB 2473 PN 3459, FINAL PASSAGE",105,97,0,1,203
1883918,1462797,2024-07-09,House,"House Appropriations: Re-report Bill As Committed",37,0,0,0,37
1883920,1467765,2024-09-30,House,"House Education: Re-refer Bill To Another Committee",25,0,0,0,25
1883921,1462414,2024-07-03,House,"House Professional Licensure: Report Bill As Committed",17,8,0,0,25
1883926,1468465,2024-10-09,House,"House Commerce: Adopt Amendment A05956",25,0,0,0,25
1883926,1468466,2024-10-09,House,"House Commerce: Report Bill As Amended",19,6,0,0,25
1883926,1468844,2024-10-22,House,"House Floor: HB 2481 PN 3747, 2023 A5982",202,0,0,1,203
1883926,1468871,2024-10-23,House,"House Floor: HB 2481 PN 3791, FINAL PASSAGE",176,26,0,1,203
1883926,1468905,2024-10-23,House,"House Appropriations: Re-report Bill As Committed",37,0,0,0,37
1883932,1467830,2024-09-30,House,"House Tourism And Economic And Recreational Development: Report Bill As Committed",25,0,0,0,25
1883932,1468566,2024-10-09,House,"House Floor: HR 493 PN 3472",200,2,0,1,203
1883939,1467833,2024-09-30,House,"House Tourism And Economic And Recreational Development: Report Bill As Committed",25,0,0,0,25
1884351,1467641,2024-09-25,House,"House Local Government: Report Bill As Committed",23,2,0,0,25
1884396,1467336,2024-09-17,Senate,"Senate Local Government: Reported as Committed",11,0,0,0,11
1884396,1467821,2024-09-30,Senate,"Senate Appropriations: Re-Reported as Committed",23,0,1,0,24
1884396,1468182,2024-10-07,Senate,"Senate Floor: SB 1289 PN 1830, Final Passage",48,0,0,2,50
1884405,1467346,2024-09-17,Senate,"Senate Consumer Protection And Professional Licensure: Reported as Committed",13,1,0,0,14
1884548,1468170,2024-10-07,Senate,"Senate Agriculture And Rural Affairs: Reported as Committed",11,0,0,0,11
1884559,1468074,2024-10-02,House,"House Health: Report Bill As Committed",25,0,0,0,25
1884583,1467832,2024-09-30,House,"House Tourism And Economic And Recreational Development: Report Bill As Committed",25,0,0,0,25
1884583,1467927,2024-10-01,House,"House Floor: HR 502 PN 3533",201,1,0,1,203
1884856,1468084,2024-10-02,House,"House Health: Report Bill As Committed",25,0,0,0,25
1884899,1467873,2024-10-01,Senate,"Senate Judiciary: Reported as Amended",9,4,1,0,14
1884899,1467874,2024-10-01,Senate,"Senate Judiciary: Adopt Amendment A05770",13,0,1,0,14
1884899,1468430,2024-10-08,Senate,"Senate Floor: SB 1300 PN 1925, Final Passage",26,24,0,0,50
1884899,1468431,2024-10-08,Senate,"Senate Appropriations: Re-Reported as Committed",15,9,0,0,24
1885364,1468072,2024-10-02,House,"House Judiciary: Report Bill As Committed",14,11,0,0,25
1885712,1467881,2024-10-01,House,"House Game And Fisheries: Report Bill As Committed",25,0,0,0,25
1885721,1468087,2024-10-02,House,"House Human Services: Adopt Amendment A05792",25,0,0,0,25
1885721,1468088,2024-10-02,House,"House Human Services: Report Bill As Amended",25,0,0,0,25
1885721,1468553,2024-10-09,House,"House Floor: HB 2533 PN 3706, 2023 A5870",202,0,0,1,203
1885721,1468893,2024-10-23,House,"House Floor: HB 2533 PN 3757, FINAL PASSAGE",202,0,0,1,203
1885721,1468894,2024-10-23,House,"House Appropriations: Re-report Bill As Committed",37,0,0,0,37
1885796,1467545,2024-09-23,House,"House Veterans Affairs And Emergency Preparedness: Report Bill As Committed",25,0,0,0,25
1885797,1468091,2024-10-02,House,"House Health: Report Bill As Committed",25,0,0,0,25
1885798,1467971,2024-10-01,House,"House Commerce: Adopt Amendment A05771",25,0,0,0,25
1885798,1467972,2024-10-01,House,"House Commerce: Report Bill As Amended",25,0,0,0,25
1885798,1468843,2024-10-22,House,"House Floor: HR 512 PN 3696",201,1,0,1,203
1885799,1468005,2024-10-01,House,"House Commerce: Adopt Amendment A05634",25,0,0,0,25
1885799,1468006,2024-10-01,House,"House Commerce: Adopt Amendment A05640",25,0,0,0,25
1885799,1468007,2024-10-01,House,"House Commerce: Report Bill As Amended",14,11,0,0,25
1885800,1467789,2024-09-30,House,"House Consumer Protection, Technology And Utilities: Report Bill As Committed",25,0,0,0,25
1885800,1468041,2024-10-02,House,"House Floor: HR 511 PN 3570",201,1,0,1,203
1885801,1468178,2024-10-07,House,"House Liquor Control: Report Bill As Committed",25,0,0,0,25
1885801,1468565,2024-10-09,House,"House Floor: HR 513 PN 3572",199,3,0,1,203
1885817,1467909,2024-10-01,House,"House Finance: Report Bill As Committed",24,1,0,0,25
1885817,1468045,2024-10-02,House,"House Floor: HB 2536 PN 3567, 2023 A5779",202,0,0,1,203
1885817,1468193,2024-10-07,House,"House Floor: HB 2536 PN 3707, FINAL PASSAGE",202,0,0,1,203
1885817,1468194,2024-10-07,House,"House Appropriations: Re-report Bill As Committed",37,0,0,0,37
1886418,1467905,2024-10-01,House,"House State Government: Adopt Resolution",24,1,0,0,25
1886418,1468052,2024-10-02,House,"House Floor: HR 516 PN 3590",201,1,0,1,203
1886437,1467544,2024-09-23,House,"House Veterans Affairs And Emergency Preparedness: Report Bill As Committed",25,0,0,0,25
1886482,1467949,2024-10-01,Senate,"Senate Aging And Youth: Reported as Committed",9,0,2,0,11
1886485,1467714,2024-09-30,House,"House Human Services: Report Bill As Committed",24,0,0,0,24
1886485,1467836,2024-09-30,House,"House Floor: HR 519 PN 3593",201,1,0,1,203
1886561,1468098,2024-10-02,House,"House Health: Report Bill As Committed",25,0,0,0,25
1886562,1467737,2024-09-30,House,"House Labor And Industry: Adopt Amendment A05707",14,11,0,0,25
1886562,1467738,2024-09-30,House,"House Labor And Industry: Adopt Amendment A05686",11,14,0,0,25
1886562,1467739,2024-09-30,House,"House Labor And Industry: Report Bill As Amended",14,11,0,0,25
1886613,1467547,2024-09-23,House,"House Veterans Affairs And Emergency Preparedness: Report Bill As Committed",25,0,0,0,25
1886613,1467741,2024-09-30,House,"House Floor: HR 520 PN 3594",201,1,0,1,203
1886625,1467917,2024-10-01,House,"House State Government: Adopt Resolution",24,1,0,0,25
1886625,1468442,2024-10-08,House,"House Floor: HR 521 PN 3595",200,1,0,2,203
1886653,1467443,2024-09-18,Senate,"Senate Transportation: Reported as Committed",13,0,1,0,14
1886658,1467348,2024-09-17,Senate,"Senate Judiciary: Reported as Amended",13,0,1,0,14
1886658,1467349,2024-09-17,Senate,"Senate Judiciary: Adopt Amendment A05604",13,0,1,0,14
1886669,1468089,2024-10-02,House,"House Health: Report Bill As Committed",25,0,0,0,25
1886735,1467767,2024-09-30,House,"House Consumer Protection, Technology And Utilities: Adopt Amendment A05630",24,1,0,0,25
1886735,1467768,2024-09-30,House,"House Consumer Protection, Technology And Utilities: Report Bill As Amended",24,1,0,0,25
1886735,1468531,2024-10-09,House,"House Floor: HB 2557 PN 3679, 2023 A5813",100,102,0,1,203
1886735,1468772,2024-10-21,House,"House Floor: HB 2557 PN 3679, FINAL PASSAGE",153,49,0,1,203
1886735,1468773,2024-10-21,House,"House Appropriations: Re-report Bill As Committed",37,0,0,0,37
1886778,1467859,2024-10-01,Senate,"Senate Finance: Reported as Amended",9,1,1,0,11
1886778,1467860,2024-10-01,Senate,"Senate Finance: Adopt Amendment A05775",9,1,1,0,11
1886779,1467785,2024-09-30,House,"House Agriculture And Rural Affairs: Report Bill As Committed",25,0,0,0,25
1886779,1468166,2024-10-07,House,"House Floor: HB 2561 PN 3611, FINAL PASSAGE",202,0,0,1,203
1886779,1468167,2024-10-07,Senate,"Senate Agriculture And Rural Affairs: Reported as Committed",11,0,0,0,11
1886779,1468168,2024-10-07,House,"House Appropriations: Re-report Bill As Committed",37,0,0,0,37
1886779,1468464,2024-10-09,Senate,"Senate Appropriations: Re-Reported as Committed",24,0,0,0,24
1886779,1468556,2024-10-09,Senate,"Senate Floor: HB 2561 PN 3611, Final Passage",49,0,0,1,50
1886816,1467783,2024-09-30,House,"House Insurance: Report Bill As Committed",23,2,0,0,25
1886816,1468484,2024-10-09,House,"House Floor: HB 2562 PN 3598, FINAL PASSAGE",160,42,0,1,203
1886816,1468485,2024-10-09,House,"House Appropriations: Re-report Bill As Committed",37,0,0,0,37
1886833,1467717,2024-09-30,House,"House Insurance: Report Bill As Committed",24,1,0,0,25
1886833,1468469,2024-10-09,House,"House Floor: HB 2563 PN 3599, FINAL PASSAGE",163,39,0,1,203
1886833,1468470,2024-10-09,House,"House Appropriations: Re-report Bill As Committed",37,0,0,0,37
1886852,1467779,2024-09-30,House,"House Insurance: Report Bill As Committed",24,1,0,0,25
1886852,1468537,2024-10-09,House,"House Floor: HB 2564 PN 3600, FINAL PASSAGE",174,28,0,1,203
1886852,1468538,2024-10-09,House,"House Appropriations: Re-report Bill As Committed",37,0,0,0,37
1886914,1468095,2024-10-02,House,"House Health: Report Bill As Committed",25,0,0,0,25
1886920,1467712,2024-09-30,House,"House Labor And Industry: Adopt Amendment A05679",25,0,0,0,25
1886920,1467713,2024-09-30,House,"House Labor And Industry: Report Bill As Amended",24,1,0,0,25
1886926,1467740,2024-09-30,House,"House Human Services: Report Bill As Committed",24,0,0,0,24
1886926,1468047,2024-10-02,House,"House Floor: HR 525 PN 3613",201,1,0,1,203
1886936,1467786,2024-09-30,House,"House Floor: HR 528 PN 3614",201,1,0,1,203
1886936,1467787,2024-09-30,House,"House Agriculture And Rural Affairs: Report Bill As Committed",25,0,0,0,25
1886969,1467790,2024-09-30,House,"House Education: Report Bill As Committed",25,0,0,0,25
1886969,1468061,2024-10-02,House,"House Floor: HR 527 PN 3630",201,1,0,1,203
1887003,1468156,2024-10-07,House,"House Veterans Affairs And Emergency Preparedness: Report Bill As Committed",25,0,0,0,25
1887114,1467337,2024-09-17,Senate,"Senate Veterans Affairs And Emergency Preparedness: Reported as Committed",10,0,0,0,10
1887189,1468140,2024-10-07,House,"House Education: Report Bill As Committed",14,11,0,0,25
1887194,1467347,2024-09-17,Senate,"Senate Judiciary: Reported as Committed",13,0,1,0,14
1887194,1467890,2024-10-01,Senate,"Senate Floor: SB 1317 PN 1872, Final Passage",48,0,0,2,50
1887212,1467908,2024-10-01,House,"House State Government: Adopt Resolution",24,1,0,0,25
1887212,1468439,2024-10-08,House,"House Floor: HR 530 PN 3632",200,1,0,2,203
1887214,1467353,2024-09-17,Senate,"Senate Consumer Protection And Professional Licensure: Reported as Committed",13,1,0,0,14
1887214,1467897,2024-10-01,Senate,"Senate Floor: SB 1319 PN 1879, Final Passage",48,0,0,2,50
1887214,1467898,2024-10-01,Senate,"Senate Appropriations: Re-Reported as Committed",23,0,1,0,24
1887214,1468540,2024-10-09,House,"House Professional Licensure: Report Bill As Committed",17,8,0,0,25
1887214,1468861,2024-10-22,House,"House Appropriations: Re-report Bill As Committed",37,0,0,0,37
1887214,1468904,2024-10-23,House,"House Floor: SB 1319 PN 1879, FINAL PASSAGE",130,72,0,1,203
1887221,1467342,2024-09-17,Senate,"Senate Banking And Insurance: Reported as Committed",14,0,0,0,14
1887221,1467784,2024-09-30,Senate,"Senate Appropriations: Re-Reported as Committed",23,0,1,0,24
1887221,1468434,2024-10-08,Senate,"Senate Floor: SB 1320 PN 1938, Final Passage",50,0,0,0,50
1887221,1468727,2024-10-21,House,"House Commerce: Report Bill As Committed",25,0,0,0,25
1887312,1467548,2024-09-23,House,"House Veterans Affairs And Emergency Preparedness: Report Bill As Committed",25,0,0,0,25
1887340,1467918,2024-10-01,House,"House Finance: Re-report Bill As Committed",24,1,0,0,25
1887340,1468856,2024-10-22,House,"House Floor: HB 2565 PN 3616, 2023 A5994",116,86,0,1,203
1887340,1468883,2024-10-23,House,"House Floor: HB 2565 PN 3792, FINAL PASSAGE",119,83,0,1,203
1887340,1468884,2024-10-23,House,"House Appropriations: Re-report Bill As Committed",25,12,0,0,37
1887426,1468158,2024-10-07,Senate,"Senate Rules And Executive Nominations: Reported as Committed",11,5,1,0,17
1887426,1468374,2024-10-08,Senate,"Senate Floor: SR 334 PN 1892",28,22,0,0,50
1887428,1467914,2024-10-01,House,"House State Government: Adopt Resolution",19,6,0,0,25
1887433,1467796,2024-09-30,House,"House Education: Report Bill As Committed",25,0,0,0,25
1887665,1468246,2024-10-07,House,"House Education: Adopt Amendment A05818",14,11,0,0,25
1887665,1468247,2024-10-07,House,"House Education: Report Bill As Amended",14,11,0,0,25
1887751,1468094,2024-10-02,House,"House Health: Report Bill As Committed",25,0,0,0,25
1887758,1467778,2024-09-30,House,"House Transportation: Report Bill As Committed",25,0,0,0,25
1887759,1467880,2024-10-01,House,"House Game And Fisheries: Report Bill As Committed",25,0,0,0,25
1887759,1468896,2024-10-23,House,"House Floor: HB 2583 PN 3643, FINAL PASSAGE",179,23,0,1,203
1887759,1468897,2024-10-23,House,"House Appropriations: Re-report Bill As Committed",37,0,0,0,37
1887851,1468096,2024-10-02,House,"House Health: Report Bill As Committed",25,0,0,0,25
1887855,1467857,2024-10-01,House,"House Environmental Resources And Energy: Adopt Amendment A05766",25,0,0,0,25
1887855,1467858,2024-10-01,House,"House Environmental Resources And Energy: Report Bill As Amended",16,9,0,0,25
1887855,1468548,2024-10-09,House,"House Floor: HB 2594 PN 3689, 2023 A5957",199,3,0,1,203
1887855,1468764,2024-10-21,House,"House Floor: HB 2594 PN 3758, FINAL PASSAGE",165,37,0,1,203
1887855,1468765,2024-10-21,House,"House Appropriations: Re-report Bill As Committed",26,11,0,0,37
1887947,1467991,2024-10-01,House,"House Game And Fisheries: Report Bill As Committed",25,0,0,0,25
1887952,1468154,2024-10-07,House,"House Veterans Affairs And Emergency Preparedness: Report Bill As Committed",25,0,0,0,25
1887956,1467871,2024-10-01,House,"House State Government: Adopt Resolution",24,1,0,0,25
1888398,1468090,2024-10-02,House,"House Health: Report Bill As Committed",25,0,0,0,25
1888400,1468155,2024-10-07,House,"House Veterans Affairs And Emergency Preparedness: Report Bill As Committed",25,0,0,0,25
1888400,1468737,2024-10-21,House,"House Floor: HR 544 PN 3664",202,0,0,1,203
1888411,1467715,2024-09-30,House,"House Education: Report Bill As Committed",24,1,0,0,25
1888411,1468774,2024-10-21,House,"House Floor: HB 2599 PN 3655, FINAL PASSAGE",192,10,0,1,203
1888411,1468775,2024-10-21,House,"House Appropriations: Re-report Bill As Committed",37,0,0,0,37
1888425,1468388,2024-10-08,House,"House Aging And Older Adult Services: Report Bill As Committed",25,0,0,0,25
1888425,1468490,2024-10-09,House,"House Floor: HR 545 PN 3665",200,2,0,1,203
1888429,1467895,2024-10-01,House,"House State Government: Report Bill As Committed",14,11,0,0,25
1888435,1468110,2024-09-30,House,"House Floor: UNCONTESTED CALENDAR SUP A",202,0,0,1,203
1888541,1467882,2024-10-01,House,"House Game And Fisheries: Report Bill As Committed",25,0,0,0,25
1888541,1468876,2024-10-23,House,"House Floor: HB 2608 PN 3685, FINAL PASSAGE",179,23,0,1,203
1888541,1468877,2024-10-23,House,"House Appropriations: Re-report Bill As Committed",37,0,0,0,37
1888616,1467989,2024-10-01,House,"House State Government: Adopt Resolution",24,1,0,0,25
1888616,1468732,2024-10-21,House,"House Floor: HR 547 PN 3687",200,2,0,1,203
1888669,1468145,2024-10-07,House,"House Veterans Affairs And Emergency Preparedness: Report Bill As Committed",25,0,0,0,25
1888680,1468097,2024-10-02,House,"House Finance: Report Bill As Committed",25,0,0,0,25
1888680,1468318,2024-10-08,House,"House Floor: HR 549 PN 3703",200,1,0,2,203
1888684,1468026,2024-10-02,House,"House Professional Licensure: Report Bill As Committed",25,0,0,0,25
1888684,1468308,2024-10-08,House,"House Appropriations: Re-report Bill As Committed",37,0,0,0,37
1888684,1468447,2024-10-08,House,"House Floor: HB 2610 PN 3698, FINAL PASSAGE",201,0,0,2,203
1888684,1468448,2024-10-08,Senate,"Senate Consumer Protection And Professional Licensure: Reported as Committed",14,0,0,0,14
1888684,1468786,2024-10-21,Senate,"Senate Floor: HB 2610 PN 3698, Final Passage",48,0,0,2,50
1888707,1468793,2024-10-21,House,"House Veterans Affairs And Emergency Preparedness: Report Bill As Committed",25,0,0,0,25
1888712,1468766,2024-10-21,House,"House Veterans Affairs And Emergency Preparedness: Report Bill As Committed",25,0,0,0,25
1888724,1468257,2024-10-07,House,"House Transportation: Report Bill As Committed",25,0,0,0,25
1888724,1468853,2024-10-22,House,"House Floor: HR 555 PN 3713",201,1,0,1,203
1888731,1468279,2024-10-07,House,"House Appropriations: Report Bill As Committed",37,0,0,0,37
1888731,1468820,2024-10-22,House,"House Floor: HR 553 PN 3714",201,1,0,1,203
1888743,1468412,2024-10-08,Senate,"Senate Aging And Youth: Reported as Committed",11,0,0,0,11
1888749,1468153,2024-10-07,House,"House Appropriations: Report Bill As Committed",37,0,0,0,37
1888749,1468833,2024-10-22,House,"House Floor: HR 557 PN 3715",201,1,0,1,203
1888847,1468900,2024-10-23,House,"House Floor: HR 559 PN 3735",201,1,0,1,203
1888857,1468542,2024-10-09,Senate,"Senate Floor: SR 350 PN 1934",49,0,0,1,50
1888857,1468543,2024-10-09,Senate,"Senate Education: Reported as Committed",11,0,0,0,11
1888873,1468546,2024-10-09,Senate,"Senate Transportation: Reported as Committed",14,0,0,0,14
1888909,1468451,2024-10-08,House,"House Transportation: Report Bill As Committed",14,10,1,0,25
1888909,1468797,2024-10-21,House,"House Floor: HB 2625 PN 3741, MOTION TO TABLE AMENDMENTS",102,100,0,1,203
1888909,1468823,2024-10-22,House,"House Appropriations: Re-report Bill As Committed",22,15,0,0,37
1888909,1468860,2024-10-22,House,"House Floor: HB 2625 PN 3741, FINAL PASSAGE",111,91,0,1,203
1888959,1468730,2024-10-21,House,"House Judiciary: Report Bill As Committed",14,11,0,0,25
1888959,1468731,2024-10-21,House,"House Judiciary: Adopt Amendment A06007",11,14,0,0,25
1889353,1468810,2024-10-22,House,"House Children And Youth: Report Bill As Committed",25,0,0,0,25
1889427,1468791,2024-10-21,Senate,"Senate Floor: SR 359 PN 1967",27,21,0,2,50
1889427,1468792,2024-10-21,Senate,"Senate Rules And Executive Nominations: Reported as Committed",11,6,0,0,17
1889462,1468787,2024-10-21,House,"House Appropriations: Report Bill As Committed",37,0,0,0,37
1889462,1468834,2024-10-22,House,"House Floor: HR 566 PN 3766, 2023 A6049",114,88,0,1,203
1889462,1468835,2024-10-22,House,"House Floor: HR 566 PN 3789",150,52,0,1,203
