bill_id,roll_call_id,date,chamber,description,yea,nay,nv,absent,total
1785363,1366847,2024-01-18,Senate,"Senate: Reported from Transportation (15-Y 0-N)",15,0,0,0,15
1785363,1368680,2024-01-22,Senate,"Senate: Constitutional reading dispensed (40-Y 0-N)",40,0,0,0,40
1785363,1368681,2024-01-24,Senate,"Senate: Read third time and passed Senate (40-Y 0-N)",40,0,0,0,40
1785363,1388360,2024-02-20,House,"House: Subcommittee recommends reporting (8-Y 0-N)",8,0,0,0,8
1785363,1388361,2024-02-20,House,"House: Subcommittee recommends reporting (8-Y 0-N)",8,0,0,0,8
1785363,1391322,2024-02-22,House,"House: Reported from Transportation (20-Y 2-N)",20,2,0,0,22
1785363,1396932,2024-02-27,House,"House: VOTE: Passage (90-Y 5-N)",90,5,0,5,100
1785363,1400036,2024-02-29,Senate,"Senate: House amendment agreed to by Senate (39-Y 0-N)",39,0,0,1,40
1785376,1364157,2024-01-12,Senate,"Senate: Reported from Rehabilitation and Social Services with amendments (15-Y 0-N)",15,0,0,0,15
1785376,1432079,2024-01-15,Senate,"Senate: Constitutional reading dispensed (39-Y 0-N)",39,0,0,0,39
1785376,1432080,2024-01-18,Senate,"Senate: Read third time and passed Senate (40-Y 0-N)",40,0,0,0,40
1785376,1432081,2024-02-15,House,"House: Reported from Health and Human Services (22-Y 0-N)",22,0,0,0,22
1785376,1432082,2024-02-20,House,"House: VOTE: Passage (72-Y 26-N)",72,26,0,2,100
1785376,1432083,2024-04-17,Senate,"Senate: Senate concurred in Governor's recommendation (40-Y 0-N)",40,0,0,0,40
1785376,1432084,2024-04-17,House,"House: BLOCK VOTE: (97-Y 0-N)",97,0,0,3,100
1785398,1368041,2024-01-23,Senate,"Senate: Reported from Privileges and Elections (14-Y 0-N)",14,0,0,0,14
1785398,1371566,2024-01-30,Senate,"Senate: Reported from Finance and Appropriations (15-Y 0-N)",15,0,0,0,15
1785398,1376239,2024-02-05,Senate,"Senate: Agreed to by Senate (40-Y 0-N)",40,0,0,0,40
1785398,1386623,2024-02-16,House,"House: Reported from Privileges and Elections (21-Y 0-N)",21,0,0,1,22
1785398,1390274,2024-02-21,House,"House: VOTE: Adoption (99-Y 0-N)",99,0,0,1,100
1785412,1364067,2024-01-11,Senate,"Senate: Reported from Education and Health (15-Y 0-N)",15,0,0,0,15
1785412,1368191,2024-01-24,Senate,"Senate: Reported from Finance and Appropriations (14-Y 0-N)",14,0,0,0,14
1785412,1369356,2024-01-25,Senate,"Senate: Constitutional reading dispensed (40-Y 0-N)",40,0,0,0,40
1785412,1370395,2024-01-29,Senate,"Senate: Read third time and passed Senate (40-Y 0-N)",40,0,0,0,40
1785412,1394672,2024-02-26,House,"House: Reported from Appropriations with substitute (22-Y 0-N)",22,0,0,0,22
1785412,1398457,2024-02-28,House,"House: VOTE: Block Vote Passage (97-Y 0-N)",97,0,0,3,100
1785412,1401032,2024-03-01,Senate,"Senate: House substitute agreed to by Senate (40-Y 0-N)",40,0,0,0,40
1785447,1366690,2024-01-18,House,"House: Subcommittee recommends reporting (6-Y 4-N)",6,4,0,0,10
1785447,1366942,2024-01-19,House,"House: Reported from Public Safety (11-Y 9-N)",11,9,0,2,22
1785447,1368587,2024-01-24,House,"House: Subcommittee recommends reporting with substitute (5-Y 3-N)",5,3,0,1,9
1785447,1370788,2024-01-29,House,"House: Reported from Appropriations with substitute (11-Y 10-N)",11,10,0,1,22
1785447,1374825,2024-02-02,House,"House: VOTE: Passage (51-Y 49-N)",51,49,0,0,100
1785447,1387272,2024-02-19,Senate,"Senate: Reported from Courts of Justice with substitute (8-Y 4-N)",8,4,0,0,12
1785447,1395826,2024-02-27,Senate,"Senate: Constitutional reading dispensed (39-Y 0-N)",39,0,0,1,40
1785447,1395827,2024-02-27,Senate,"Senate: Reported from Finance and Appropriations (10-Y 5-N)",10,5,0,0,15
1785447,1398176,2024-02-28,Senate,"Senate: Passed Senate with substitute (20-Y 19-N)",20,19,0,1,40
1785447,1400473,2024-03-01,House,"House: VOTE: Adoption (50-Y 47-N)",50,47,0,3,100
1785459,1367167,2024-01-22,Senate,"Senate: Reported from Courts of Justice (9-Y 6-N)",9,6,0,0,15
1785459,1372813,2024-01-31,Senate,"Senate: Reported from Finance and Appropriations with amendments (10-Y 5-N)",10,5,0,0,15
1785459,1373887,2024-02-01,Senate,"Senate: Constitutional reading dispensed (40-Y 0-N)",40,0,0,0,40
1785459,1378075,2024-02-07,Senate,"Senate: Pending question, not ordered (18-Y 22-N)",18,22,0,0,40
1785459,1378076,2024-02-07,Senate,"Senate: Read third time and passed Senate (21-Y 19-N)",21,19,0,0,40
1785459,1386630,2024-02-16,House,"House: Reported from Public Safety with substitute (12-Y 10-N)",12,10,0,0,22
1785459,1390512,2024-02-21,House,"House: Reported from Appropriations (12-Y 10-N)",12,10,0,0,22
1785459,1397912,2024-02-28,House,"House: VOTE: Passage (51-Y 49-N)",51,49,0,0,100
1785459,1400681,2024-03-01,Senate,"Senate: House substitute agreed to by Senate (21-Y 19-N)",21,19,0,0,40
1785459,1430115,2024-04-17,Senate,"Senate: Passed in enrolled form rejected (21-Y 19-N)",21,19,0,0,40
1785484,1367677,2024-01-23,Senate,"Senate: Reported from Finance and Appropriations (10-Y 4-N)",10,4,0,0,14
1785484,1368367,2024-01-24,Senate,"Senate: Constitutional reading dispensed (40-Y 0-N)",40,0,0,0,40
1785484,1370355,2024-01-29,Senate,"Senate: Engrossment reconsidered by Senate (40-Y 0-N)",40,0,0,0,40
1785484,1370356,2024-01-29,Senate,"Senate: Constitutional reading dispensed (40-Y 0-N)",40,0,0,0,40
1785484,1370357,2024-01-29,Senate,"Senate: Passed Senate (27-Y 13-N)",27,13,0,0,40
1785484,1390621,2024-02-21,House,"House: Reported from Finance with substitute (13-Y 8-N)",13,8,0,1,22
1785484,1394916,2024-02-26,House,"House: VOTE: Passage (68-Y 28-N)",68,28,0,4,100
1785484,1397863,2024-02-28,Senate,"Senate: House substitute agreed to by Senate (25-Y 14-N)",25,14,0,1,40
1785484,1430199,2024-04-17,Senate,"Senate: Passed in enrolled form rejected (25-Y 15-N)",25,15,0,0,40
1785497,1366481,2024-01-18,Senate,"Senate: Reported from Education and Health with substitute (15-Y 0-N)",15,0,0,0,15
1785497,1367248,2024-01-22,Senate,"Senate: Reported from Local Government (15-Y 0-N)",15,0,0,0,15
1785497,1368836,2024-01-23,Senate,"Senate: Constitutional reading dispensed (39-Y 0-N)",39,0,0,1,40
1785497,1369614,2024-01-25,Senate,"Senate: Read third time and passed Senate (40-Y 0-N)",40,0,0,0,40
1785497,1389718,2024-02-21,House,"House: Subcommittee recommends reporting (8-Y 0-N)",8,0,0,0,8
1785497,1394321,2024-02-26,House,"House: Reported from Education (20-Y 0-N)",20,0,1,1,22
1785497,1399063,2024-02-29,House,"House: VOTE: Passage (96-Y 2-N)",96,2,0,2,100
1785521,1364473,2024-01-16,Senate,"Senate: Continued to 2025 in Privileges and Elections (14-Y 0-N)",14,0,0,0,14
1785529,1364023,2024-01-11,Senate,"Senate: Rereferred from Education and Health (15-Y 0-N)",15,0,0,0,15
1785529,1378657,2024-02-07,Senate,"Senate: Reported from Courts of Justice with amendments (9-Y 6-N)",9,6,0,0,15
1785529,1380132,2024-02-08,Senate,"Senate: Constitutional reading dispensed (40-Y 0-N)",40,0,0,0,40
1785529,1381844,2024-02-12,Senate,"Senate: Read third time and passed Senate (21-Y 19-N)",21,19,0,0,40
1785529,1386944,2024-02-16,House,"House: Reported from Courts of Justice with substitute (12-Y 10-N)",12,10,0,0,22
1785529,1390008,2024-02-21,House,"House: VOTE: Passage (54-Y 46-N)",54,46,0,0,100
1785529,1394567,2024-02-26,Senate,"Senate: House substitute rejected by Senate (0-Y 40-N)",0,40,0,0,40
1785529,1395897,2024-02-27,House,"House: VOTE: Adoption (51-Y 46-N)",51,46,0,3,100
1785529,1430234,2024-04-17,Senate,"Senate: Passed in enrolled form rejected (21-Y 19-N)",21,19,0,0,40
1785542,1367632,2024-01-23,Senate,"Senate: Reported from Finance and Appropriations (14-Y 0-N)",14,0,0,0,14
1785542,1368874,2024-01-24,Senate,"Senate: Constitutional reading dispensed (40-Y 0-N)",40,0,0,0,40
1785542,1370022,2024-01-26,Senate,"Senate: Read third time and passed Senate (38-Y 0-N)",38,0,0,2,40
1785542,1387047,2024-02-16,House,"House: Subcommittee recommends reporting (8-Y 0-N)",8,0,0,0,8
1785542,1387048,2024-02-16,House,"House: Reported from Counties, Cities and Towns (22-Y 0-N)",22,0,0,0,22
1785542,1390559,2024-02-21,House,"House: VOTE: Block Vote Passage (100-Y 0-N)",100,0,0,0,100
1785555,1364470,2024-01-16,Senate,"Senate: Continued to 2025 in Privileges and Elections (14-Y 0-N)",14,0,0,0,14
1785564,1364029,2024-01-11,Senate,"Senate: Rereferred from Education and Health (15-Y 0-N)",15,0,0,0,15
1785564,1378697,2024-02-07,Senate,"Senate: Reported from Courts of Justice with substitute (9-Y 6-N)",9,6,0,0,15
1785564,1380033,2024-02-08,Senate,"Senate: Constitutional reading dispensed (40-Y 0-N)",40,0,0,0,40
1785564,1381566,2024-02-12,Senate,"Senate: Read third time and passed Senate (22-Y 18-N)",22,18,0,0,40
1785564,1387000,2024-02-16,House,"House: Reported from Courts of Justice with substitute (12-Y 10-N)",12,10,0,0,22
1785564,1390360,2024-02-21,House,"House: VOTE: Passage (51-Y 49-N)",51,49,0,0,100
1785564,1393413,2024-02-23,Senate,"Senate: House amendment agreed to by Senate (22-Y 17-N)",22,17,0,1,40
1785578,1379438,2024-02-08,House,"House: Subcommittee recommends laying on the table (3-Y 2-N)",3,2,0,0,5
1785592,1366157,2024-01-16,Senate,"Senate: Passed by indefinitely in Agriculture, Conservation and Natural Resources (8-Y 6-N)",8,6,0,0,14
1785627,1368754,2024-01-24,Senate,"Senate: Reported from Courts of Justice with substitute (14-Y 0-N)",14,0,0,0,14
1785627,1377440,2024-02-06,Senate,"Senate: Reported from Finance and Appropriations (10-Y 0-N 2-A)",10,0,2,0,12
1785627,1378406,2024-02-07,Senate,"Senate: Constitutional reading dispensed (40-Y 0-N)",40,0,0,0,40
1785627,1380931,2024-02-09,Senate,"Senate: Read third time and passed Senate (36-Y 0-N)",36,0,0,4,40
1785627,1386983,2024-02-16,House,"House: Reported from Courts of Justice (22-Y 0-N)",22,0,0,0,22
1785627,1390220,2024-02-21,House,"House: VOTE: Block Vote Passage (100-Y 0-N)",100,0,0,0,100
1785638,1366974,2024-01-19,House,"House: Subcommittee recommends reporting (8-Y 0-N)",8,0,0,0,8
1785638,1366975,2024-01-19,House,"House: Reported from Counties, Cities and Towns (22-Y 0-N)",22,0,0,0,22
1785638,1378797,2024-02-07,House,"House: VOTE: Passage (74-Y 26-N)",74,26,0,0,100
1785638,1387281,2024-02-19,Senate,"Senate: Reported from Local Government (13-Y 1-N 1-A)",13,1,1,0,15
1785638,1389512,2024-02-20,Senate,"Senate: Constitutional reading dispensed (39-Y 0-N)",39,0,0,1,40
1785638,1391049,2024-02-21,Senate,"Senate: Passed Senate (36-Y 4-N)",36,4,0,0,40
1785650,1364301,2024-01-15,Senate,"Senate: Reported from Commerce and Labor (9-Y 6-N)",9,6,0,0,15
1785650,1379726,2024-02-08,Senate,"Senate: Reported from Finance and Appropriations (10-Y 5-N)",10,5,0,0,15
1785650,1380797,2024-02-09,Senate,"Senate: Constitutional reading dispensed (39-Y 0-N)",39,0,0,1,40
1785650,1383445,2024-02-13,Senate,"Senate: Read third time and passed Senate (21-Y 19-N)",21,19,0,0,40
1785650,1389251,2024-02-20,House,"House: Reported from Labor and Commerce (12-Y 10-N)",12,10,0,0,22
1785650,1393973,2024-02-23,House,"House: VOTE: Passage (51-Y 47-N)",51,47,0,2,100
1785650,1429537,2024-04-17,Senate,"Senate: Passed in enrolled form rejected (21-Y 19-N)",21,19,0,0,40
1785663,1374731,2024-02-02,House,"House: Subcommittee recommends reporting (5-Y 3-N)",5,3,0,0,8
1785663,1374732,2024-02-02,House,"House: Reported from Counties, Cities and Towns (13-Y 9-N)",13,9,0,0,22
1785663,1379628,2024-02-08,House,"House: VOTE: Passage (52-Y 45-N)",52,45,0,3,100
1785663,1395840,2024-02-27,Senate,"Senate: Constitutional reading dispensed (39-Y 0-N)",39,0,0,1,40
1785663,1395841,2024-02-27,Senate,"Senate: Reported from Finance and Appropriations (11-Y 4-N)",11,4,0,0,15
1785663,1398231,2024-02-28,Senate,"Senate: Passed Senate (22-Y 17-N)",22,17,0,1,40
1785672,1368167,2024-01-23,Senate,"Senate: Reported from Agriculture, Conservation and Natural Resources with amendment (12-Y 2-N)",12,2,0,0,14
1785672,1369441,2024-01-25,Senate,"Senate: Constitutional reading dispensed (40-Y 0-N)",40,0,0,0,40
1785672,1372019,2024-01-30,Senate,"Senate: Engrossment reconsidered by Senate (40-Y 0-N)",40,0,0,0,40
1785672,1372020,2024-01-30,Senate,"Senate: Committee amendments reconsidered (40-Y 0-N)",40,0,0,0,40
1785672,1372021,2024-01-30,Senate,"Senate: Constitutional reading dispensed (40-Y 0-N)",40,0,0,0,40
1785672,1372838,2024-01-31,Senate,"Senate: Engrossment reconsidered by Senate (40-Y 0-N)",40,0,0,0,40
1785672,1372839,2024-01-31,Senate,"Senate: Constitutional reading dispensed (40-Y 0-N)",40,0,0,0,40
1785672,1372840,2024-01-31,Senate,"Senate: Passed Senate (39-Y 1-N)",39,1,0,0,40
1785672,1390834,2024-02-21,House,"House: Subcommittee recommends reporting with substitute (7-Y 3-N)",7,3,0,0,10
1785672,1397375,2024-02-28,House,"House: Reported from Agriculture, Chesapeake and Natural Resources (15-Y 7-N)",15,7,0,0,22
1785672,1401552,2024-03-04,House,"House: VOTE: Passage (85-Y 13-N)",85,13,0,2,100
1785685,1364277,2024-01-15,Senate,"Senate: Reported from Courts of Justice with amendment (13-Y 1-N)",13,1,0,0,14
1785685,1432193,2024-01-16,Senate,"Senate: Constitutional reading dispensed (38-Y 0-N)",38,0,0,1,39
1785685,1432194,2024-01-18,Senate,"Senate: Read third time and passed Senate (39-Y 1-N)",39,1,0,0,40
1785685,1432195,2024-02-14,House,"House: Subcommittee recommends reporting with amendments (8-Y 0-N)",8,0,0,1,9
1785685,1432196,2024-02-16,House,"House: Reported from Courts of Justice with amendment (22-Y 0-N)",22,0,0,0,22
1785685,1432197,2024-02-21,House,"House: VOTE: Block Vote Passage (100-Y 0-N)",100,0,0,0,100
1785685,1432198,2024-02-23,Senate,"Senate: House amendments agreed to by Senate (38-Y 1-N)",38,1,0,1,40
1785700,1366659,2024-01-18,House,"House: Reported from Labor and Commerce (12-Y 10-N)",12,10,0,0,22
1785700,1368471,2024-01-24,House,"House: Subcommittee recommends reporting (5-Y 3-N)",5,3,0,1,9
1785700,1370849,2024-01-29,House,"House: Reported from Appropriations (11-Y 10-N)",11,10,0,1,22
1785700,1374871,2024-02-02,House,"House: VOTE: Passage (51-Y 49-N)",51,49,0,0,100
1785700,1387591,2024-02-19,Senate,"Senate: Reported from Commerce and Labor (9-Y 5-N)",9,5,0,0,14
1785700,1389803,2024-02-21,Senate,"Senate: Reported from Finance and Appropriations (10-Y 4-N)",10,4,0,0,14
1785700,1391923,2024-02-22,Senate,"Senate: Constitutional reading dispensed (40-Y 0-N)",40,0,0,0,40
1785700,1393454,2024-02-23,Senate,"Senate: Passed Senate (21-Y 18-N)",21,18,0,1,40
1785713,1367796,2024-01-23,Senate,"Senate: Reported from Privileges and Elections (14-Y 0-N)",14,0,0,0,14
1785713,1371556,2024-01-30,Senate,"Senate: Reported from Finance and Appropriations (15-Y 0-N)",15,0,0,0,15
1785713,1372931,2024-01-31,Senate,"Senate: Constitutional reading dispensed (40-Y 0-N)",40,0,0,0,40
1785713,1432131,2024-02-16,House,"House: Reported from Privileges and Elections (21-Y 0-N)",21,0,0,1,22
1785713,1432132,2024-02-21,House,"House: VOTE: Block Vote Passage (100-Y 0-N)",100,0,0,0,100
1785722,1376949,2024-02-06,Senate,"Senate: Continued to 2025 in Finance and Appropriations (14-Y 0-N)",14,0,0,0,14
1785841,1366488,2024-01-18,House,"House: Subcommittee recommends striking from docket (8-Y 0-N)",8,0,0,0,8
1789448,1368153,2024-01-23,Senate,"Senate: Rereferred from Agriculture, Conservation and Natural Resources (15-Y 0-N)",15,0,0,0,15
1789448,1370255,2024-01-29,Senate,"Senate: Reported from Local Government with substitute (15-Y 0-N)",15,0,0,0,15
1789448,1377124,2024-02-06,Senate,"Senate: Reported from Finance and Appropriations (14-Y 1-N)",14,1,0,0,15
1789448,1378206,2024-02-07,Senate,"Senate: Constitutional reading dispensed (40-Y 0-N)",40,0,0,0,40
1789448,1380790,2024-02-09,Senate,"Senate: Read third time and passed Senate (39-Y 1-N)",39,1,0,0,40
1789448,1380791,2024-02-09,Senate,"Senate: Reconsideration of passage agreed to by Senate (40-Y 0-N)",40,0,0,0,40
1789448,1380792,2024-02-09,Senate,"Senate: Passed Senate (40-Y 0-N)",40,0,0,0,40
1789448,1391443,2024-02-22,House,"House: Subcommittee recommends reporting (8-Y 0-N)",8,0,0,0,8
1789448,1393971,2024-02-23,House,"House: Reported from Counties, Cities and Towns (21-Y 1-N)",21,1,0,0,22
1789448,1398093,2024-02-28,House,"House: VOTE: Passage (94-Y 5-N)",94,5,0,1,100
1789459,1378442,2024-02-07,Senate,"Senate: Reported from General Laws and Technology with substitute (13-Y 1-N 1-A)",13,1,1,0,15
1789459,1381575,2024-02-12,Senate,"Senate: Reported from Finance and Appropriations with substitute (15-Y 0-N)",15,0,0,0,15
1789459,1381576,2024-02-12,Senate,"Senate: Constitutional reading dispensed (40-Y 0-N)",40,0,0,0,40
1789459,1382982,2024-02-13,Senate,"Senate: Constitutional reading dispensed (40-Y 0-N)",40,0,0,0,40
1789459,1382983,2024-02-13,Senate,"Senate: Passed Senate (40-Y 0-N)",40,0,0,0,40
1789459,1396077,2024-02-27,House,"House: Subcommittee recommends reporting with substitute (8-Y 0-N)",8,0,0,0,8
1789459,1396877,2024-02-27,House,"House: Reported from General Laws with substitute (21-Y 1-N)",21,1,0,0,22
1789459,1400549,2024-03-01,House,"House: VOTE: Passage (96-Y 0-N)",96,0,0,4,100
1789459,1402945,2024-03-05,Senate,"Senate: House substitute rejected by Senate (0-Y 40-N)",0,40,0,0,40
1789459,1405690,2024-03-07,Senate,"Senate: Senate acceded to request (40-Y 0-N)",40,0,0,0,40
1789459,1406369,2024-03-08,Senate,"Senate: Conference report agreed to by Senate (40-Y 0-N)",40,0,0,0,40
1789459,1406370,2024-03-08,House,"House: VOTE: Adoption (98-Y 0-N)",98,0,0,2,100
1789474,1364171,2024-01-12,Senate,"Senate: Reported from Rehabilitation and Social Services with substitute (15-Y 0-N)",15,0,0,0,15
1789474,1368394,2024-01-24,Senate,"Senate: Reported from Finance and Appropriations (14-Y 0-N)",14,0,0,0,14
1789474,1369607,2024-01-25,Senate,"Senate: Constitutional reading dispensed (40-Y 0-N)",40,0,0,0,40
1789474,1370983,2024-01-29,Senate,"Senate: Read third time and passed Senate (40-Y 0-N)",40,0,0,0,40
1789474,1385309,2024-02-15,House,"House: Reported from Health and Human Services (22-Y 0-N)",22,0,0,0,22
1789474,1389043,2024-02-20,House,"House: VOTE: Block Vote Passage (98-Y 0-N)",98,0,0,2,100
1789561,1367627,2024-01-23,House,"House: Subcommittee recommends laying on the table (8-Y 0-N)",8,0,0,1,9
1789561,1368273,2024-01-24,House,"House: Stricken from docket by Education (21-Y 0-N)",21,0,0,1,22
1789603,1366969,2024-01-19,House,"House: Tabled in Public Safety (12-Y 9-N)",12,9,0,1,22
1790937,1367662,2024-01-23,House,"House: Subcommittee recommends laying on the table (5-Y 2-N)",5,2,0,1,8
1791149,1369357,2024-01-25,House,"House: Subcommittee recommends reporting with substitute (8-Y 0-N)",8,0,0,0,8
1791149,1372063,2024-01-30,House,"House: Reported from Labor and Commerce with substitute (21-Y 1-N)",21,1,0,0,22
1791149,1378314,2024-02-07,House,"House: Subcommittee recommends reporting with substitute (8-Y 0-N)",8,0,0,1,9
1791149,1378315,2024-02-07,House,"House: Reported from Appropriations with substitute (22-Y 0-N)",22,0,0,0,22
1791149,1383444,2024-02-13,House,"House: VOTE: Passage (99-Y 0-N)",99,0,0,1,100
1791149,1395080,2024-02-26,Senate,"Senate: Reported from Commerce and Labor with amendments (15-Y 0-N)",15,0,0,0,15
1791149,1395797,2024-02-27,Senate,"Senate: Constitutional reading dispensed (39-Y 0-N)",39,0,0,1,40
1791149,1395798,2024-02-27,Senate,"Senate: Reported from Finance and Appropriations with substitute (15-Y 0-N)",15,0,0,0,15
1791149,1398219,2024-02-28,Senate,"Senate: Passed Senate with substitute (39-Y 0-N)",39,0,0,1,40
1791149,1398220,2024-02-28,House,"House: VOTE: REJECTED (0-Y 95-N)",0,95,0,5,100
1791149,1398221,2024-02-28,Senate,"Senate: Senate insisted on substitute (39-Y 0-N)",39,0,0,1,40
1791149,1400471,2024-03-01,House,"House: VOTE: Adoption (97-Y 0-N)",97,0,0,3,100
1791149,1400931,2024-03-01,Senate,"Senate: Conference report agreed to by Senate (40-Y 0-N)",40,0,0,0,40
1791254,1366457,2024-01-17,House,"House: Subcommittee recommends reporting (7-Y 0-N)",7,0,0,1,8
1791254,1367652,2024-01-23,House,"House: Reported from Transportation (21-Y 0-N)",21,0,0,1,22
1791254,1370998,2024-01-29,House,"House: VOTE: Block Vote Passage (98-Y 0-N)",98,0,0,2,100
1791254,1386611,2024-02-15,Senate,"Senate: Reported from Transportation (12-Y 0-N)",12,0,0,0,12
1791254,1387687,2024-02-19,Senate,"Senate: Constitutional reading dispensed (38-Y 0-N)",38,0,0,2,40
1791254,1389184,2024-02-20,Senate,"Senate: Passed Senate (40-Y 0-N)",40,0,0,0,40
1791324,1376014,2024-02-05,House,"House: Subcommittee recommends reporting with substitute (8-Y 0-N)",8,0,0,1,9
1791324,1378497,2024-02-07,House,"House: Reported from Courts of Justice with substitute (22-Y 0-N)",22,0,0,0,22
1791324,1383514,2024-02-13,House,"House: VOTE: Block Vote Passage (99-Y 0-N)",99,0,0,1,100
1791324,1390844,2024-02-21,Senate,"Senate: Reported from Courts of Justice (9-Y 0-N)",9,0,0,0,9
1791324,1397391,2024-02-28,Senate,"Senate: Reported from Finance and Appropriations (15-Y 0-N)",15,0,0,0,15
1791324,1399659,2024-02-29,Senate,"Senate: Constitutional reading dispensed (39-Y 0-N)",39,0,0,1,40
1791324,1400866,2024-03-01,Senate,"Senate: Passed Senate (40-Y 0-N)",40,0,0,0,40
1791330,1367808,2024-01-23,House,"House: Subcommittee recommends laying on the table (6-Y 2-N)",6,2,0,1,9
1791335,1366962,2024-01-19,House,"House: Passed by indefinitely in Public Safety (12-Y 9-N)",12,9,0,1,22
1791429,1378361,2024-02-07,Senate,"Senate: Reported from Courts of Justice with amendment (8-Y 4-N 3-A)",8,4,3,0,15
1791429,1379255,2024-02-08,Senate,"Senate: Constitutional reading dispensed (40-Y 0-N)",40,0,0,0,40
1791429,1382265,2024-02-12,Senate,"Senate: Read third time and passed Senate (21-Y 19-N)",21,19,0,0,40
1791429,1386816,2024-02-16,House,"House: Reported from Courts of Justice with substitute (11-Y 10-N)",11,10,0,1,22
1791429,1390210,2024-02-21,House,"House: VOTE: Passage (51-Y 49-N)",51,49,0,0,100
1791429,1393526,2024-02-23,Senate,"Senate: House substitute agreed to by Senate (21-Y 18-N)",21,18,0,1,40
1791429,1430333,2024-04-17,Senate,"Senate: Passed in enrolled form rejected (21-Y 19-N)",21,19,0,0,40
1791435,1369004,2024-01-25,Senate,"Senate: Reported from Education and Health with substitute (8-Y 6-N 1-A)",8,6,1,0,15
1791435,1369931,2024-01-26,Senate,"Senate: Constitutional reading dispensed (37-Y 0-N)",37,0,0,3,40
1791435,1373683,2024-02-01,Senate,"Senate: Reported from Education and Health with substitute (15-Y 0-N)",15,0,0,0,15
1791435,1375923,2024-02-05,Senate,"Senate: Read third time and passed Senate (38-Y 1-N)",38,1,0,1,40
1791435,1375924,2024-02-05,Senate,"Senate: Reconsideration of passage agreed to by Senate (40-Y 0-N)",40,0,0,0,40
1791435,1375925,2024-02-05,Senate,"Senate: Passed Senate (40-Y 0-N)",40,0,0,0,40
1791435,1387328,2024-02-19,House,"House: Subcommittee recommends reporting with substitute (7-Y 3-N)",7,3,0,0,10
1791435,1389822,2024-02-21,House,"House: Reported from Education with substitute (15-Y 7-N)",15,7,0,0,22
1791435,1394968,2024-02-26,House,"House: VOTE: Passage (86-Y 10-N)",86,10,0,4,100
1791435,1397895,2024-02-28,Senate,"Senate: House substitute rejected by Senate (0-Y 39-N)",0,39,0,1,40
1791435,1402101,2024-03-04,Senate,"Senate: Senate acceded to request (38-Y 0-N)",38,0,0,2,40
1791435,1404382,2024-03-06,House,"House: VOTE: Adoption (98-Y 0-N)",98,0,0,2,100
1791435,1405217,2024-03-07,Senate,"Senate: Conference report agreed to by Senate (40-Y 0-N)",40,0,0,0,40
1791438,1366483,2024-01-18,Senate,"Senate: Reported from Education and Health (13-Y 2-N)",13,2,0,0,15
1791438,1368534,2024-01-19,Senate,"Senate: Constitutional reading dispensed (37-Y 0-N)",37,0,0,3,40
1791438,1368535,2024-01-23,Senate,"Senate: Read third time and passed Senate (36-Y 3-N)",36,3,0,1,40
1791438,1395623,2024-02-27,House,"House: Subcommittee recommends reporting (8-Y 0-N)",8,0,0,0,8
1791438,1397280,2024-02-28,House,"House: Reported from Education (19-Y 1-N)",19,1,0,2,22
1791441,1366480,2024-01-18,Senate,"Senate: Reported from Education and Health (15-Y 0-N)",15,0,0,0,15
1791441,1371460,2024-01-30,Senate,"Senate: Reported from Finance and Appropriations with substitute (15-Y 0-N)",15,0,0,0,15
1791441,1373028,2024-01-31,Senate,"Senate: Constitutional reading dispensed (40-Y 0-N)",40,0,0,0,40
1791441,1432109,2024-02-26,House,"House: Tabled in Appropriations (22-Y 0-N)",22,0,0,0,22
1791447,1366875,2024-01-19,Senate,"Senate: Reported from Rehabilitation and Social Services (15-Y 0-N)",15,0,0,0,15
1791447,1368741,2024-01-22,Senate,"Senate: Constitutional reading dispensed (40-Y 0-N)",40,0,0,0,40
1791447,1368742,2024-01-24,Senate,"Senate: Read third time and passed Senate (40-Y 0-N)",40,0,0,0,40
1791447,1396068,2024-02-27,House,"House: Subcommittee recommends reporting (8-Y 0-N)",8,0,0,0,8
1791447,1396872,2024-02-27,House,"House: Reported from General Laws (22-Y 0-N)",22,0,0,0,22
1791447,1400584,2024-03-01,House,"House: VOTE: Passage (91-Y 5-N)",91,5,0,4,100
1791451,1364404,2024-01-16,Senate,"Senate: Rereferred from Privileges and Elections (14-Y 0-N)",14,0,0,0,14
1791451,1368998,2024-01-25,Senate,"Senate: Reported from Education and Health with amendments (15-Y 0-N)",15,0,0,0,15
1791451,1372836,2024-01-31,Senate,"Senate: Reported from Finance and Appropriations (15-Y 0-N)",15,0,0,0,15
1791451,1374270,2024-02-01,Senate,"Senate: Constitutional reading dispensed (40-Y 0-N)",40,0,0,0,40
1791451,1375902,2024-02-05,Senate,"Senate: Read third time and passed Senate (40-Y 0-N)",40,0,0,0,40
1791451,1385743,2024-02-15,House,"House: Reported from Health and Human Services (22-Y 0-N)",22,0,0,0,22
1791451,1388572,2024-02-20,House,"House: VOTE: Block Vote Passage (98-Y 0-N)",98,0,0,2,100
1791456,1366077,2024-01-16,Senate,"Senate: Reported from Agriculture, Conservation and Natural Resources (13-Y 0-N)",13,0,0,0,13
1791456,1368192,2024-01-24,Senate,"Senate: Reported from Finance and Appropriations (13-Y 0-N)",13,0,0,0,13
1791456,1369363,2024-01-25,Senate,"Senate: Constitutional reading dispensed (40-Y 0-N)",40,0,0,0,40
1791456,1370396,2024-01-29,Senate,"Senate: Read third time and passed Senate (40-Y 0-N)",40,0,0,0,40
1791456,1384138,2024-02-14,House,"House: Reported from Agriculture, Chesapeake and Natural Resources (21-Y 0-N)",21,0,0,1,22
1791456,1387398,2024-02-19,House,"House: VOTE: Passage (93-Y 6-N)",93,6,0,1,100
1791460,1373726,2024-01-31,Senate,"Senate: Reported from Courts of Justice with substitute (15-Y 0-N)",15,0,0,0,15
1791460,1377167,2024-02-06,Senate,"Senate: Read third time and passed Senate (39-Y 0-N)",39,0,0,1,40
1791460,1432091,2024-02-16,House,"House: Subcommittee recommends reporting (8-Y 0-N)",8,0,0,1,9
1791460,1432092,2024-02-23,House,"House: Reported from Courts of Justice (21-Y 0-N)",21,0,0,1,22
1791460,1432093,2024-02-28,House,"House: VOTE: Block Vote Passage (97-Y 0-N)",97,0,0,3,100
1791463,1368984,2024-01-25,Senate,"Senate: Reported from Education and Health with amendment (15-Y 0-N)",15,0,0,0,15
1791463,1369941,2024-01-26,Senate,"Senate: Constitutional reading dispensed (37-Y 0-N)",37,0,0,3,40
1791463,1371978,2024-01-30,Senate,"Senate: Read third time and passed Senate (40-Y 0-N)",40,0,0,0,40
1791463,1388438,2024-02-20,House,"House: Reported from Health and Human Services (22-Y 0-N)",22,0,0,0,22
1791463,1394099,2024-02-23,House,"House: VOTE: Block Vote Passage (98-Y 0-N)",98,0,0,2,100
1792049,1366693,2024-01-18,House,"House: Subcommittee recommends reporting with substitute (10-Y 0-N)",10,0,0,0,10
1792049,1366930,2024-01-19,House,"House: Reported from Public Safety with substitute (20-Y 0-N)",20,0,0,2,22
1792049,1368658,2024-01-24,House,"House: Subcommittee recommends reporting (8-Y 0-N)",8,0,0,1,9
1792049,1370826,2024-01-29,House,"House: Reported from Appropriations (21-Y 0-N)",21,0,0,1,22
1792049,1374637,2024-02-02,House,"House: VOTE: Block Vote Passage (92-Y 0-N)",92,0,0,8,100
1792049,1387344,2024-02-19,Senate,"Senate: Reported from Courts of Justice with substitute (13-Y 0-N)",13,0,0,0,13
1792049,1397507,2024-02-28,Senate,"Senate: Reported from Finance and Appropriations (10-Y 5-N)",10,5,0,0,15
1792049,1399128,2024-02-29,Senate,"Senate: Constitutional reading dispensed (39-Y 0-N)",39,0,0,1,40
1792049,1400958,2024-03-01,Senate,"Senate: Passed Senate with substitute (27-Y 13-N)",27,13,0,0,40
1792049,1401604,2024-03-04,House,"House: VOTE: Adoption (89-Y 2-N)",89,2,0,9,100
1792453,1364415,2024-01-16,Senate,"Senate: Passed by indefinitely in Privileges and Elections (8-Y 6-N)",8,6,0,0,14
1792466,1368076,2024-01-23,Senate,"Senate: Reported from Agriculture, Conservation and Natural Resources with amendment (9-Y 6-N)",9,6,0,0,15
1792466,1371577,2024-01-30,Senate,"Senate: Continued to 2025 in Finance and Appropriations (10-Y 5-N)",10,5,0,0,15
1792479,1366335,2024-01-17,House,"House: Subcommittee recommends reporting (7-Y 0-N)",7,0,0,1,8
1792479,1368082,2024-01-23,House,"House: Reported from Transportation (21-Y 0-N)",21,0,0,1,22
1792479,1371138,2024-01-29,House,"House: VOTE: Block Vote Passage (98-Y 0-N)",98,0,0,2,100
1792479,1386420,2024-02-15,Senate,"Senate: Reported from Transportation (13-Y 0-N 1-A)",13,0,1,0,14
1792479,1388043,2024-02-19,Senate,"Senate: Constitutional reading dispensed (38-Y 0-N)",38,0,0,2,40
1792479,1389404,2024-02-20,Senate,"Senate: Passed Senate (37-Y 2-N)",37,2,0,1,40
1792493,1364367,2024-01-16,Senate,"Senate: Continued to 2025 in Privileges and Elections (14-Y 0-N)",14,0,0,0,14
1793685,1366187,2024-01-17,House,"House: Reported from Finance with amendment(s) (21-Y 0-N)",21,0,0,1,22
1793685,1367876,2024-01-23,House,"House: VOTE: Block Vote Passage (98-Y 0-N)",98,0,0,2,100
1793685,1368676,2024-01-23,House,"House: VOTE: Block Vote Passage (98-Y 0-N)",98,0,0,2,100
1793685,1395862,2024-02-27,Senate,"Senate: Constitutional reading dispensed (39-Y 0-N)",39,0,0,1,40
1793685,1395863,2024-02-27,Senate,"Senate: Reported from Finance and Appropriations with amendment (15-Y 0-N)",15,0,0,0,15
1793685,1398289,2024-02-28,Senate,"Senate: Passed Senate with amendment (39-Y 0-N)",39,0,0,1,40
1793685,1400491,2024-03-01,House,"House: VOTE: Adoption (95-Y 1-N)",95,1,0,4,100
1793708,1371161,2024-01-29,House,"House: Subcommittee recommends reporting (7-Y 1-N)",7,1,0,0,8
1793708,1374631,2024-02-02,House,"House: Reported from Privileges and Elections (19-Y 3-N)",19,3,0,0,22
1793708,1380765,2024-02-09,House,"House: VOTE: Passage (85-Y 11-N)",85,11,0,4,100
1793708,1389027,2024-02-20,Senate,"Senate: Reported from Privileges and Elections (10-Y 5-N)",10,5,0,0,15
1793708,1392251,2024-02-22,Senate,"Senate: Constitutional reading dispensed (40-Y 0-N)",40,0,0,0,40
1793708,1393769,2024-02-23,Senate,"Senate: Passed Senate (21-Y 17-N)",21,17,0,2,40
1793711,1366699,2024-01-18,House,"House: Subcommittee recommends reporting with substitute (8-Y 0-N)",8,0,0,0,8
1793711,1367691,2024-01-23,House,"House: Reported from Health and Human Services with substitute (21-Y 1-N)",21,1,0,0,22
1793711,1375181,2024-02-02,House,"House: Subcommittee recommends reporting (8-Y 0-N)",8,0,0,1,9
1793711,1375672,2024-02-05,House,"House: Reported from Appropriations (21-Y 0-N)",21,0,0,1,22
1793711,1380876,2024-02-09,House,"House: VOTE: Passage (96-Y 0-N)",96,0,0,4,100
1793711,1386477,2024-02-16,Senate,"Senate: Reported from Rehabilitation and Social Services (12-Y 0-N)",12,0,0,0,12
1793711,1399387,2024-02-29,Senate,"Senate: Reported from Finance and Appropriations (14-Y 0-N)",14,0,0,0,14
1793711,1402518,2024-03-04,Senate,"Senate: Constitutional reading dispensed (40-Y 0-N)",40,0,0,0,40
1793711,1403067,2024-03-05,Senate,"Senate: Passed Senate (40-Y 0-N)",40,0,0,0,40
1793743,1370302,2024-01-29,House,"House: Subcommittee recommends laying on the table (6-Y 0-N)",6,0,0,0,6
1793744,1368509,2024-01-24,Senate,"Senate: Reported from General Laws and Technology with substitute (15-Y 0-N)",15,0,0,0,15
1793744,1369898,2024-01-26,Senate,"Senate: Constitutional reading dispensed (37-Y 0-N)",37,0,0,3,40
1793744,1371927,2024-01-30,Senate,"Senate: Read third time and passed Senate (40-Y 0-N)",40,0,0,0,40
1793744,1389556,2024-02-20,House,"House: Subcommittee recommends reporting with substitute (8-Y 0-N)",8,0,0,0,8
1793744,1392882,2024-02-22,House,"House: Reported from General Laws with substitute (22-Y 0-N)",22,0,0,0,22
1793744,1397048,2024-02-27,House,"House: VOTE: Block Vote Passage (97-Y 0-N)",97,0,0,3,100
1793744,1399949,2024-02-29,Senate,"Senate: House substitute rejected by Senate (0-Y 39-N)",0,39,0,1,40
1793744,1403489,2024-03-05,Senate,"Senate: Senate acceded to request (40-Y 0-N)",40,0,0,0,40
1793744,1406185,2024-03-08,Senate,"Senate: Conference report agreed to by Senate (40-Y 0-N)",40,0,0,0,40
1793744,1406186,2024-03-08,House,"House: VOTE: Adoption (99-Y 0-N)",99,0,0,1,100
1793747,1369044,2024-01-25,Senate,"Senate: Reported from Education and Health with substitute (10-Y 5-N)",10,5,0,0,15
1793747,1372795,2024-01-31,Senate,"Senate: Reported from Finance and Appropriations (15-Y 0-N)",15,0,0,0,15
1793747,1374129,2024-02-01,Senate,"Senate: Constitutional reading dispensed (40-Y 0-N)",40,0,0,0,40
1793747,1376040,2024-02-05,Senate,"Senate: Read third time and passed Senate (36-Y 4-N)",36,4,0,0,40
1793747,1385254,2024-02-15,House,"House: Reported from Health and Human Services (15-Y 7-N)",15,7,0,0,22
1793747,1388614,2024-02-20,House,"House: VOTE: Passage (57-Y 41-N)",57,41,0,2,100
1793747,1429539,2024-04-17,Senate,"Senate: Senate rejected Governor's recommendation (18-Y 22-N)",18,22,0,0,40
1793749,1368987,2024-01-25,Senate,"Senate: Reported from Education and Health with substitute (11-Y 2-N 2-A)",11,2,2,0,15
1793749,1369902,2024-01-26,Senate,"Senate: Constitutional reading dispensed (37-Y 0-N)",37,0,0,3,40
1793749,1371704,2024-01-30,Senate,"Senate: Read third time and passed Senate (34-Y 6-N)",34,6,0,0,40
1793752,1368433,2024-01-24,House,"House: Subcommittee recommends laying on the table (5-Y 3-N)",5,3,0,0,8
1793757,1373748,2024-02-01,Senate,"Senate: Reported from Education and Health with substitute (15-Y 0-N)",15,0,0,0,15
1793757,1379871,2024-02-08,Senate,"Senate: Reported from Finance and Appropriations with amendments (15-Y 0-N)",15,0,0,0,15
1793757,1381124,2024-02-09,Senate,"Senate: Constitutional reading dispensed (39-Y 0-N)",39,0,0,1,40
1793757,1381514,2024-02-12,Senate,"Senate: Constitutional reading dispensed (40-Y 0-N)",40,0,0,0,40
1793757,1381515,2024-02-12,Senate,"Senate: Passed Senate (40-Y 0-N)",40,0,0,0,40
1793757,1396076,2024-02-27,House,"House: Reported from Health and Human Services with amendment(s) (21-Y 0-N)",21,0,0,1,22
1793757,1398677,2024-02-28,House,"House: Reported from Appropriations with substitute (21-Y 1-N)",21,1,0,0,22
1793757,1402754,2024-03-05,House,"House: VOTE: Passage (88-Y 11-N)",88,11,0,1,100
1793757,1404646,2024-03-06,Senate,"Senate: House substitute with amendments agreed to by Senate (40-Y 0-N)",40,0,0,0,40
1793757,1429485,2024-04-17,Senate,"Senate: Senate concurred in Governor's recommendation (40-Y 0-N)",40,0,0,0,40
1793757,1430684,2024-04-17,House,"House: VOTE: Adoption (91-Y 8-N)",91,8,0,1,100
1793759,1379230,2024-02-08,Senate,"Senate: Passed by indefinitely in Education and Health (9-Y 6-N)",9,6,0,0,15
1793765,1370310,2024-01-29,House,"House: Subcommittee recommends reporting with amendments (8-Y 0-N)",8,0,0,1,9
1793765,1372729,2024-01-31,House,"House: Reported from Finance with amendment(s) (19-Y 2-N)",19,2,0,1,22
1793765,1373990,2024-02-01,House,"House: Subcommittee recommends reporting with substitute (9-Y 0-N)",9,0,0,1,10
1793765,1374698,2024-02-02,House,"House: Reported from Public Safety with substitute (22-Y 0-N)",22,0,0,0,22
1793765,1380024,2024-02-08,House,"House: VOTE: Passage (73-Y 25-N)",73,25,0,2,100
1793765,1394255,2024-02-26,Senate,"Senate: Reported from Courts of Justice (15-Y 0-N)",15,0,0,0,15
1793765,1396043,2024-02-27,Senate,"Senate: Constitutional reading dispensed (39-Y 0-N)",39,0,0,1,40
1793765,1399301,2024-02-29,Senate,"Senate: Passed Senate (39-Y 0-N)",39,0,0,1,40
1793768,1366190,2024-01-17,House,"House: Subcommittee recommends reporting with substitute (6-Y 2-N)",6,2,0,1,9
1793768,1366958,2024-01-19,House,"House: Reported from Courts of Justice with substitute (12-Y 10-N)",12,10,0,0,22
1793768,1369790,2024-01-26,House,"House: VOTE: Passage (49-Y 46-N)",49,46,0,5,100
1793768,1384639,2024-02-14,Senate,"Senate: Reported from Courts of Justice with amendment (12-Y 3-N)",12,3,0,0,15
1793768,1399965,2024-02-29,Senate,"Senate: Reported from Finance and Appropriations with amendment (14-Y 0-N)",14,0,0,0,14
1793768,1401826,2024-03-04,Senate,"Senate: Constitutional reading dispensed (40-Y 0-N)",40,0,0,0,40
1793768,1402968,2024-03-05,Senate,"Senate: Passed Senate with amendments (26-Y 14-N)",26,14,0,0,40
1793768,1404206,2024-03-06,House,"House: VOTE: Adoption (51-Y 46-N)",51,46,0,3,100
1793768,1429697,2024-04-17,Senate,"Senate: Senate concurred in Governor's recommendation (40-Y 0-N)",40,0,0,0,40
1793768,1430335,2024-04-17,House,"House: VOTE: Adoption (52-Y 48-N)",52,48,0,0,100
1793772,1374860,2024-02-02,House,"House: Subcommittee recommends reporting with substitute (5-Y 3-N)",5,3,0,1,9
1793772,1381030,2024-02-09,House,"House: Reported from Courts of Justice with substitute (12-Y 10-N)",12,10,0,0,22
1793772,1383308,2024-02-13,House,"House: VOTE: Passage (55-Y 43-N)",55,43,0,2,100
1793772,1394254,2024-02-26,Senate,"Senate: Reported from Courts of Justice (12-Y 0-N)",12,0,0,0,12
1793772,1397514,2024-02-28,Senate,"Senate: Reported from Finance and Appropriations (15-Y 0-N)",15,0,0,0,15
1793772,1399192,2024-02-29,Senate,"Senate: Constitutional reading dispensed (39-Y 0-N)",39,0,0,1,40
1793772,1400997,2024-03-01,Senate,"Senate: Passed Senate (40-Y 0-N)",40,0,0,0,40
1793777,1367057,2024-01-19,Senate,"Senate: Reported from Rehabilitation and Social Services (15-Y 0-N)",15,0,0,0,15
1793777,1372378,2024-01-31,Senate,"Senate: Passed by indefinitely in Finance and Appropriations (10-Y 5-N)",10,5,0,0,15
1793782,1364290,2024-01-15,Senate,"Senate: Passed by indefinitley in Courts of Justice (8-Y 7-N)",8,7,0,0,15
1793789,1364154,2024-01-12,Senate,"Senate: Reported from Rehabilitation and Social Services (14-Y 0-N)",14,0,0,0,14
1793789,1371535,2024-01-30,Senate,"Senate: Reported from Finance and Appropriations with substitute (15-Y 0-N)",15,0,0,0,15
1793789,1372912,2024-01-31,Senate,"Senate: Constitutional reading dispensed (40-Y 0-N)",40,0,0,0,40
1793789,1432230,2024-02-15,House,"House: Subcommittee recommends reporting (7-Y 0-N)",7,0,0,1,8
1793789,1432231,2024-02-20,House,"House: Reported from Health and Human Services (22-Y 0-N)",22,0,0,0,22
1793789,1432232,2024-02-26,House,"House: Tabled in Appropriations (22-Y 0-N)",22,0,0,0,22
1793795,1373625,2024-01-31,Senate,"Senate: Reported from Courts of Justice with substitute (13-Y 0-N 2-A)",13,0,2,0,15
1793795,1379724,2024-02-08,Senate,"Senate: Reported from Finance and Appropriations with substitute (14-Y 1-N)",14,1,0,0,15
1793795,1380788,2024-02-09,Senate,"Senate: Constitutional reading dispensed (39-Y 0-N)",39,0,0,1,40
1793795,1383213,2024-02-13,Senate,"Senate: Read third time and passed Senate (27-Y 13-N)",27,13,0,0,40
1793795,1386741,2024-02-16,House,"House: Reported from Public Safety (13-Y 9-N)",13,9,0,0,22
1793795,1390680,2024-02-21,House,"House: VOTE: Passage (55-Y 43-N)",55,43,0,2,100
1793800,1364393,2024-01-16,Senate,"Senate: Passed by indefinitely in Privileges and Elections (8-Y 6-N)",8,6,0,0,14
1793806,1366932,2024-01-19,Senate,"Senate: Reported from Rehabilitation and Social Services with substitute (15-Y 0-N)",15,0,0,0,15
1793806,1379872,2024-02-08,Senate,"Senate: Reported from Finance and Appropriations (15-Y 0-N)",15,0,0,0,15
1793806,1380896,2024-02-09,Senate,"Senate: Constitutional reading dispensed (39-Y 0-N)",39,0,0,1,40
1793806,1381489,2024-02-12,Senate,"Senate: Constitutional reading dispensed (40-Y 0-N)",40,0,0,0,40
1793806,1381490,2024-02-12,Senate,"Senate: Passed Senate (40-Y 0-N)",40,0,0,0,40
1793806,1388316,2024-02-20,House,"House: Reported from Health and Human Services (22-Y 0-N)",22,0,0,0,22
1793806,1393726,2024-02-23,House,"House: VOTE: Block Vote Passage (98-Y 0-N)",98,0,0,2,100
1793813,1364159,2024-01-12,Senate,"Senate: Reported from Rehabilitation and Social Services with amendment (15-Y 0-N)",15,0,0,0,15
1793813,1379694,2024-02-08,Senate,"Senate: Reported from Finance and Appropriations with substitute (15-Y 0-N)",15,0,0,0,15
1793813,1380795,2024-02-09,Senate,"Senate: Constitutional reading dispensed (39-Y 0-N)",39,0,0,1,40
1793813,1381865,2024-02-12,Senate,"Senate: Constitutional reading dispensed (40-Y 0-N)",40,0,0,0,40
1793813,1381866,2024-02-12,Senate,"Senate: Passed Senate (40-Y 0-N)",40,0,0,0,40
1793813,1392386,2024-02-22,House,"House: Subcommittee recommends reporting (8-Y 0-N)",8,0,0,0,8
1793813,1395570,2024-02-27,House,"House: Reported from Health and Human Services (21-Y 0-N)",21,0,0,1,22
1793813,1397569,2024-02-28,House,"House: Tabled in Appropriations (21-Y 1-N)",21,1,0,0,22
1793819,1366567,2024-01-18,House,"House: Subcommittee recommends reporting with amendments (5-Y 3-N)",5,3,0,0,8
1793819,1367770,2024-01-23,House,"House: Reported from Health and Human Services with amendment(s) (18-Y 4-N)",18,4,0,0,22
1793819,1374765,2024-02-02,House,"House: Subcommittee recommends laying on the table (7-Y 1-N)",7,1,0,1,9
1794018,1387254,2024-02-18,Senate,"Senate: Reported from Finance and Appropriations with amendments (15-Y 0-N)",15,0,0,0,15
1794018,1390537,2024-02-21,Senate,"Senate: Motion for Special and Continuing Order (39-Y 0-N)",39,0,0,1,40
1794018,1391817,2024-02-22,Senate,"Senate: Constitutional reading dispensed (40-Y 0-N)",40,0,0,0,40
1794018,1391818,2024-02-22,Senate,"Senate: Passed Senate (38-Y 2-N)",38,2,0,0,40
1794021,1387252,2024-02-18,House,"House: Reported from Appropriations with amendment(s) (22-Y 0-N)",22,0,0,0,22
1794021,1389948,2024-02-21,House,"House: VOTE: Adoption (99-Y 0-N)",99,0,0,1,100
1794021,1391840,2024-02-22,House,"House: VOTE: Adoption (98-Y 0-N)",98,0,0,2,100
1794021,1391841,2024-02-22,House,"House: VOTE: Adoption (56-Y 43-N)",56,43,0,1,100
1794021,1391842,2024-02-22,House,"House: VOTE: Adoption (51-Y 48-N)",51,48,0,1,100
1794021,1391843,2024-02-22,House,"House: VOTE: Adoption (99-Y 0-N)",99,0,0,1,100
1794021,1391844,2024-02-22,House,"House: VOTE: Passage (81-Y 18-N)",81,18,0,1,100
1794021,1395870,2024-02-27,Senate,"Senate: Constitutional reading dispensed (39-Y 0-N)",39,0,0,1,40
1794021,1395871,2024-02-27,Senate,"Senate: Reported from Finance and Appropriations with amendments (15-Y 0-N)",15,0,0,0,15
1794021,1398167,2024-02-28,Senate,"Senate: Passed Senate with amendments (37-Y 2-N)",37,2,0,1,40
1794021,1398168,2024-02-28,House,"House: VOTE: REJECTED (0-Y 97-N)",0,97,0,3,100
1794021,1398169,2024-02-28,Senate,"Senate: Senate insisted on amendments (39-Y 0-N)",39,0,0,1,40
1794021,1406646,2024-03-09,House,"House: VOTE: Adoption (62-Y 37-N)",62,37,0,1,100
1794021,1406647,2024-03-09,Senate,"Senate: Conference report agreed to by Senate (36-Y 4-N)",36,4,0,0,40
1794021,1430124,2024-04-17,House,"House: VOTE: Block Vote Adoption (100-Y 0-N)",100,0,0,0,100
1794026,1387253,2024-02-18,Senate,"Senate: Reported from Finance and Appropriations with amendments (15-Y 0-N)",15,0,0,0,15
1794026,1390353,2024-02-21,Senate,"Senate: Motion for Special and Continuing Order (39-Y 0-N)",39,0,0,1,40
1794026,1392670,2024-02-22,Senate,"Senate: Contested committee amendment agreed to (P.066 Item 125#15s) (21-Y 19-N)",21,19,0,0,40
1794026,1392671,2024-02-22,Senate,"Senate: Contested committee amendment agreed to (P.270 Item 4-14#1s) (21-Y 19-N)",21,19,0,0,40
1794026,1392672,2024-02-22,Senate,"Senate: Constitutional reading dispensed (40-Y 0-N)",40,0,0,0,40
1794026,1392673,2024-02-22,Senate,"Senate: Passed Senate (38-Y 2-N)",38,2,0,0,40
1794034,1387251,2024-02-18,House,"House: Reported from Appropriations with amendment(s) (22-Y 0-N)",22,0,0,0,22
1794034,1390241,2024-02-21,House,"House: VOTE: Adoption (99-Y 0-N)",99,0,0,1,100
1794034,1392319,2024-02-22,House,"House: VOTE: Adoption (98-Y 0-N)",98,0,0,2,100
1794034,1392320,2024-02-22,House,"House: VOTE: Adoption (61-Y 37-N)",61,37,0,2,100
1794034,1392321,2024-02-22,House,"House: VOTE: Adoption (51-Y 48-N)",51,48,0,1,100
1794034,1392322,2024-02-22,House,"House: VOTE: Adoption (51-Y 48-N)",51,48,0,1,100
1794034,1392323,2024-02-22,House,"House: VOTE: Adoption (50-Y 48-N)",50,48,0,2,100
1794034,1392324,2024-02-22,House,"House: VOTE: Adoption (51-Y 46-N 2-A)",51,46,2,1,100
1794034,1392325,2024-02-22,House,"House: VOTE: Adoption (51-Y 47-N)",51,47,0,2,100
1794034,1392326,2024-02-22,House,"House: VOTE: Adoption (52-Y 47-N)",52,47,0,1,100
1794034,1392327,2024-02-22,House,"House: VOTE: Adoption (52-Y 47-N)",52,47,0,1,100
1794034,1392328,2024-02-22,House,"House: VOTE: Adoption (50-Y 48-N)",50,48,0,2,100
1794034,1392329,2024-02-22,House,"House: VOTE: Adoption (62-Y 35-N)",62,35,0,3,100
1794034,1392330,2024-02-22,House,"House: VOTE: Adoption (59-Y 38-N)",59,38,0,3,100
1794034,1392331,2024-02-22,House,"House: VOTE: Adoption (59-Y 38-N)",59,38,0,3,100
1794034,1392332,2024-02-22,House,"House: VOTE: Adoption (53-Y 45-N)",53,45,0,2,100
1794034,1392333,2024-02-22,House,"House: VOTE: Adoption (57-Y 42-N)",57,42,0,1,100
1794034,1392334,2024-02-22,House,"House: VOTE: Adoption (59-Y 39-N)",59,39,0,2,100
1794034,1392335,2024-02-22,House,"House: VOTE: Adoption (56-Y 43-N)",56,43,0,1,100
1794034,1392336,2024-02-22,House,"House: VOTE: Adoption (54-Y 42-N 1-A)",54,42,1,3,100
1794034,1392337,2024-02-22,House,"House: VOTE: (54-Y 45-N)",54,45,0,1,100
1794034,1392338,2024-02-22,House,"House: VOTE: (54-Y 45-N)",54,45,0,1,100
1794034,1392339,2024-02-22,House,"House: VOTE: (54-Y 45-N)",54,45,0,1,100
1794034,1392340,2024-02-22,House,"House: VOTE: (54-Y 45-N)",54,45,0,1,100
1794034,1392341,2024-02-22,House,"House: VOTE: (54-Y 45-N)",54,45,0,1,100
1794034,1392342,2024-02-22,House,"House: VOTE: (54-Y 45-N)",54,45,0,1,100
1794034,1392343,2024-02-22,House,"House: VOTE: (54-Y 45-N)",54,45,0,1,100
1794034,1392344,2024-02-22,House,"House: VOTE: (54-Y 45-N)",54,45,0,1,100
1794034,1392345,2024-02-22,House,"House: VOTE: (54-Y 45-N)",54,45,0,1,100
1794034,1392346,2024-02-22,House,"House: VOTE: (54-Y 45-N)",54,45,0,1,100
1794034,1392347,2024-02-22,House,"House: VOTE: (54-Y 45-N)",54,45,0,1,100
1794034,1392348,2024-02-22,House,"House: VOTE: (54-Y 45-N)",54,45,0,1,100
1794034,1392349,2024-02-22,House,"House: VOTE: (54-Y 45-N)",54,45,0,1,100
1794034,1392350,2024-02-22,House,"House: VOTE: (54-Y 45-N)",54,45,0,1,100
1794034,1392351,2024-02-22,House,"House: VOTE: (54-Y 45-N)",54,45,0,1,100
1794034,1392352,2024-02-22,House,"House: VOTE: (54-Y 45-N)",54,45,0,1,100
1794034,1392353,2024-02-22,House,"House: VOTE: (54-Y 45-N)",54,45,0,1,100
1794034,1392354,2024-02-22,House,"House: VOTE: Adoption (69-Y 28-N 1-A)",69,28,1,2,100
1794034,1392355,2024-02-22,House,"House: VOTE: Adoption (70-Y 29-N)",70,29,0,1,100
1794034,1392357,2024-02-22,House,"House: VOTE: Adoption (52-Y 47-N)",52,47,0,1,100
1794034,1392358,2024-02-22,House,"House: VOTE: Adoption (53-Y 45-N)",53,45,0,2,100
1794034,1392359,2024-02-22,House,"House: VOTE: Adoption (54-Y 45-N)",54,45,0,1,100
1794034,1392360,2024-02-22,House,"House: VOTE: Adoption (56-Y 42-N)",56,42,0,2,100
1794034,1392361,2024-02-22,House,"House: VOTE: Adoption (53-Y 46-N)",53,46,0,1,100
1794034,1392960,2024-02-22,House,"House: VOTE: Adoption (54-Y 44-N)",54,44,0,2,100
1794034,1392961,2024-02-22,House,"House: VOTE: Adoption (53-Y 44-N)",53,44,0,3,100
1794034,1392962,2024-02-22,House,"House: VOTE: Adoption (52-Y 47-N)",52,47,0,1,100
1794034,1392963,2024-02-22,House,"House: VOTE: Adoption (52-Y 47-N)",52,47,0,1,100
1794034,1392964,2024-02-22,House,"House: VOTE: Adoption (99-Y 0-N)",99,0,0,1,100
1794034,1392965,2024-02-22,House,"House: VOTE: Adoption (55-Y 43-N)",55,43,0,2,100
1794034,1392966,2024-02-22,House,"House: VOTE: Adoption (51-Y 48-N)",51,48,0,1,100
1794034,1392967,2024-02-22,House,"House: VOTE: Adoption (51-Y 48-N)",51,48,0,1,100
1794034,1392968,2024-02-22,House,"House: VOTE: Adoption (52-Y 47-N)",52,47,0,1,100
1794034,1392969,2024-02-22,House,"House: VOTE: Adoption (51-Y 47-N)",51,47,0,2,100
1794034,1392970,2024-02-22,House,"House: VOTE: Pass by (54-Y 45-N)",54,45,0,1,100
1794034,1392971,2024-02-22,House,"House: VOTE: Adoption (99-Y 0-N)",99,0,0,1,100
1794034,1392972,2024-02-22,House,"House: VOTE: Passage (75-Y 24-N)",75,24,0,1,100
1794034,1395820,2024-02-27,Senate,"Senate: Constitutional reading dispensed (39-Y 0-N)",39,0,0,1,40
1794034,1395821,2024-02-27,Senate,"Senate: Reported from Finance and Appropriations with amendments (15-Y 0-N)",15,0,0,0,15
1794034,1398257,2024-02-28,Senate,"Senate: Passed Senate with amendments (37-Y 2-N)",37,2,0,1,40
1794034,1398258,2024-02-28,House,"House: VOTE: REJECTED (0-Y 96-N)",0,96,0,4,100
1794034,1398259,2024-02-28,Senate,"Senate: Senate insisted on amendments (39-Y 0-N)",39,0,0,1,40
1794034,1406652,2024-03-09,Senate,"Senate: Conference report agreed to by Senate (24-Y 14-N)",24,14,0,2,40
1794034,1406653,2024-03-09,House,"House: VOTE: Adoption (62-Y 37-N)",62,37,0,1,100
1794034,1430129,2024-04-17,House,"House: VOTE: Block Vote Adoption (100-Y 0-N)",100,0,0,0,100
1794071,1366083,2024-01-17,House,"House: Subcommittee recommends reporting with amendments (8-Y 0-N)",8,0,0,0,8
1794071,1369744,2024-01-26,House,"House: Reported from Privileges and Elections with amendment(s) (21-Y 0-N)",21,0,0,1,22
1794146,1366653,2024-01-18,House,"House: Subcommittee recommends reporting (6-Y 4-N)",6,4,0,0,10
1794146,1366939,2024-01-19,House,"House: Reported from Public Safety (11-Y 9-N)",11,9,0,2,22
1794146,1369971,2024-01-26,House,"House: VOTE: Passage (51-Y 44-N)",51,44,0,5,100
1794146,1384970,2024-02-14,Senate,"Senate: Reported from Courts of Justice (6-Y 5-N)",6,5,0,0,11
1794146,1386569,2024-02-16,Senate,"Senate: Constitutional reading dispensed (38-Y 0-N)",38,0,0,2,40
1794146,1387781,2024-02-19,Senate,"Senate: Passed Senate (20_Y 18-N)",21,18,0,1,40
1794149,1369031,2024-01-25,House,"House: Subcommittee recommends reporting (8-Y 0-N)",8,0,0,0,8
1794149,1371500,2024-01-30,House,"House: Reported from Health and Human Services (22-Y 0-N)",22,0,0,0,22
1794149,1375043,2024-02-02,House,"House: Subcommittee recommends reporting (7-Y 0-N)",7,0,0,2,9
1794149,1378418,2024-02-07,House,"House: Reported from Courts of Justice (22-Y 0-N)",22,0,0,0,22
1794149,1383448,2024-02-13,House,"House: VOTE: Block Vote Passage (99-Y 0-N)",99,0,0,1,100
1794149,1391513,2024-02-22,Senate,"Senate: Reported from Education and Health (13-Y 0-N 1-A)",13,0,1,0,14
1794149,1393949,2024-02-23,Senate,"Senate: Constitutional reading dispensed (38-Y 0-N)",38,0,0,2,40
1794149,1394597,2024-02-26,Senate,"Senate: Passed Senate (40-Y 0-N)",40,0,0,0,40
1794155,1367536,2024-01-22,House,"House: Subcommittee recommends laying on the table (5-Y 3-N)",5,3,0,0,8
1794158,1373212,2024-01-31,House,"House: Subcommittee recommends reporting (7-Y 1-N)",7,1,0,1,9
1794158,1375624,2024-02-02,House,"House: Reported from Courts of Justice (15-Y 6-N)",15,6,0,1,22
1794158,1378107,2024-02-07,House,"House: Subcommittee recommends reporting (5-Y 3-N)",5,3,0,1,9
1794158,1378757,2024-02-07,House,"House: Reported from Appropriations (13-Y 9-N)",13,9,0,0,22
1794158,1383442,2024-02-13,House,"House: VOTE: Passage (59-Y 39-N)",59,39,0,2,100
1794158,1394448,2024-02-26,Senate,"Senate: Reported from Courts of Justice with substitute (10-Y 5-N)",10,5,0,0,15
1794158,1401401,2024-03-04,Senate,"Senate: Reported from Finance and Appropriations with amendments (10-Y 5-N)",10,5,0,0,15
1794158,1402914,2024-03-05,Senate,"Senate: Constitutional reading dispensed (39-Y 0-N)",39,0,0,1,40
1794158,1404119,2024-03-06,Senate,"Senate: Passed Senate with substitute with amendments (21-Y 18-N)",21,18,0,1,40
1794158,1405590,2024-03-07,House,"House: VOTE: Adoption (57-Y 42-N)",57,42,0,1,100
1794158,1405591,2024-03-07,House,"House: VOTE: REJECTED (0-Y 99-N)",0,99,0,1,100
1794158,1405592,2024-03-07,House,"House: VOTE: Adoption (61-Y 38-N)",61,38,0,1,100
1794158,1405593,2024-03-07,Senate,"Senate: Senate insisted on substitute with amendments (40-Y 0-N)",40,0,0,0,40
1794158,1406238,2024-03-08,Senate,"Senate: Conference report agreed to by Senate (21-Y 19-N)",21,19,0,0,40
1794158,1406239,2024-03-08,House,"House: VOTE: Adoption (55-Y 38-N)",55,38,0,7,100
1794191,1368620,2024-01-24,House,"House: Subcommittee recommends laying on the table (5-Y 3-N)",5,3,0,0,8
1794220,1366403,2024-01-17,House,"House: Subcommittee recommends reporting (6-Y 4-N)",6,4,0,0,10
1794220,1368242,2024-01-24,House,"House: Reported from Agriculture, Chesapeake and Natural Resources (14-Y 8-N)",14,8,0,0,22
1794220,1371760,2024-01-30,House,"House: VOTE: Passage (52-Y 47-N)",52,47,0,1,100
1794220,1386578,2024-02-16,Senate,"Senate: Reported from Agriculture, Conservation and Natural Resources with substitute (12-Y 2-N)",12,2,0,0,14
1794220,1387452,2024-02-19,Senate,"Senate: Constitutional reading dispensed (38-Y 0-N)",38,0,0,2,40
1794220,1392071,2024-02-22,Senate,"Senate: Committee substitute agreed to 24107836D-S1 (36-Y 4-N)",36,4,0,0,40
1794220,1392072,2024-02-22,Senate,"Senate: Passed Senate with substitute (31-Y 9-N)",31,9,0,0,40
1794220,1394423,2024-02-26,House,"House: VOTE: REJECTED (4-Y 91-N)",4,91,0,5,100
1794220,1398067,2024-02-28,Senate,"Senate: Senate insisted on substitute (39-Y 0-N)",39,0,0,1,40
1794220,1404537,2024-03-06,Senate,"Senate: Conference report agreed to by Senate (25-Y 14-N)",25,14,0,1,40
1794220,1404538,2024-03-06,House,"House: VOTE: Adoption (62-Y 37-N)",62,37,0,1,100
1794254,1367178,2024-01-22,House,"House: Subcommittee recommends reporting (10-Y 0-N)",10,0,0,0,10
1794254,1368264,2024-01-24,House,"House: Reported from Education (21-Y 0-N)",21,0,0,1,22
1794254,1371758,2024-01-30,House,"House: VOTE: Block Vote Passage (100-Y 0-N)",100,0,0,0,100
1794254,1385462,2024-02-15,Senate,"Senate: Reported from Education and Health (13-Y 0-N)",13,0,0,0,13
1794254,1386899,2024-02-16,Senate,"Senate: Constitutional reading dispensed (38-Y 0-N)",38,0,0,2,40
1794254,1387612,2024-02-19,Senate,"Senate: Passed Senate (39-Y 0-N)",39,0,0,1,40
1794344,1371489,2024-01-30,House,"House: Subcommittee recommends reporting with amendments (7-Y 1-N)",7,1,0,0,8
1794344,1374054,2024-02-01,House,"House: Reported from Health and Human Services with amendment(s) (19-Y 3-N)",19,3,0,0,22
1794344,1378264,2024-02-07,House,"House: VOTE: Passage (53-Y 47-N)",53,47,0,0,100
1794344,1384524,2024-02-14,Senate,"Senate: Reported from General Laws and Technology (8-Y 7-N)",8,7,0,0,15
1794344,1386759,2024-02-16,Senate,"Senate: Constitutional reading dispensed (38-Y 0-N)",38,0,0,2,40
1794344,1387899,2024-02-19,Senate,"Senate: Defeated by Senate (6-Y 32-N)",6,32,0,2,40
1794352,1373791,2024-02-01,House,"House: Subcommittee recommends reporting (5-Y 3-N)",5,3,0,0,8
1794352,1376820,2024-02-06,House,"House: Reported from Health and Human Services (15-Y 7-N)",15,7,0,0,22
1794352,1378817,2024-02-07,House,"House: Subcommittee recommends laying on the table (7-Y 0-N)",7,0,0,2,9
1794425,1369326,2024-01-25,House,"House: Subcommittee recommends reporting (7-Y 0-N)",7,0,0,1,8
1794425,1372218,2024-01-30,House,"House: Reported from General Laws (22-Y 0-N)",22,0,0,0,22
1794425,1376233,2024-02-05,House,"House: Subcommittee recommends laying on the table (5-Y 3-N)",5,3,0,1,9
1794430,1373599,2024-02-01,House,"House: Subcommittee recommends reporting (8-Y 0-N)",8,0,0,0,8
1794430,1374939,2024-02-02,House,"House: Reported from Counties, Cities and Towns (21-Y 0-N)",21,0,0,1,22
1794430,1380187,2024-02-08,House,"House: VOTE: Block Vote Passage (98-Y 0-N)",98,0,0,2,100
1794430,1387978,2024-02-19,Senate,"Senate: Rereferred from Commerce and Labor (13-Y 0-N)",13,0,0,0,13
1794430,1394273,2024-02-26,Senate,"Senate: Reported from Local Government (10-Y 0-N)",10,0,0,0,10
1794430,1396474,2024-02-27,Senate,"Senate: Constitutional reading dispensed (39-Y 0-N)",39,0,0,1,40
1794430,1398034,2024-02-28,Senate,"Senate: Passed Senate (39-Y 0-N)",39,0,0,1,40
1794435,1374915,2024-02-02,House,"House: Subcommittee recommends reporting (8-Y 0-N)",8,0,0,0,8
1794435,1374916,2024-02-02,House,"House: Reported from Counties, Cities and Towns (22-Y 0-N)",22,0,0,0,22
1794435,1380189,2024-02-08,House,"House: VOTE: Block Vote Passage (98-Y 0-N)",98,0,0,2,100
1794435,1394267,2024-02-26,Senate,"Senate: Reported from Local Government (15-Y 0-N)",15,0,0,0,15
1794435,1396481,2024-02-27,Senate,"Senate: Constitutional reading dispensed (39-Y 0-N)",39,0,0,1,40
1794435,1398058,2024-02-28,Senate,"Senate: Passed Senate (39-Y 0-N)",39,0,0,1,40
1794445,1366955,2024-01-19,House,"House: Subcommittee recommends reporting (5-Y 3-N)",5,3,0,0,8
1794445,1366956,2024-01-19,House,"House: Reported from Counties, Cities and Towns (12-Y 10-N)",12,10,0,0,22
1794445,1378304,2024-02-07,House,"House: VOTE: Defeated (51-Y 47-N)",51,47,0,2,100
1794445,1380811,2024-02-09,House,"House: VOTE: Passage (91-Y 2-N)",91,2,0,7,100
1794445,1388034,2024-02-19,Senate,"Senate: Reported from Local Government (15-Y 0-N)",15,0,0,0,15
1794445,1389383,2024-02-20,Senate,"Senate: Constitutional reading dispensed (39-Y 0-N)",39,0,0,1,40
1794445,1390959,2024-02-21,Senate,"Senate: Passed Senate (40-Y 0-N)",40,0,0,0,40
1794449,1366811,2024-01-18,House,"House: Subcommittee recommends reporting (8-Y 0-N)",8,0,0,0,8
1794449,1367959,2024-01-23,House,"House: Reported from General Laws (21-Y 0-N)",21,0,0,1,22
1794449,1371201,2024-01-29,House,"House: VOTE: Block Vote Passage (98-Y 0-N)",98,0,0,2,100
1794449,1384481,2024-02-14,Senate,"Senate: Reported from General Laws and Technology (15-Y 0-N)",15,0,0,0,15
1794449,1386898,2024-02-16,Senate,"Senate: Constitutional reading dispensed (38-Y 0-N)",38,0,0,2,40
1794449,1387924,2024-02-19,Senate,"Senate: Passed Senate (39-Y 0-N)",39,0,0,1,40
1794453,1376337,2024-02-05,House,"House: Subcommittee recommends reporting with amendments (8-Y 0-N)",8,0,0,1,9
1794453,1380941,2024-02-09,House,"House: Reported from Privileges and Elections with amendment(s) (22-Y 0-N)",22,0,0,0,22
1794453,1383145,2024-02-13,House,"House: VOTE: Block Vote Passage (99-Y 0-N)",99,0,0,1,100
1794453,1389578,2024-02-20,Senate,"Senate: Reported from Privileges and Elections (14-Y 1-N)",14,1,0,0,15
1794453,1392914,2024-02-22,Senate,"Senate: Constitutional reading dispensed (40-Y 0-N)",40,0,0,0,40
1794453,1394110,2024-02-23,Senate,"Senate: Passed Senate (35-Y 4-N)",35,4,0,1,40
1794509,1367175,2024-01-22,Senate,"Senate: Reported from Courts of Justice (9-Y 6-N)",9,6,0,0,15
1794509,1368725,2024-01-23,Senate,"Senate: Constitutional reading dispensed (39-Y 0-N)",39,0,0,1,40
1794509,1369166,2024-01-25,Senate,"Senate: Read third time and passed Senate (23-Y 17-N)",23,17,0,0,40
1794509,1369168,2024-01-25,Senate,"Senate: Reconsideration of passage agreed to by Senate (40-Y 0-N)",40,0,0,0,40
1794509,1369169,2024-01-25,Senate,"Senate: Passed Senate (21-Y 19-N)",21,19,0,0,40
1794509,1386796,2024-02-16,House,"House: Reported from Public Safety (12-Y 10-N)",12,10,0,0,22
1794509,1389960,2024-02-21,House,"House: VOTE: Passage (52-Y 47-N)",52,47,0,1,100
1794509,1430206,2024-04-17,Senate,"Senate: Passed in enrolled form rejected (21-Y 19-N)",21,19,0,0,40
1794510,1369009,2024-01-25,Senate,"Senate: Reported from Education and Health with substitute (15-Y 0-N)",15,0,0,0,15
1794510,1379779,2024-02-08,Senate,"Senate: Reported from Finance and Appropriations with substitute (15-Y 0-N)",15,0,0,0,15
1794510,1381077,2024-02-09,Senate,"Senate: Constitutional reading dispensed (39-Y 0-N)",39,0,0,1,40
1794510,1381529,2024-02-12,Senate,"Senate: Constitutional reading dispensed (40-Y 0-N)",40,0,0,0,40
1794510,1381530,2024-02-12,Senate,"Senate: Passed Senate (40-Y 0-N)",40,0,0,0,40
1794510,1389776,2024-02-21,House,"House: Subcommittee recommends reporting with substitute (7-Y 1-N)",7,1,0,0,8
1794510,1394251,2024-02-26,House,"House: Reported from Education with substitute (16-Y 5-N)",16,5,0,1,22
1794510,1399105,2024-02-29,House,"House: VOTE: Passage (90-Y 9-N)",90,9,0,1,100
1794510,1401711,2024-03-04,Senate,"Senate: House substitute rejected by Senate (0-Y 39-N)",0,39,0,1,40
1794510,1404134,2024-03-06,Senate,"Senate: Senate acceded to request (40-Y 0-N)",40,0,0,0,40
1794510,1406316,2024-03-08,Senate,"Senate: Conference report agreed to by Senate (40-Y 0-N)",40,0,0,0,40
1794510,1406317,2024-03-08,House,"House: VOTE: Adoption (93-Y 3-N)",93,3,0,4,100
1794511,1366159,2024-01-16,Senate,"Senate: Incorporated by Agriculture, Conservation and Natural Resources ",14,0,0,0,14
1794512,1368780,2024-01-24,Senate,"Senate: Reported from General Laws and Technology (15-Y 0-N)",15,0,0,0,15
1794512,1369937,2024-01-26,Senate,"Senate: Constitutional reading dispensed (37-Y 0-N)",37,0,0,3,40
1794512,1371528,2024-01-30,Senate,"Senate: Read third time and passed Senate (40-Y 0-N)",40,0,0,0,40
1794512,1385508,2024-02-15,House,"House: Reported from General Laws (22-Y 0-N)",22,0,0,0,22
1794512,1388877,2024-02-20,House,"House: VOTE: Block Vote Passage (98-Y 0-N)",98,0,0,2,100
1794513,1366296,2024-01-17,Senate,"Senate: Passed by indefinitely in Courts of Justice (8-Y 7-N)",8,7,0,0,15
1794514,1364202,2024-01-12,Senate,"Senate: Reported from Rehabilitation and Social Services with amendment (15-Y 0-N)",15,0,0,0,15
1794514,1368751,2024-01-15,Senate,"Senate: Constitutional reading dispensed (39-Y 0-N)",39,0,0,0,39
1794514,1368752,2024-01-18,Senate,"Senate: Read third time and passed Senate (40-Y 0-N)",40,0,0,0,40
1794514,1386268,2024-02-15,House,"House: Subcommittee recommends reporting (7-Y 0-N)",7,0,0,1,8
1794514,1388313,2024-02-20,House,"House: Reported from Health and Human Services (22-Y 0-N)",22,0,0,0,22
1794514,1393796,2024-02-23,House,"House: VOTE: Block Vote Passage (98-Y 0-N)",98,0,0,2,100
1794515,1364278,2024-01-15,Senate,"Senate: Reported from Local Government (12-Y 0-N)",12,0,0,0,12
1794515,1368395,2024-01-16,Senate,"Senate: Constitutional reading dispensed (38-Y 0-N)",38,0,0,1,39
1794515,1368396,2024-01-18,Senate,"Senate: Read third time and passed Senate (40-Y 0-N)",40,0,0,0,40
1794515,1386577,2024-02-16,House,"House: Reported from Counties, Cities and Towns (21-Y 1-N)",21,1,0,0,22
1794515,1389936,2024-02-21,House,"House: VOTE: Passage (88-Y 12-N)",88,12,0,0,100
1794516,1364410,2024-01-16,Senate,"Senate: Incorporated by Privileges and Elections ",14,0,0,0,14
1794517,1366607,2024-01-18,Senate,"Senate: Reported from Education and Health with substitute (15-Y 0-N)",15,0,0,0,15
1794517,1368683,2024-01-19,Senate,"Senate: Constitutional reading dispensed (37-Y 0-N)",37,0,0,3,40
1794517,1368684,2024-01-23,Senate,"Senate: Read third time and passed Senate (39-Y 0-N)",39,0,0,1,40
1794517,1384137,2024-02-14,House,"House: Reported from Education (21-Y 0-N)",21,0,0,1,22
1794517,1387472,2024-02-19,House,"House: VOTE: Block Vote Passage (99-Y 0-N)",99,0,0,1,100
1794518,1364308,2024-01-15,Senate,"Senate: Reported from Local Government with substitute (11-Y 0-N)",11,0,0,0,11
1794518,1368767,2024-01-16,Senate,"Senate: Constitutional reading dispensed (38-Y 0-N)",38,0,0,1,39
1794518,1368768,2024-01-18,Senate,"Senate: Read third time and passed Senate (40-Y 0-N)",40,0,0,0,40
1794518,1386576,2024-02-16,House,"House: Reported from Counties, Cities and Towns (13-Y 9-N)",13,9,0,0,22
1794518,1390367,2024-02-21,House,"House: VOTE: Passage (65-Y 35-N)",65,35,0,0,100
1794645,1366343,2024-01-17,House,"House: Subcommittee recommends reporting with substitute (6-Y 2-N)",6,2,0,1,9
1794645,1366954,2024-01-19,House,"House: Reported from Courts of Justice with substitute (15-Y 7-N)",15,7,0,0,22
1794645,1369788,2024-01-26,House,"House: VOTE: Passage (53-Y 42-N)",53,42,0,5,100
1794645,1387347,2024-02-19,Senate,"Senate: Reported from Courts of Justice (8-Y 5-N)",8,5,0,0,13
1794645,1388594,2024-02-20,Senate,"Senate: Constitutional reading dispensed (39-Y 0-N)",39,0,0,1,40
1794645,1390569,2024-02-21,Senate,"Senate: Passed Senate (21-Y 19-N)",21,19,0,0,40
1794648,1368193,2024-01-24,House,"House: Subcommittee recommends laying on the table (6-Y 4-N)",6,4,0,0,10
1794651,1367817,2024-01-23,House,"House: Subcommittee recommends laying on the table (6-Y 2-N)",6,2,0,1,9
1794653,1371265,2024-01-29,House,"House: Subcommittee recommends reporting (6-Y 1-N)",6,1,0,1,8
1794653,1374950,2024-02-02,House,"House: Reported from Privileges and Elections (21-Y 1-N)",21,1,0,0,22
1794653,1379612,2024-02-08,House,"House: VOTE: Passage (98-Y 0-N)",98,0,0,2,100
1794653,1388844,2024-02-20,Senate,"Senate: Reported from Privileges and Elections (15-Y 0-N)",15,0,0,0,15
1794653,1392193,2024-02-22,Senate,"Senate: Constitutional reading dispensed (40-Y 0-N)",40,0,0,0,40
1794653,1393717,2024-02-23,Senate,"Senate: Passed Senate (39-Y 0-N)",39,0,0,1,40
1794656,1366363,2024-01-17,House,"House: Subcommittee recommends reporting with substitute (8-Y 0-N)",8,0,0,1,9
1794656,1367038,2024-01-19,House,"House: Reported from Courts of Justice with substitute (22-Y 0-N)",22,0,0,0,22
1794656,1369384,2024-01-25,House,"House: VOTE: Block Vote Passage (98-Y 0-N)",98,0,0,2,100
1794656,1387376,2024-02-19,Senate,"Senate: Reported from Courts of Justice with amendments (12-Y 1-N)",12,1,0,0,13
1794656,1398157,2024-02-28,Senate,"Senate: Reported from Finance and Appropriations (15-Y 0-N)",15,0,0,0,15
1794656,1399610,2024-02-29,Senate,"Senate: Constitutional reading dispensed (39-Y 0-N)",39,0,0,1,40
1794656,1401827,2024-03-04,Senate,"Senate: Passed Senate with amendments (39-Y 0-N)",39,0,0,1,40
1794656,1402764,2024-03-05,House,"House: VOTE: Adoption (99-Y 0-N)",99,0,0,1,100
1794658,1367598,2024-01-22,House,"House: Subcommittee recommends reporting (9-Y 0-N)",9,0,0,1,10
1794658,1368230,2024-01-24,House,"House: Reported from Agriculture, Chesapeake and Natural Resources (22-Y 0-N)",22,0,0,0,22
1794658,1371538,2024-01-30,House,"House: VOTE: Block Vote Passage (100-Y 0-N)",100,0,0,0,100
1794658,1386878,2024-02-16,Senate,"Senate: Reported from Agriculture, Conservation and Natural Resources (11-Y 0-N)",11,0,0,0,11
1794658,1398240,2024-02-28,Senate,"Senate: Reported from Finance and Appropriations (12-Y 0-N 1-A)",12,0,1,0,13
1794658,1399880,2024-02-29,Senate,"Senate: Constitutional reading dispensed (39-Y 0-N)",39,0,0,1,40
1794658,1401078,2024-03-01,Senate,"Senate: Passed Senate (39-Y 0-N 1-A)",39,0,1,0,40
1794661,1368816,2024-01-24,House,"House: Subcommittee recommends reporting (6-Y 4-N)",6,4,0,1,11
1794661,1372430,2024-01-31,House,"House: Reported from Agriculture, Chesapeake and Natural Resources (15-Y 7-N)",15,7,0,0,22
1794661,1374579,2024-02-02,House,"House: Subcommittee recommends reporting (6-Y 2-N)",6,2,0,1,9
1794661,1374580,2024-02-02,House,"House: Reported from Appropriations (16-Y 6-N)",16,6,0,0,22
1794661,1382112,2024-02-12,House,"House: VOTE: Passage (74-Y 26-N)",74,26,0,0,100
1794661,1388995,2024-02-20,Senate,"Senate: Reported from Agriculture, Conservation and Natural Resources with substitute (15-Y 0-N)",15,0,0,0,15
1794661,1397394,2024-02-28,Senate,"Senate: Reported from Finance and Appropriations (15-Y 0-N)",15,0,0,0,15
1794661,1399667,2024-02-29,Senate,"Senate: Constitutional reading dispensed (39-Y 0-N)",39,0,0,1,40
1794661,1400875,2024-03-01,Senate,"Senate: Passed Senate with substitute (40-Y 0-N)",40,0,0,0,40
1794661,1401537,2024-03-04,House,"House: VOTE: REJECTED (2-Y 96-N)",2,96,0,2,100
1794661,1403331,2024-03-05,Senate,"Senate: Senate insisted on substitute (40-Y 0-N)",40,0,0,0,40
1794661,1406148,2024-03-08,Senate,"Senate: Conference report agreed to by Senate (38-Y 1-N)",38,1,0,1,40
1794661,1406509,2024-03-08,House,"House: VOTE: Adoption (81-Y 15-N)",81,15,0,4,100
1794663,1371555,2024-01-30,House,"House: Subcommittee recommends laying on the table (6-Y 3-N)",6,3,0,0,9
1794666,1371599,2024-01-30,House,"House: Subcommittee recommends reporting with amendments (8-Y 0-N)",8,0,0,0,8
1794666,1373567,2024-02-01,House,"House: Reported from Transportation with amendment(s) (21-Y 0-N)",21,0,0,1,22
1794666,1378619,2024-02-07,House,"House: VOTE: Block Vote Passage (100-Y 0-N)",100,0,0,0,100
1794666,1386416,2024-02-15,Senate,"Senate: Reported from Transportation with amendment (14-Y 0-N)",14,0,0,0,14
1794666,1387601,2024-02-19,Senate,"Senate: Constitutional reading dispensed (38-Y 0-N)",38,0,0,2,40
1794666,1388794,2024-02-20,Senate,"Senate: Passed Senate with amendment (40-Y 0-N)",40,0,0,0,40
1794666,1392466,2024-02-22,House,"House: VOTE: Adoption (98-Y 0-N)",98,0,0,2,100
1794668,1366727,2024-01-18,House,"House: Subcommittee recommends reporting with amendments (8-Y 0-N)",8,0,0,0,8
1794668,1367815,2024-01-23,House,"House: Reported from Health and Human Services with amendment(s) (21-Y 1-N)",21,1,0,0,22
1794668,1375179,2024-02-02,House,"House: Subcommittee recommends laying on the table (8-Y 0-N)",8,0,0,1,9
1794671,1366393,2024-01-17,House,"House: Subcommittee recommends reporting (8-Y 0-N)",8,0,0,1,9
1794671,1366885,2024-01-19,House,"House: Reported from Courts of Justice with substitute (22-Y 0-N)",22,0,0,0,22
1794671,1367244,2024-01-19,House,"House: Reported from Courts of Justice (22-Y 0-N)",22,0,0,0,22
1794671,1369664,2024-01-25,House,"House: VOTE: Block Vote Passage (98-Y 0-N)",98,0,0,2,100
1794671,1387378,2024-02-19,Senate,"Senate: Reported from Courts of Justice (14-Y 0-N)",14,0,0,0,14
1794671,1388462,2024-02-20,Senate,"Senate: Constitutional reading dispensed (39-Y 0-N)",39,0,0,1,40
1794671,1390016,2024-02-21,Senate,"Senate: Passed Senate (40-Y 0-N)",40,0,0,0,40
1794673,1364330,2024-01-16,House,"House: Subcommittee recommends reporting with substitute (8-Y 0-N)",8,0,0,0,8
1794673,1366093,2024-01-17,House,"House: Reported from Education with substitute (21-Y 0-N)",21,0,0,1,22
1794673,1368088,2024-01-23,House,"House: VOTE: Block Vote Passage (98-Y 0-N)",98,0,0,2,100
1794673,1368818,2024-01-23,House,"House: VOTE: Block Vote Passage (98-Y 0-N)",98,0,0,2,100
1794673,1399907,2024-02-29,Senate,"Senate: Reported from Education and Health with substitute (15-Y 0-N)",15,0,0,0,15
1794673,1401015,2024-03-01,Senate,"Senate: Constitutional reading dispensed (40-Y 0-N)",40,0,0,0,40
1794673,1401714,2024-03-04,Senate,"Senate: Passed Senate with substitute (39-Y 0-N)",39,0,0,1,40
1794673,1402787,2024-03-05,House,"House: VOTE: REJECTED (1-Y 99-N)",1,99,0,0,100
1794673,1404140,2024-03-06,Senate,"Senate: Senate insisted on substitute (40-Y 0-N)",40,0,0,0,40
1794673,1406275,2024-03-08,Senate,"Senate: Conference report agreed to by Senate (40-Y 0-N)",40,0,0,0,40
1794673,1406276,2024-03-08,House,"House: VOTE: Adoption (95-Y 0-N)",95,0,0,5,100
1794675,1378770,2024-02-07,House,"House: Subcommittee recommends reporting (5-Y 3-N)",5,3,0,0,8
1794675,1380852,2024-02-09,House,"House: Reported from Courts of Justice with substitute (12-Y 10-N)",12,10,0,0,22
1794675,1383207,2024-02-13,House,"House: VOTE: Passage (51-Y 48-N)",51,48,0,1,100
1794675,1390833,2024-02-21,Senate,"Senate: Reported from Courts of Justice with substitute (9-Y 6-N)",9,6,0,0,15
1794675,1393828,2024-02-23,Senate,"Senate: Constitutional reading dispensed (38-Y 0-N)",38,0,0,2,40
1794675,1394573,2024-02-26,Senate,"Senate: Passed Senate with substitute (22-Y 18-N)",22,18,0,0,40
1794675,1398281,2024-02-28,House,"House: VOTE: Adoption (51-Y 49-N)",51,49,0,0,100
1794677,1367314,2024-01-22,House,"House: Subcommittee recommends reporting (8-Y 0-N)",8,0,0,1,9
1794677,1368373,2024-01-24,House,"House: Reported from Appropriations (22-Y 0-N)",22,0,0,0,22
1794677,1372196,2024-01-30,House,"House: VOTE: Block Vote Passage (100-Y 0-N)",100,0,0,0,100
1794677,1386244,2024-02-15,Senate,"Senate: Reported from Finance and Appropriations (15-Y 0-N)",15,0,0,0,15
1794677,1388188,2024-02-19,Senate,"Senate: Constitutional reading dispensed (38-Y 0-N)",38,0,0,2,40
1794677,1389306,2024-02-20,Senate,"Senate: Passed Senate (40-Y 0-N)",40,0,0,0,40
1794679,1373392,2024-01-31,House,"House: Subcommittee recommends reporting with amendments (5-Y 3-N)",5,3,0,1,9
1794679,1375896,2024-02-02,House,"House: Reported from Courts of Justice with amendment(s) (12-Y 9-N)",12,9,0,1,22
1794679,1379618,2024-02-08,House,"House: VOTE: Passage (50-Y 47-N)",50,47,0,3,100
1794679,1394250,2024-02-26,Senate,"Senate: Reported from Courts of Justice with substitute (9-Y 5-N)",9,5,0,0,14
1794679,1395957,2024-02-27,Senate,"Senate: Constitutional reading dispensed (39-Y 0-N)",39,0,0,1,40
1794679,1398396,2024-02-28,Senate,"Senate: Passed Senate with substitute (20-Y 19-N)",20,19,0,1,40
1794679,1400510,2024-03-01,House,"House: VOTE: REJECTED (47-Y 50-N)",47,50,0,3,100
1794679,1400511,2024-03-01,House,"House: VOTE: Adoption #2 (49-Y 46-N)",49,46,0,5,100
1794683,1372131,2024-01-30,House,"House: Subcommittee recommends laying on the table (4-Y 3-N)",4,3,0,1,8
1794734,1379450,2024-02-08,House,"House: Subcommittee recommends laying on the table (3-Y 1-N)",3,1,0,1,5
1794736,1367341,2024-01-22,House,"House: Subcommittee recommends laying on the table (8-Y 0-N)",8,0,0,0,8
1794738,1367307,2024-01-22,House,"House: Subcommittee recommends reporting (7-Y 1-N)",7,1,0,1,9
1794738,1369883,2024-01-26,House,"House: Reported from Courts of Justice (13-Y 8-N)",13,8,0,1,22
1794738,1373996,2024-02-01,House,"House: VOTE: Passage (62-Y 37-N)",62,37,0,1,100
1794738,1398856,2024-02-28,Senate,"Senate: Reported from Courts of Justice with amendment (10-Y 5-N)",10,5,0,0,15
1794738,1401054,2024-03-01,Senate,"Senate: Constitutional reading dispensed (40-Y 0-N)",40,0,0,0,40
1794738,1401812,2024-03-04,Senate,"Senate: Passed Senate with amendment (20-Y 19-N)",20,19,0,1,40
1794738,1402864,2024-03-05,House,"House: VOTE: Adoption (61-Y 39-N)",61,39,0,0,100
1794740,1368655,2024-01-24,House,"House: Subcommittee recommends reporting with substitute (7-Y 0-N)",7,0,0,2,9
1794740,1369851,2024-01-26,House,"House: Reported from Courts of Justice with substitute (21-Y 0-N)",21,0,0,1,22
1794740,1374220,2024-02-01,House,"House: VOTE: Block Vote Passage (99-Y 0-N)",99,0,0,1,100
1794740,1387359,2024-02-19,Senate,"Senate: Reported from Courts of Justice (13-Y 0-N)",13,0,0,0,13
1794740,1388590,2024-02-20,Senate,"Senate: Constitutional reading dispensed (39-Y 0-N)",39,0,0,1,40
1794740,1390549,2024-02-21,Senate,"Senate: Passed Senate (40-Y 0-N)",40,0,0,0,40
1794748,1366227,2024-01-17,House,"House: Subcommittee recommends reporting with amendments (6-Y 4-N)",6,4,0,0,10
1794748,1368265,2024-01-24,House,"House: Reported from Agriculture, Chesapeake and Natural Resources with amendment(s) (13-Y 9-N)",13,9,0,0,22
1794748,1371928,2024-01-30,House,"House: VOTE: Passage (53-Y 47-N)",53,47,0,0,100
1794748,1389357,2024-02-20,Senate,"Senate: Passed by indefinitely in Agriculture, Conservation and Natural Resources (10-Y 5-N)",10,5,0,0,15
1794752,1364292,2024-01-15,Senate,"Senate: Passed by indefinitley in Courts of Justice (11-Y 4-N)",11,4,0,0,15
1794754,1366832,2024-01-18,Senate,"Senate: Rereferred from Transportation (11-Y 0-N)",11,0,0,0,11
1794754,1382704,2024-02-12,Senate,"Senate: Passed by indefinitely in Courts of Justice (9-Y 6-N)",9,6,0,0,15
1794755,1366301,2024-01-17,House,"House: Subcommittee recommends reporting (10-Y 0-N)",10,0,0,0,10
1794755,1368240,2024-01-24,House,"House: Reported from Agriculture, Chesapeake and Natural Resources (22-Y 0-N)",22,0,0,0,22
1794755,1371902,2024-01-30,House,"House: VOTE: Block Vote Passage (100-Y 0-N)",100,0,0,0,100
1794755,1389353,2024-02-20,Senate,"Senate: Reported from Agriculture, Conservation and Natural Resources (15-Y 0-N)",15,0,0,0,15
1794755,1392689,2024-02-22,Senate,"Senate: Constitutional reading dispensed (40-Y 0-N)",40,0,0,0,40
1794755,1393848,2024-02-23,Senate,"Senate: Passed Senate (39-Y 0-N)",39,0,0,1,40
1794757,1364158,2024-01-12,Senate,"Senate: Reported from Rehabilitation and Social Services with amendment (15-Y 0-N)",15,0,0,0,15
1794757,1376957,2024-02-06,Senate,"Senate: Reported from Finance and Appropriations with amendment (15-Y 0-N)",15,0,0,0,15
1794757,1378012,2024-02-07,Senate,"Senate: Constitutional reading dispensed (40-Y 0-N)",40,0,0,0,40
1794757,1379701,2024-02-08,Senate,"Senate: Constitutional reading dispensed (40-Y 0-N)",40,0,0,0,40
1794757,1379702,2024-02-08,Senate,"Senate: Read third time and passed Senate (40-Y 0-N)",40,0,0,0,40
1794757,1392461,2024-02-22,House,"House: Subcommittee recommends reporting (8-Y 0-N)",8,0,0,0,8
1794757,1395574,2024-02-27,House,"House: Reported from Health and Human Services (21-Y 0-N)",21,0,0,1,22
1794757,1397599,2024-02-28,House,"House: Tabled in Appropriations (22-Y 0-N)",22,0,0,0,22
1794759,1380264,2024-02-08,Senate,"Senate: Passed by indefinitely in Education and Health (9-Y 6-N)",9,6,0,0,15
1794761,1367173,2024-01-22,Senate,"Senate: Incorporated by Courts of Justice ",15,0,0,0,15
1794763,1364380,2024-01-16,Senate,"Senate: Rereferred from Finance and Appropriations (15-Y 0-N)",15,0,0,0,15
1794763,1379049,2024-02-08,Senate,"Senate: Passed by indefinitely in Education and Health (9-Y 5-N 1-A)",9,5,1,0,15
1794764,1366571,2024-01-18,Senate,"Senate: Reported from Education and Health with amendment (14-Y 1-N)",14,1,0,0,15
1794764,1377135,2024-02-06,Senate,"Senate: Continued to 2025 in Finance and Appropriations (14-Y 1-N)",14,1,0,0,15
1794766,1369719,2024-01-25,Senate,"Senate: Reported from Transportation (14-Y 1-N)",14,1,0,0,15
1794766,1370391,2024-01-29,Senate,"Senate: Constitutional reading dispensed (39-Y 0-N)",39,0,0,1,40
1794766,1373306,2024-01-31,Senate,"Senate: Read third time and passed Senate (31-Y 9-N)",31,9,0,0,40
1794766,1388447,2024-02-20,House,"House: Subcommittee failed to recommend reporting (3-Y 3-N)",3,3,2,0,8
1794767,1364412,2024-01-16,Senate,"Senate: Incorporated by Finance and Appropriations ",15,0,0,0,15
1794769,1366492,2024-01-18,Senate,"Senate: Reported from Education and Health (15-Y 0-N)",15,0,0,0,15
1794769,1368545,2024-01-19,Senate,"Senate: Constitutional reading dispensed (37-Y 0-N)",37,0,0,3,40
1794769,1368546,2024-01-23,Senate,"Senate: Read third time and passed Senate (39-Y 0-N)",39,0,0,1,40
1794769,1395598,2024-02-27,House,"House: Subcommittee recommends reporting (8-Y 0-N)",8,0,0,0,8
1794769,1397349,2024-02-28,House,"House: Reported from Education (22-Y 0-N)",22,0,0,0,22
1794769,1401506,2024-03-04,House,"House: VOTE: Block Vote Passage (97-Y 0-N)",97,0,0,3,100
1794771,1364408,2024-01-16,Senate,"Senate: Incorporated by Finance and Appropriations ",15,0,0,0,15
1794773,1366476,2024-01-18,Senate,"Senate: Incorporated by Education and Health ",15,0,0,0,15
1794775,1382492,2024-02-12,Senate,"Senate: Reported from Courts of Justice with substitute (14-Y 0-N)",14,0,0,0,14
1794775,1383679,2024-02-13,Senate,"Senate: Constitutional reading dispensed (40-Y 0-N)",40,0,0,0,40
1794775,1383680,2024-02-13,Senate,"Senate: Passed Senate (40-Y 0-N)",40,0,0,0,40
1794775,1383681,2024-02-13,Senate,"Senate: Constitutional reading dispensed (40-Y 0-N)",40,0,0,0,40
1794775,1386964,2024-02-16,House,"House: Reported from Courts of Justice (22-Y 0-N)",22,0,0,0,22
1794775,1390221,2024-02-21,House,"House: VOTE: Block Vote Passage (100-Y 0-N)",100,0,0,0,100
1794777,1373626,2024-01-31,Senate,"Senate: Passed by indefinitely in Courts of Justice (9-Y 6-N)",9,6,0,0,15
1794780,1376947,2024-02-06,Senate,"Senate: Continued to 2025 in Finance and Appropriations (14-Y 0-N)",14,0,0,0,14
1794782,1373590,2024-01-31,Senate,"Senate: Reported from Courts of Justice (9-Y 6-N)",9,6,0,0,15
1794782,1377266,2024-02-06,Senate,"Senate: Read third time and passed Senate (20-Y 18-N)",20,18,0,2,40
1794782,1432154,2024-02-22,House,"House: Subcommittee recommends reporting (6-Y 3-N)",6,3,0,1,10
1794785,1366228,2024-01-17,Senate,"Senate: Reported from General Laws and Technology (9-Y 0-N 6-A)",9,0,6,0,15
1794785,1382462,2024-02-12,Senate,"Senate: Reported from Courts of Justice (8-Y 6-N)",8,6,0,0,14
1794785,1383424,2024-02-13,Senate,"Senate: Constitutional reading dispensed (40-Y 0-N)",40,0,0,0,40
1794785,1383425,2024-02-13,Senate,"Senate: Passed Senate (21-Y 18-N)",21,18,0,1,40
1794785,1383426,2024-02-13,Senate,"Senate: Constitutional reading dispensed (40-Y 0-N)",40,0,0,0,40
1794785,1391325,2024-02-22,House,"House: Subcommittee recommends reporting (4-Y 2-N)",4,2,0,0,6
1794785,1393742,2024-02-23,House,"House: Reported from Public Safety (13-Y 8-N)",13,8,0,1,22
1794785,1398199,2024-02-28,House,"House: VOTE: Passage (53-Y 47-N)",53,47,0,0,100
1794786,1366605,2024-01-18,Senate,"Senate: Reported from Education and Health (15-Y 0-N)",15,0,0,0,15
1794786,1368387,2024-01-19,Senate,"Senate: Constitutional reading dispensed (37-Y 0-N)",37,0,0,3,40
1794786,1368388,2024-01-23,Senate,"Senate: Read third time and passed Senate (39-Y 0-N)",39,0,0,1,40
1794786,1385719,2024-02-15,House,"House: Reported from Health and Human Services (22-Y 0-N)",22,0,0,0,22
1794786,1388544,2024-02-20,House,"House: VOTE: Block Vote Passage (98-Y 0-N)",98,0,0,2,100
1794788,1379833,2024-02-08,Senate,"Senate: Incorporated by Education and Health ",15,0,0,0,15
1794791,1374491,2024-02-01,Senate,"Senate: Reported from Transportation with substitute (14-Y 0-N 1-A)",14,0,1,0,15
1794791,1376261,2024-02-05,Senate,"Senate: Constitutional reading dispensed (39-Y 0-N)",39,0,0,1,40
1794791,1378301,2024-02-07,Senate,"Senate: Read third time and passed Senate (40-Y 0-N)",40,0,0,0,40
1794791,1388358,2024-02-20,House,"House: Subcommittee recommends reporting (8-Y 0-N)",8,0,0,0,8
1794791,1391350,2024-02-22,House,"House: Reported from Transportation (22-Y 0-N)",22,0,0,0,22
1794791,1395858,2024-02-27,House,"House: VOTE: Block Vote Passage (97-Y 0-N)",97,0,0,3,100
1794792,1373717,2024-02-01,Senate,"Senate: Reported from Education and Health with substitute (15-Y 0-N)",15,0,0,0,15
1794792,1379733,2024-02-08,Senate,"Senate: Continued to 2025 in Finance and Appropriations (15-Y 0-N)",15,0,0,0,15
1794793,1364020,2024-01-11,Senate,"Senate: Rereferred from Education and Health (15-Y 0-N)",15,0,0,0,15
1794793,1374593,2024-02-02,Senate,"Senate: Reported from Rules (14-Y 0-N)",14,0,0,0,14
1794793,1375976,2024-02-05,Senate,"Senate: Constitutional reading dispensed (39-Y 0-N)",39,0,0,1,40
1794793,1377174,2024-02-06,Senate,"Senate: Constitutional reading dispensed (39-Y 0-N)",39,0,0,1,40
1794793,1377175,2024-02-06,Senate,"Senate: Passed Senate (39-Y 0-N)",39,0,0,1,40
1794793,1393186,2024-02-23,House,"House: Subcommittee recommends reporting (6-Y 0-N)",6,0,0,0,6
1794793,1393187,2024-02-23,House,"House: Reported from Rules (16-Y 0-N)",16,0,0,2,18
1794793,1398387,2024-02-28,House,"House: Reported from Appropriations with amendment(s) (22-Y 0-N)",22,0,0,0,22
1794793,1401732,2024-03-04,House,"House: VOTE: Block Vote Passage (97-Y 0-N)",97,0,0,3,100
1794793,1402815,2024-03-05,Senate,"Senate: House amendments agreed to by Senate (40-Y 0-N)",40,0,0,0,40
1794975,1376422,2024-02-05,House,"House: Subcommittee recommends continuing to 2025 (7-Y 0-N)",7,0,0,1,8
1794976,1366701,2024-01-18,House,"House: Stricken from docket by Transportation (22-Y 0-N)",22,0,0,0,22
1794977,1370424,2024-01-29,House,"House: Subcommittee recommends laying on the table (5-Y 3-N)",5,3,0,1,9
1794979,1374894,2024-02-02,House,"House: Subcommittee recommends reporting (8-Y 0-N)",8,0,0,0,8
1794979,1374895,2024-02-02,House,"House: Reported from Counties, Cities and Towns (22-Y 0-N)",22,0,0,0,22
1794979,1379801,2024-02-08,House,"House: VOTE: Block Vote Passage (98-Y 0-N)",98,0,0,2,100
1794979,1394628,2024-02-26,Senate,"Senate: Reported from Local Government (11-Y 0-N)",11,0,0,0,11
1794979,1396320,2024-02-27,Senate,"Senate: Constitutional reading dispensed (39-Y 0-N)",39,0,0,1,40
1794979,1397850,2024-02-28,Senate,"Senate: Passed Senate (39-Y 0-N)",39,0,0,1,40
1794980,1371509,2024-01-30,House,"House: Subcommittee recommends laying on the table (5-Y 3-N)",5,3,0,0,8
1794981,1366833,2024-01-18,House,"House: Subcommittee recommends reporting with substitute (8-Y 0-N)",8,0,0,0,8
1794981,1367902,2024-01-23,House,"House: Reported from Labor and Commerce with substitute (22-Y 0-N)",22,0,0,0,22
1794981,1370678,2024-01-29,House,"House: VOTE: Block Vote Passage (98-Y 0-N)",98,0,0,2,100
1794981,1387567,2024-02-19,Senate,"Senate: Reported from Commerce and Labor with amendment (15-Y 0-N)",15,0,0,0,15
1794981,1395795,2024-02-27,Senate,"Senate: Constitutional reading dispensed (39-Y 0-N)",39,0,0,1,40
1794981,1395796,2024-02-27,Senate,"Senate: Reported from Finance and Appropriations (15-Y 0-N)",15,0,0,0,15
1794981,1398201,2024-02-28,Senate,"Senate: Passed Senate with amendment (39-Y 0-N)",39,0,0,1,40
1794981,1400484,2024-03-01,House,"House: VOTE: Adoption (93-Y 0-N 1-A)",93,0,1,6,100
1794982,1376518,2024-02-05,House,"House: Subcommittee recommends reporting (7-Y 1-N)",7,1,0,1,9
1794982,1380956,2024-02-09,House,"House: Reported from Privileges and Elections (18-Y 3-N)",18,3,0,1,22
1794982,1382895,2024-02-13,House,"House: VOTE: Passage (83-Y 16-N)",83,16,0,1,100
1794982,1389590,2024-02-20,Senate,"Senate: Reported from Privileges and Elections with substitute (12-Y 3-N)",12,3,0,0,15
1794982,1392934,2024-02-22,Senate,"Senate: Constitutional reading dispensed (40-Y 0-N)",40,0,0,0,40
1794982,1393394,2024-02-23,Senate,"Senate: Defeated by Senate (18-Y 21-N)",18,21,0,1,40
1794982,1393395,2024-02-23,Senate,"Senate: Reconsideration of defeated action agreed to by Senate (38-Y 0-N)",38,0,0,2,40
1794982,1394430,2024-02-26,Senate,"Senate: Passed Senate with substitute (35-Y 5-N)",35,5,0,0,40
1794982,1397869,2024-02-28,House,"House: VOTE: Adoption (90-Y 8-N)",90,8,0,2,100
1794983,1372126,2024-01-30,House,"House: Tabled in General Laws (21-Y 0-N)",21,0,0,1,22
1794984,1367645,2024-01-23,House,"House: Reported from Transportation (21-Y 0-N)",21,0,0,1,22
1794984,1371284,2024-01-29,House,"House: VOTE: Block Vote Passage (98-Y 0-N)",98,0,0,2,100
1794984,1386429,2024-02-15,Senate,"Senate: Reported from Transportation (12-Y 0-N)",12,0,0,0,12
1794984,1387945,2024-02-19,Senate,"Senate: Constitutional reading dispensed (38-Y 0-N)",38,0,0,2,40
1794984,1389286,2024-02-20,Senate,"Senate: Passed Senate (40-Y 0-N)",40,0,0,0,40
1794985,1366473,2024-01-18,House,"House: Subcommittee recommends reporting with substitute (6-Y 0-N)",6,0,0,0,6
1794985,1366890,2024-01-19,House,"House: Reported from Public Safety with substitute (21-Y 0-N)",21,0,0,1,22
1794985,1369582,2024-01-25,House,"House: VOTE: Block Vote Passage (98-Y 0-N)",98,0,0,2,100
1794985,1386766,2024-02-16,Senate,"Senate: Reported from Rehabilitation and Social Services with amendment (14-Y 0-N)",14,0,0,0,14
1794985,1387597,2024-02-19,Senate,"Senate: Constitutional reading dispensed (38-Y 0-N)",38,0,0,2,40
1794985,1388439,2024-02-20,Senate,"Senate: Passed Senate with amendment (40-Y 0-N)",40,0,0,0,40
1794985,1392402,2024-02-22,House,"House: VOTE: Adoption (99-Y 0-N)",99,0,0,1,100
1794986,1373458,2024-01-31,House,"House: Subcommittee recommends reporting with substitute (8-Y 0-N)",8,0,0,1,9
1794986,1375676,2024-02-02,House,"House: Reported from Courts of Justice with substitute (21-Y 0-N)",21,0,0,1,22
1794986,1380672,2024-02-09,House,"House: Subcommittee recommends reporting with substitute (7-Y 0-N)",7,0,0,2,9
1794986,1380673,2024-02-09,House,"House: Reported from Appropriations with substitute (20-Y 0-N)",20,0,0,2,22
1794986,1383517,2024-02-13,House,"House: VOTE: Block Vote Passage (99-Y 0-N)",99,0,0,1,100
1794986,1391205,2024-02-21,Senate,"Senate: Reported from Courts of Justice with substitute (10-Y 0-N)",10,0,0,0,10
1794986,1397847,2024-02-28,Senate,"Senate: Reported from Finance and Appropriations with substitute (15-Y 0-N)",15,0,0,0,15
1794986,1399618,2024-02-29,Senate,"Senate: Constitutional reading dispensed (39-Y 0-N)",39,0,0,1,40
1794986,1400899,2024-03-01,Senate,"Senate: Passed Senate with substitute (40-Y 0-N)",40,0,0,0,40
1794986,1401808,2024-03-04,House,"House: VOTE: REJECTED (4-Y 94-N)",4,94,0,2,100
1794986,1403695,2024-03-05,Senate,"Senate: Senate insisted on substitute (40-Y 0-N)",40,0,0,0,40
1794986,1406308,2024-03-08,Senate,"Senate: Conference report agreed to by Senate (40-Y 0-N)",40,0,0,0,40
1794986,1406309,2024-03-08,House,"House: VOTE: Adoption (97-Y 0-N 2-A)",97,0,2,1,100
1794988,1367726,2024-01-23,House,"House: Subcommittee recommends striking from docket (8-Y 0-N)",8,0,0,0,8
1794988,1369485,2024-01-25,House,"House: Stricken from docket by Transportation (21-Y 0-N)",21,0,0,1,22
1794989,1366708,2024-01-18,House,"House: Subcommittee recommends striking from docket (8-Y 0-N)",8,0,0,0,8
1794990,1367747,2024-01-23,House,"House: Subcommittee recommends reporting with substitute (8-Y 0-N)",8,0,0,0,8
1794990,1369195,2024-01-25,House,"House: Reported from Health and Human Services with substitute (22-Y 0-N)",22,0,0,0,22
1794990,1374730,2024-02-02,House,"House: Subcommittee recommends reporting (8-Y 0-N)",8,0,0,1,9
1794990,1375808,2024-02-05,House,"House: Reported from Appropriations (21-Y 0-N)",21,0,0,1,22
1794990,1380592,2024-02-09,House,"House: VOTE: Block Vote Passage (96-Y 0-N)",96,0,0,4,100
1794990,1391577,2024-02-22,Senate,"Senate: Reported from Education and Health (15-Y 0-N)",15,0,0,0,15
1794990,1399967,2024-02-29,Senate,"Senate: Reported from Finance and Appropriations (14-Y 0-N)",14,0,0,0,14
1794990,1401825,2024-03-04,Senate,"Senate: Constitutional reading dispensed (40-Y 0-N)",40,0,0,0,40
1794990,1402905,2024-03-05,Senate,"Senate: Passed Senate (40-Y 0-N)",40,0,0,0,40
1794991,1364339,2024-01-16,House,"House: Subcommittee recommends reporting (8-Y 0-N)",8,0,0,0,8
1794991,1366088,2024-01-17,House,"House: Reported from Education (21-Y 0-N)",21,0,0,1,22
1794991,1367711,2024-01-23,House,"House: VOTE: Block Vote Passage (98-Y 0-N)",98,0,0,2,100
1794991,1368815,2024-01-23,House,"House: VOTE: Block Vote Passage (98-Y 0-N)",98,0,0,2,100
1794991,1391429,2024-02-22,Senate,"Senate: Reported from Education and Health with amendment (13-Y 2-N)",13,2,0,0,15
1794991,1393851,2024-02-23,Senate,"Senate: Constitutional reading dispensed (38-Y 0-N)",38,0,0,2,40
1794991,1394585,2024-02-26,Senate,"Senate: Passed Senate with amendment (37-Y 3-N)",37,3,0,0,40
1794991,1399215,2024-02-29,House,"House: VOTE:REJECTED (1-Y 99-N)",1,99,0,0,100
1794991,1401660,2024-03-04,Senate,"Senate: Senate insisted on amendment (39-Y 0-N)",39,0,0,1,40
1794991,1405556,2024-03-07,House,"House: VOTE: Adoption (94-Y 0-N)",94,0,0,6,100
1794991,1406251,2024-03-08,Senate,"Senate: Conference report agreed to by Senate (35-Y 5-N)",35,5,0,0,40
1795055,1367635,2024-01-23,House,"House: Subcommittee recommends laying on the table (7-Y 0-N)",7,0,0,1,8
1795056,1377734,2024-02-06,House,"House: Subcommittee failed to recommend reporting (4-Y 6-N)",4,6,0,0,10
1795057,1374362,2024-02-01,House,"House: Subcommittee recommends reporting with amendments (8-Y 0-N)",8,0,0,0,8
1795057,1377523,2024-02-06,House,"House: Reported from General Laws with amendment(s) (20-Y 0-N)",20,0,0,2,22
1795057,1382432,2024-02-12,House,"House: VOTE: Block Vote Passage (100-Y 0-N)",100,0,0,0,100
1795057,1390495,2024-02-21,Senate,"Senate: Reported from General Laws and Technology (15-Y 0-N)",15,0,0,0,15
1795057,1393713,2024-02-23,Senate,"Senate: Constitutional reading dispensed (38-Y 0-N)",38,0,0,2,40
1795057,1394913,2024-02-26,Senate,"Senate: Passed Senate (40-Y 0-N)",40,0,0,0,40
1795059,1366514,2024-01-18,House,"House: Subcommittee recommends reporting (8-Y 0-N)",8,0,0,0,8
1795059,1366981,2024-01-19,House,"House: Reported from Counties, Cities and Towns (22-Y 0-N)",22,0,0,0,22
1795059,1369642,2024-01-25,House,"House: VOTE: Block Vote Passage (98-Y 0-N)",98,0,0,2,100
1795059,1387267,2024-02-19,Senate,"Senate: Reported from Local Government (15-Y 0-N)",15,0,0,0,15
1795059,1389048,2024-02-20,Senate,"Senate: Constitutional reading dispensed (39-Y 0-N)",39,0,0,1,40
1795059,1390603,2024-02-21,Senate,"Senate: Passed Senate (40-Y 0-N)",40,0,0,0,40
1795060,1377743,2024-02-06,House,"House: Subcommittee failed to recommend reporting (5-Y 5-N)",5,5,0,0,10
1795061,1366649,2024-01-18,House,"House: Subcommittee recommends reporting with substitute (6-Y 4-N)",6,4,0,0,10
1795061,1366936,2024-01-19,House,"House: Reported from Public Safety with substitute (12-Y 9-N)",12,9,0,1,22
1795061,1368667,2024-01-24,House,"House: Subcommittee recommends reporting (5-Y 3-N)",5,3,0,1,9
1795061,1370876,2024-01-29,House,"House: Reported from Appropriations (11-Y 10-N)",11,10,0,1,22
1795062,1374337,2024-02-01,House,"House: Tabled in Rules (17-Y 0-N)",17,0,0,1,18
1795065,1366100,2024-01-17,House,"House: Subcommittee recommends reporting with amendments (8-Y 0-N)",8,0,0,0,8
1795065,1369725,2024-01-26,House,"House: Reported from Privileges and Elections with substitute (22-Y 0-N)",22,0,0,0,22
1795065,1376264,2024-02-05,House,"House: Subcommittee recommends reporting (8-Y 0-N)",8,0,0,1,9
1795065,1378750,2024-02-07,House,"House: Reported from Appropriations (22-Y 0-N)",22,0,0,0,22
1795065,1383567,2024-02-13,House,"House: VOTE: Block Vote Passage (99-Y 0-N)",99,0,0,1,100
1795065,1388535,2024-02-20,Senate,"Senate: Reported from Privileges and Elections (8-Y 7-N)",8,7,0,0,15
1795065,1392716,2024-02-22,Senate,"Senate: Constitutional reading dispensed (40-Y 0-N)",40,0,0,0,40
1795066,1373720,2024-02-01,House,"House: Reported from Rules (15-Y 0-N)",15,0,0,3,18
1795066,1379397,2024-02-08,House,"House: VOTE: Adoption (83-Y 7-N)",83,7,0,10,100
1795066,1394959,2024-02-26,Senate,"Senate: Reading waived (40-Y 0-N)",40,0,0,0,40
1795069,1367448,2024-01-22,House,"House: Subcommittee recommends reporting (4-Y 2-N)",4,2,0,3,9
1795069,1369799,2024-01-26,House,"House: Reported from Courts of Justice (11-Y 10-N)",11,10,0,1,22
1795069,1372887,2024-01-31,House,"House: VOTE: Engrossment (51-Y 49-N)",51,49,0,0,100
1795069,1373789,2024-02-01,House,"House: VOTE: Passage (50-Y 48-N)",50,48,0,2,100
1795069,1384456,2024-02-14,Senate,"Senate: Reported from Courts of Justice (10-Y 5-N)",10,5,0,0,15
1795069,1386592,2024-02-16,Senate,"Senate: Constitutional reading dispensed (38-Y 0-N)",38,0,0,2,40
1795069,1387911,2024-02-19,Senate,"Senate: Passed Senate (20-Y 18-N)",20,18,0,2,40
1795071,1377722,2024-02-06,House,"House: Subcommittee recommends reporting with substitute (10-Y 0-N)",10,0,0,0,10
1795071,1380275,2024-02-08,House,"House: Reported from Labor and Commerce with substitute (18-Y 4-N)",18,4,0,0,22
1795071,1383852,2024-02-13,House,"House: VOTE: Passage (74-Y 24-N)",74,24,0,2,100
1795071,1396658,2024-02-27,Senate,"Senate: Rereferred from Agriculture, Conservation and Natural Resources (13-Y 0-N)",13,0,0,0,13
1795071,1399243,2024-02-28,Senate,"Senate: Reported from Courts of Justice with amendment (7-Y 4-N)",7,4,0,0,11
1795071,1400619,2024-03-01,Senate,"Senate: Constitutional reading dispensed (40-Y 0-N)",40,0,0,0,40
1795071,1401637,2024-03-04,Senate,"Senate: Passed Senate with amendment (22-Y 16-N)",22,16,0,2,40
1795071,1403034,2024-03-05,House,"House: VOTE: Adoption (75-Y 25-N)",75,25,0,0,100
1795072,1366090,2024-01-17,House,"House: Subcommittee recommends reporting with substitute (7-Y 0-N)",7,0,0,1,8
1795072,1367190,2024-01-22,House,"House: Reported from Education with substitute (21-Y 0-N)",21,0,0,1,22
1795072,1369965,2024-01-26,House,"House: VOTE: Block Vote Passage (95-Y 0-N)",95,0,0,5,100
1795072,1391547,2024-02-22,Senate,"Senate: Reported from Education and Health (14-Y 1-N)",14,1,0,0,15
1795072,1394008,2024-02-23,Senate,"Senate: Constitutional reading dispensed (38-Y 0-N)",38,0,0,2,40
1795072,1394780,2024-02-26,Senate,"Senate: Passed Senate (40-Y 0-N)",40,0,0,0,40
1795075,1372380,2024-01-31,House,"House: Subcommittee recommends reporting (8-Y 0-N)",8,0,0,0,8
1795075,1374667,2024-02-02,House,"House: Reported from Privileges and Elections (22-Y 0-N)",22,0,0,0,22
1795075,1379680,2024-02-08,House,"House: VOTE: Block Vote Passage (98-Y 0-N)",98,0,0,2,100
1795075,1388780,2024-02-20,Senate,"Senate: Reported from Privileges and Elections (14-Y 0-N 1-A)",14,0,1,0,15
1795075,1392069,2024-02-22,Senate,"Senate: Constitutional reading dispensed (40-Y 0-N)",40,0,0,0,40
1795075,1393611,2024-02-23,Senate,"Senate: Passed Senate (32-Y 6-N)",32,6,0,2,40
1795075,1430263,2024-04-17,House,"House: VOTE: (100-Y 0-N)",100,0,0,0,100
1795075,1430264,2024-04-17,Senate,"Senate: Senate concurred in Governor's recommendation (40-Y 0-N)",40,0,0,0,40
1795076,1372113,2024-01-30,House,"House: Subcommittee recommends reporting (5-Y 4-N)",5,4,0,1,10
1795076,1377324,2024-02-06,House,"House: Reported from Labor and Commerce (12-Y 10-N)",12,10,0,0,22
1795076,1382188,2024-02-12,House,"House: VOTE: Passage (51-Y 49-N)",51,49,0,0,100
1795076,1401803,2024-03-04,Senate,"Senate: Continued to 2025 in Commerce and Labor (14-Y 0-N)",14,0,0,0,14
1795077,1364458,2024-01-16,House,"House: Subcommittee recommends reporting with substitute (7-Y 0-N)",7,0,0,0,7
1795077,1366665,2024-01-18,House,"House: Reported from Labor and Commerce with substitute (22-Y 0-N)",22,0,0,0,22
1795077,1369056,2024-01-24,House,"House: VOTE: Block Vote Passage (99-Y 0-N)",99,0,0,1,100
1795077,1387596,2024-02-19,Senate,"Senate: Reported from Commerce and Labor (14-Y 0-N)",14,0,0,0,14
1795077,1389867,2024-02-21,Senate,"Senate: Constitutional reading dispensed (40-Y 0-N)",40,0,0,0,40
1795077,1392132,2024-02-22,Senate,"Senate: Passed Senate (40-Y 0-N)",40,0,0,0,40
1795078,1364346,2024-01-16,House,"House: Reported from Labor and Commerce (22-Y 0-N)",22,0,0,0,22
1795078,1367219,2024-01-22,House,"House: VOTE: Passage (98-Y 0-N)",98,0,0,2,100
1795078,1367583,2024-01-22,House,"House: VOTE: Passage (98-Y 0-N)",98,0,0,2,100
1795078,1388049,2024-02-19,Senate,"Senate: Reported from Commerce and Labor (15-Y 0-N)",15,0,0,0,15
1795078,1390957,2024-02-21,Senate,"Senate: Constitutional reading dispensed (40-Y 0-N)",40,0,0,0,40
1795078,1392732,2024-02-22,Senate,"Senate: Passed Senate (40-Y 0-N)",40,0,0,0,40
1795080,1366838,2024-01-18,House,"House: Subcommittee recommends reporting (8-Y 0-N)",8,0,0,0,8
1795080,1367983,2024-01-23,House,"House: Reported from General Laws (21-Y 0-N)",21,0,0,1,22
1795080,1371456,2024-01-30,House,"House: Reported from Health and Human Services (22-Y 0-N)",22,0,0,0,22
1795080,1376639,2024-02-05,House,"House: VOTE: Block Vote Passage (98-Y 0-N)",98,0,0,2,100
1795080,1385059,2024-02-14,Senate,"Senate: Reported from General Laws and Technology (15-Y 0-N)",15,0,0,0,15
1795080,1386662,2024-02-16,Senate,"Senate: Constitutional reading dispensed (38-Y 0-N)",38,0,0,2,40
1795080,1388164,2024-02-19,Senate,"Senate: Passed Senate (39-Y 0-N)",39,0,0,1,40
1795081,1373908,2024-02-01,House,"House: Subcommittee recommends striking from docket (8-Y 0-N)",8,0,0,1,9
1795082,1366898,2024-01-19,House,"House: Subcommittee recommends reporting with substitute (8-Y 0-N)",8,0,0,1,9
1795082,1369842,2024-01-26,House,"House: Reported from Courts of Justice with substitute (21-Y 0-N)",21,0,0,1,22
1795082,1373635,2024-02-01,House,"House: VOTE: Block Vote Passage (99-Y 0-N)",99,0,0,1,100
1795082,1384921,2024-02-14,Senate,"Senate: Reported from Courts of Justice (9-Y 0-N)",9,0,0,0,9
1795082,1386559,2024-02-16,Senate,"Senate: Constitutional reading dispensed (38-Y 0-N)",38,0,0,2,40
1795082,1388146,2024-02-19,Senate,"Senate: Passed Senate (39-Y 0-N)",39,0,0,1,40
1795083,1368231,2024-01-24,House,"House: Subcommittee recommends reporting (8-Y 2-N)",8,2,0,0,10
1795083,1372419,2024-01-31,House,"House: Reported from Agriculture, Chesapeake and Natural Resources with amendment(s) (16-Y 6-N)",16,6,0,0,22
1795083,1374582,2024-02-02,House,"House: Subcommittee recommends reporting with amendments (8-Y 0-N)",8,0,0,1,9
1795083,1374583,2024-02-02,House,"House: Reported from Appropriations with amendment(s) (22-Y 0-N)",22,0,0,0,22
1795083,1379948,2024-02-08,House,"House: VOTE: Passage (71-Y 27-N)",71,27,0,2,100
1795083,1387585,2024-02-19,Senate,"Senate: Rereferred from Commerce and Labor (14-Y 0-N)",14,0,0,0,14
1795083,1396728,2024-02-27,Senate,"Senate: Reported from Agriculture, Conservation and Natural Resources with amendment (14-Y 0-N)",14,0,0,0,14
1795083,1399975,2024-02-29,Senate,"Senate: Reported from Finance and Appropriations with amendment (10-Y 4-N)",10,4,0,0,14
1795083,1400595,2024-02-29,Senate,"Senate: Reported from Finance and Appropriations with amendments (10-Y 4-N)",10,4,0,0,14
1795083,1401918,2024-03-04,Senate,"Senate: Constitutional reading dispensed (40-Y 0-N)",40,0,0,0,40
1795083,1403033,2024-03-05,Senate,"Senate: Passed Senate with amendments (28-Y 12-N)",28,12,0,0,40
1795083,1404282,2024-03-06,House,"House: VOTE: Adoption (74-Y 22-N)",74,22,0,4,100
1795083,1404283,2024-03-06,House,"House: VOTE: REJECTED (0-Y 97-N)",0,97,0,3,100
1795083,1405172,2024-03-07,Senate,"Senate: Senate insisted on amendment (40-Y 0-N)",40,0,0,0,40
1795085,1367114,2024-01-19,House,"House: Subcommittee recommends reporting (7-Y 1-N)",7,1,0,1,9
1795085,1369826,2024-01-26,House,"House: Reported from Courts of Justice (21-Y 0-N)",21,0,0,1,22
1795085,1371200,2024-01-29,House,"House: Subcommittee recommends reporting (7-Y 0-N)",7,0,0,2,9
1795085,1372773,2024-01-31,House,"House: Reported from Appropriations (22-Y 0-N)",22,0,0,0,22
1795085,1376953,2024-02-06,House,"House: VOTE: Block Vote Passage (99-Y 0-N)",99,0,0,1,100
1795085,1387338,2024-02-19,Senate,"Senate: Reported from Courts of Justice with amendments (14-Y 0-N)",14,0,0,0,14
1795085,1395760,2024-02-27,Senate,"Senate: Constitutional reading dispensed (39-Y 0-N)",39,0,0,1,40
1795085,1395761,2024-02-27,Senate,"Senate: Reported from Finance and Appropriations with amendments (15-Y 0-N)",15,0,0,0,15
1795085,1398695,2024-02-28,Senate,"Senate: Passed Senate with amendments (39-Y 0-N)",39,0,0,1,40
1795085,1400573,2024-03-01,House,"House: VOTE: REJECTED (1-Y 94-N)",1,94,0,5,100
1795085,1403027,2024-03-05,Senate,"Senate: Senate insisted on amendments",40,0,0,0,40
1795085,1406655,2024-03-09,Senate,"Senate: Conference report agreed to by Senate (40-Y 0-N)",40,0,0,0,40
1795085,1406656,2024-03-09,House,"House: VOTE: Adoption (96-Y 1-N)",96,1,0,3,100
1795085,1429514,2024-04-17,Senate,"Senate: Senate concurred in Governor's recommendation (40-Y 0-N)",40,0,0,0,40
1795085,1430301,2024-04-17,House,"House: VOTE: (100-Y 0-N)",100,0,0,0,100
1795086,1367942,2024-01-23,House,"House: Stricken from docket by General Laws (21-Y 0-N)",21,0,0,1,22
1795087,1377724,2024-02-06,House,"House: Subcommittee recommends reporting with substitute (6-Y 4-N)",6,4,0,0,10
1795087,1379926,2024-02-08,House,"House: Reported from Labor and Commerce with substitute (13-Y 9-N)",13,9,0,0,22
1795087,1383279,2024-02-13,House,"House: VOTE: Passage (55-Y 44-N)",55,44,0,1,100
1795087,1395205,2024-02-26,Senate,"Senate: Reported from Commerce and Labor with amendment (10-Y 5-N)",10,5,0,0,15
1795087,1398310,2024-02-28,Senate,"Senate: Constitutional reading dispensed (39-Y 0-N)",39,0,0,1,40
1795087,1399134,2024-02-29,Senate,"Senate: Passed Senate with amendment (22-Y 17-N)",22,17,0,1,40
1795087,1401599,2024-03-04,House,"House: VOTE: Adoption (52-Y 46-N)",52,46,0,2,100
1795088,1368047,2024-01-23,House,"House: Stricken from docket by Labor and Commerce (22-Y 0-N)",22,0,0,0,22
1795090,1366648,2024-01-18,House,"House: Reported from Labor and Commerce (15-Y 7-N)",15,7,0,0,22
1795090,1369024,2024-01-24,House,"House: VOTE: Passage (88-Y 11-N)",88,11,0,1,100
1795090,1393545,2024-02-23,Senate,"Senate: Reported from Rules (15-Y 0-N)",15,0,0,0,15
1795090,1394978,2024-02-26,Senate,"Senate: Constitutional reading dispensed (40-Y 0-N)",40,0,0,0,40
1795090,1396516,2024-02-27,Senate,"Senate: Passed Senate (39-Y 0-N)",39,0,0,1,40
1795091,1377760,2024-02-06,House,"House: Subcommittee recommends reporting with substitute (6-Y 4-N)",6,4,0,0,10
1795091,1380073,2024-02-08,House,"House: Reported from Labor and Commerce with substitute (12-Y 10-N)",12,10,0,0,22
1795091,1383527,2024-02-13,House,"House: VOTE: Passage (54-Y 44-N)",54,44,0,2,100
1795091,1395212,2024-02-26,Senate,"Senate: Reported from Commerce and Labor (10-Y 4-N)",10,4,0,0,14
1795091,1398292,2024-02-28,Senate,"Senate: Constitutional reading dispensed (39-Y 0-N)",39,0,0,1,40
1795091,1399122,2024-02-29,Senate,"Senate: Passed Senate (22-Y 17-N)",22,17,0,1,40
1795092,1371495,2024-01-30,House,"House: Subcommittee recommends reporting with substitute (7-Y 1-N)",7,1,0,0,8
1795092,1375769,2024-02-05,House,"House: Reported from Education with substitute (22-Y 0-N)",22,0,0,0,22
1795092,1380921,2024-02-09,House,"House: VOTE: Block Vote Passage (96-Y 0-N)",96,0,0,4,100
1795092,1391520,2024-02-22,Senate,"Senate: Reported from Education and Health with substitute (13-Y 2-N)",13,2,0,0,15
1795092,1393965,2024-02-23,Senate,"Senate: Constitutional reading dispensed (38-Y 0-N)",38,0,0,2,40
1795092,1394790,2024-02-26,Senate,"Senate: Passed Senate with substitute (40-Y 0-N)",40,0,0,0,40
1795092,1398504,2024-02-28,House,"House: VOTE: Adoption (97-Y 2-N)",97,2,0,1,100
1795093,1366564,2024-01-18,House,"House: Subcommittee recommends reporting with amendments (8-Y 0-N)",8,0,0,0,8
1795093,1367775,2024-01-23,House,"House: Reported from General Laws with amendment(s) (21-Y 0-N)",21,0,0,1,22
1795093,1372844,2024-01-31,House,"House: Subcommittee recommends reporting with substitute (7-Y 0-N)",7,0,0,2,9
1795093,1374584,2024-02-02,House,"House: Reported from Appropriations with substitute (22-Y 0-N)",22,0,0,0,22
1795093,1380107,2024-02-08,House,"House: VOTE: Block Vote Passage (98-Y 0-N)",98,0,0,2,100
1795093,1398591,2024-02-28,Senate,"Senate: Reported from General Laws and Technology with substitute (11-Y 0-N)",11,0,0,0,11
1795093,1401409,2024-03-04,Senate,"Senate: Reported from Finance and Appropriations with substitute (15-Y 0-N)",15,0,0,0,15
1795093,1402964,2024-03-05,Senate,"Senate: Constitutional reading dispensed (39-Y 0-N)",39,0,0,1,40
1795093,1404207,2024-03-06,Senate,"Senate: Passed Senate with substitute (40-Y 0-N)",40,0,0,0,40
1795093,1405732,2024-03-07,House,"House: VOTE: Adoption (99-Y 0-N)",99,0,0,1,100
1795096,1375838,2024-02-05,House,"House: Subcommittee recommends incorporating (HB310-Hope) (0-Y 0-N)",0,0,0,9,9
1795098,1364444,2024-01-16,House,"House: Stricken from docket by Health and Human Services (22-Y 0-N)",22,0,0,0,22
1795101,1373899,2024-02-01,House,"House: Subcommittee recommends reporting with substitute (5-Y 2-N)",5,2,0,1,8
1795101,1377676,2024-02-06,House,"House: Reported from Labor and Commerce with substitute (12-Y 10-N)",12,10,0,0,22
1795101,1381831,2024-02-12,House,"House: VOTE: Passage (51-Y 49-N)",51,49,0,0,100
1795101,1395227,2024-02-26,Senate,"Senate: Reported from Commerce and Labor (8-Y 7-N)",8,7,0,0,15
1795101,1399370,2024-02-29,Senate,"Senate: Reported from Finance and Appropriations with amendments (10-Y 4-N)",10,4,0,0,14
1795101,1401932,2024-03-04,Senate,"Senate: Constitutional reading dispensed (40-Y 0-N)",40,0,0,0,40
1795101,1403021,2024-03-05,Senate,"Senate: Passed Senate with amendments (21-Y 19-N)",21,19,0,0,40
1795101,1404312,2024-03-06,House,"House: VOTE: REJECTED (0-Y 97-N)",0,97,0,3,100
1795101,1405174,2024-03-07,Senate,"Senate: Senate insisted on amendments (40-Y 0-N)",40,0,0,0,40
1795101,1406427,2024-03-08,Senate,"Senate: Conference report rejected by Senate (20-Y 20-N)",20,20,0,0,40
1795101,1406428,2024-03-08,Senate,"Senate: Reconsideration of conference report agreed to by Senate (40-Y 0-N)",40,0,0,0,40
1795101,1406429,2024-03-08,Senate,"Senate: Conference report agreed to by Senate (21-Y 19-N)",21,19,0,0,40
1795101,1406430,2024-03-08,House,"House: VOTE: Adoption (49-Y 47-N 1-A)",49,47,1,3,100
1795101,1406696,2024-03-09,Senate,"Senate: Reconsideration of conference report agreed to by Senate (40-Y 0-N)",40,0,0,0,40
1795105,1369427,2024-01-25,House,"House: Subcommittee recommends reporting with substitute (6-Y 4-N)",6,4,0,0,10
1795105,1369756,2024-01-26,House,"House: Reported from Public Safety with substitute (12-Y 10-N)",12,10,0,0,22
1795105,1374020,2024-02-01,House,"House: VOTE: Passage (51-Y 49-N)",51,49,0,0,100
1795105,1398763,2024-02-28,Senate,"Senate: Continued to 2025 in Courts of Justice (15-Y 0-N)",15,0,0,0,15
1795113,1364340,2024-01-16,House,"House: Subcommittee recommends reporting with amendments (8-Y 0-N)",8,0,0,0,8
1795113,1366080,2024-01-17,House,"House: Reported from Education with amendment(s) (19-Y 2-N)",19,2,0,1,22
1795113,1371011,2024-01-29,House,"House: Subcommittee recommends laying on the table (7-Y 0-N)",7,0,0,2,9
1795116,1373881,2024-02-01,House,"House: Subcommittee recommends reporting (5-Y 0-N)",5,0,0,3,8
1795116,1377293,2024-02-06,House,"House: Reported from General Laws (20-Y 0-N)",20,0,0,2,22
1795116,1382197,2024-02-12,House,"House: VOTE: Block Vote Passage (100-Y 0-N)",100,0,0,0,100
1795116,1390808,2024-02-21,Senate,"Senate: Reported from General Laws and Technology (8-Y 0-N)",8,0,0,0,8
1795116,1399428,2024-02-29,Senate,"Senate: Continued to 2025 in Finance and Appropriations (13-Y 1-N)",13,1,0,0,14
1795121,1367625,2024-01-23,House,"House: Subcommittee recommends reporting (8-Y 0-N)",8,0,0,1,9
1795121,1370733,2024-01-29,House,"House: Reported from Education with substitute (22-Y 0-N)",22,0,0,0,22
1795121,1376329,2024-02-05,House,"House: Subcommittee recommends reporting with amendments (8-Y 0-N)",8,0,0,1,9
1795121,1378732,2024-02-07,House,"House: Reported from Appropriations with amendment(s) (22-Y 0-N)",22,0,0,0,22
1795121,1383563,2024-02-13,House,"House: VOTE: Block Vote Passage (99-Y 0-N)",99,0,0,1,100
1795121,1399250,2024-02-29,Senate,"Senate: Reported from Education and Health with substitute (15-Y 0-N)",15,0,0,0,15
1795121,1401067,2024-03-01,Senate,"Senate: Constitutional reading dispensed (40-Y 0-N)",40,0,0,0,40
1795121,1401882,2024-03-04,Senate,"Senate: Passed Senate with substitute (39-Y 0-N)",39,0,0,1,40
1795121,1402980,2024-03-05,House,"House: VOTE: Adoption (100-Y 0-N)",100,0,0,0,100
1795125,1366568,2024-01-18,House,"House: Subcommittee recommends reporting with substitute (7-Y 1-N)",7,1,0,0,8
1795125,1367766,2024-01-23,House,"House: Reported from General Laws with substitute (17-Y 4-N)",17,4,0,1,22
1795125,1370530,2024-01-29,House,"House: VOTE: Passage (54-Y 44-N)",54,44,0,2,100
1795125,1384334,2024-02-14,Senate,"Senate: Reported from General Laws and Technology (9-Y 6-N)",9,6,0,0,15
1795125,1395923,2024-02-27,Senate,"Senate: Constitutional reading dispensed (39-Y 0-N)",39,0,0,1,40
1795125,1395924,2024-02-27,Senate,"Senate: Reported from Finance and Appropriations (10-Y 5-N)",10,5,0,0,15
1795125,1398356,2024-02-28,Senate,"Senate: Passed Senate (20-Y 19-N)",20,19,0,1,40
1795129,1366654,2024-01-18,House,"House: Reported from Labor and Commerce with substitute (12-Y 10-N)",12,10,0,0,22
1795129,1369014,2024-01-24,House,"House: VOTE: Passage (50-Y 49-N)",50,49,0,1,100
1795129,1394997,2024-02-26,Senate,"Senate: Reported from Commerce and Labor (9-Y 6-N)",9,6,0,0,15
1795129,1398027,2024-02-28,Senate,"Senate: Constitutional reading dispensed (39-Y 0-N)",39,0,0,1,40
1795129,1399652,2024-02-29,Senate,"Senate: Passed Senate (20-Y 19-N)",20,19,0,1,40
1795133,1366589,2024-01-18,House,"House: Subcommittee recommends reporting (7-Y 1-N)",7,1,0,0,8
1795133,1366891,2024-01-19,House,"House: Reported from Counties, Cities and Towns (18-Y 4-N)",18,4,0,0,22
1795137,1376796,2024-02-06,House,"House: Subcommittee recommends reporting with substitute (8-Y 0-N)",8,0,0,0,8
1795137,1379382,2024-02-08,House,"House: Reported from Transportation with substitute (22-Y 0-N)",22,0,0,0,22
1795137,1383738,2024-02-13,House,"House: VOTE: Block Vote Passage (99-Y 0-N)",99,0,0,1,100
1795137,1392305,2024-02-22,Senate,"Senate: Reported from Transportation (15-Y 0-N)",15,0,0,0,15
1795137,1394560,2024-02-26,Senate,"Senate: Constitutional reading dispensed (40-Y 0-N)",40,0,0,0,40
1795137,1395866,2024-02-27,Senate,"Senate: Passed Senate (39-Y 0-N)",39,0,0,1,40
1795139,1366394,2024-01-17,House,"House: Subcommittee recommends reporting with substitute (8-Y 0-N)",8,0,0,1,9
1795139,1366896,2024-01-19,House,"House: Reported from Courts of Justice with substitute (22-Y 0-N)",22,0,0,0,22
1795139,1369652,2024-01-25,House,"House: VOTE: Block Vote Passage (98-Y 0-N)",98,0,0,2,100
1795139,1387372,2024-02-19,Senate,"Senate: Reported from Courts of Justice (13-Y 0-N)",13,0,0,0,13
1795139,1396127,2024-02-27,Senate,"Senate: Constitutional reading dispensed (39-Y 0-N)",39,0,0,1,40
1795139,1396128,2024-02-27,Senate,"Senate: Reported from Finance and Appropriations with substitute (15-Y 0-N)",15,0,0,0,15
1795139,1397723,2024-02-28,Senate,"Senate: Passed Senate (39-Y 0-N)",39,0,0,1,40
1795139,1400781,2024-03-01,House,"House: VOTE: Adoption (94-Y 0-N)",94,0,0,6,100
1795147,1364283,2024-01-15,House,"House: Stricken from docket by Courts of Justice (22-Y 0-N)",22,0,0,0,22
1795151,1377096,2024-02-06,House,"House: Subcommittee recommends reporting with substitute (8-Y 0-N)",8,0,0,0,8
1795151,1379206,2024-02-08,House,"House: Reported from Transportation with substitute (22-Y 0-N)",22,0,0,0,22
1795151,1383774,2024-02-13,House,"House: VOTE: Block Vote Passage (99-Y 0-N)",99,0,0,1,100
1795151,1392366,2024-02-22,Senate,"Senate: Reported from Transportation (15-Y 0-N)",15,0,0,0,15
1795151,1394575,2024-02-26,Senate,"Senate: Constitutional reading dispensed (40-Y 0-N)",40,0,0,0,40
1795151,1396231,2024-02-27,Senate,"Senate: Passed Senate (39-Y 0-N)",39,0,0,1,40
1795154,1375635,2024-02-05,House,"House: Subcommittee recommends reporting (8-Y 0-N)",8,0,0,1,9
1795154,1378477,2024-02-07,House,"House: Reported from Courts of Justice (22-Y 0-N)",22,0,0,0,22
1795154,1383359,2024-02-13,House,"House: VOTE: Block Vote Passage (99-Y 0-N)",99,0,0,1,100
1795154,1390898,2024-02-21,Senate,"Senate: Reported from Courts of Justice (9-Y 0-N)",9,0,0,0,9
1795154,1393877,2024-02-23,Senate,"Senate: Constitutional reading dispensed (38-Y 0-N)",38,0,0,2,40
1795154,1394630,2024-02-26,Senate,"Senate: Passed Senate (40-Y 0-N)",40,0,0,0,40
1795158,1366652,2024-01-18,House,"House: Subcommittee recommends reporting with substitute (8-Y 0-N)",8,0,0,0,8
1795158,1367776,2024-01-23,House,"House: Reported from Health and Human Services with substitute (21-Y 1-N)",21,1,0,0,22
1795158,1370514,2024-01-29,House,"House: VOTE: Passage (89-Y 9-N)",89,9,0,2,100
1795158,1385472,2024-02-15,Senate,"Senate: Rereferred from Education and Health (12-Y 0-N)",12,0,0,0,12
1795158,1400355,2024-03-01,Senate,"Senate: Reported from Rehabilitation and Social Services (8-Y 6-N)",8,6,0,0,14
1795158,1401902,2024-03-04,Senate,"Senate: Constitutional reading dispensed (40-Y 0-N)",40,0,0,0,40
1795158,1403004,2024-03-05,Senate,"Senate: Passed Senate (22-Y 18-N)",22,18,0,0,40
1795165,1368236,2024-01-24,House,"House: Subcommittee recommends striking from docket (8-Y 0-N)",8,0,0,2,10
1795168,1366641,2024-01-18,House,"House: Subcommittee recommends reporting with amendments (8-Y 0-N)",8,0,0,0,8
1795168,1368010,2024-01-23,House,"House: Reported from Labor and Commerce with amendment(s) (19-Y 2-N)",19,2,0,1,22
1795168,1370756,2024-01-29,House,"House: VOTE: Passage (78-Y 20-N)",78,20,0,2,100
1795168,1387577,2024-02-19,Senate,"Senate: Rereferred from Commerce and Labor (14-Y 0-N)",14,0,0,0,14
1795168,1393148,2024-02-23,Senate,"Senate: Reported from Rehabilitation and Social Services with substitute (10-Y 5-N)",10,5,0,0,15
1795168,1394417,2024-02-26,Senate,"Senate: Constitutional reading dispensed (40-Y 0-N)",40,0,0,0,40
1795168,1395732,2024-02-27,Senate,"Senate: Passed Senate with substitute (26-Y 13-N)",26,13,0,1,40
1795168,1399637,2024-02-29,House,"House: VOTE: Adoption (82-Y 17-N)",82,17,0,1,100
1795173,1373732,2024-02-01,House,"House: Reported from Rules with substitute (16-Y 0-N)",16,0,0,2,18
1795173,1377055,2024-02-06,House,"House: VOTE: Block Vote Adoption (98-Y 0-N)",98,0,0,2,100
1795173,1394424,2024-02-26,Senate,"Senate: Reading waived (40-Y 0-N)",40,0,0,0,40
1795176,1367439,2024-01-22,House,"House: Subcommittee recommends reporting with amendments (7-Y 0-N)",7,0,0,2,9
1795176,1369805,2024-01-26,House,"House: Reported from Courts of Justice with amendment(s) (21-Y 0-N)",21,0,0,1,22
1795176,1374030,2024-02-01,House,"House: Reported from Health and Human Services with amendment(s) (22-Y 0-N)",22,0,0,0,22
1795176,1375556,2024-02-01,House,"House: Reported from Health and Human Services (22-Y 0-N)",22,0,0,0,22
1795176,1378716,2024-02-07,House,"House: VOTE: Block Vote Passage (100-Y 0-N)",100,0,0,0,100
1795176,1387369,2024-02-19,Senate,"Senate: Reported from Courts of Justice (11-Y 0-N)",11,0,0,0,11
1795176,1388436,2024-02-20,Senate,"Senate: Constitutional reading dispensed (39-Y 0-N)",39,0,0,1,40
1795176,1389967,2024-02-21,Senate,"Senate: Passed Senate (40-Y 0-N)",40,0,0,0,40
1795180,1366173,2024-01-17,House,"House: Stricken from docket by Finance (21-Y 0-N)",21,0,0,1,22
1795393,1366837,2024-01-18,House,"House: Subcommittee recommends reporting (8-Y 0-N)",8,0,0,0,8
1795393,1368004,2024-01-23,House,"House: Reported from Labor and Commerce (21-Y 0-N)",21,0,0,1,22
1795393,1370626,2024-01-29,House,"House: VOTE: Block Vote Passage (98-Y 0-N)",98,0,0,2,100
1795393,1387579,2024-02-19,Senate,"Senate: Reported from Commerce and Labor (15-Y 0-N)",15,0,0,0,15
1795393,1389865,2024-02-21,Senate,"Senate: Constitutional reading dispensed (40-Y 0-N)",40,0,0,0,40
1795393,1392068,2024-02-22,Senate,"Senate: Passed Senate (40-Y 0-N)",40,0,0,0,40
1795464,1368593,2024-01-24,House,"House: Subcommittee recommends reporting with substitute (7-Y 1-N)",7,1,0,1,9
1795464,1369870,2024-01-26,House,"House: Reported from Courts of Justice with substitute (13-Y 8-N)",13,8,0,1,22
1795464,1372815,2024-01-31,House,"House: Subcommittee recommends reporting (5-Y 3-N)",5,3,0,1,9
1795464,1374613,2024-02-02,House,"House: Reported from Appropriations (13-Y 9-N)",13,9,0,0,22
1795464,1379489,2024-02-08,House,"House: VOTE: Passage (63-Y 34-N)",63,34,0,3,100
1795464,1390868,2024-02-21,Senate,"Senate: Reported from Courts of Justice (9-Y 6-N)",9,6,0,0,15
1795464,1393782,2024-02-23,Senate,"Senate: Constitutional reading dispensed (38-Y 0-N)",38,0,0,2,40
1795464,1395778,2024-02-27,Senate,"Senate: Passed Senate (21-Y 18-N)",21,18,0,1,40
1795536,1366537,2024-01-18,House,"House: Subcommittee recommends reporting with substitute (6-Y 0-N)",6,0,0,0,6
1795536,1369716,2024-01-26,House,"House: Reported from Public Safety with substitute (22-Y 0-N)",22,0,0,0,22
1795536,1372848,2024-01-31,House,"House: Subcommittee recommends reporting (8-Y 0-N)",8,0,0,1,9
1795536,1374805,2024-02-02,House,"House: Reported from Appropriations (22-Y 0-N)",22,0,0,0,22
1795536,1379705,2024-02-08,House,"House: VOTE: Passage (82-Y 15-N)",82,15,0,3,100
1795536,1386554,2024-02-16,Senate,"Senate: Reported from Rehabilitation and Social Services (14-Y 0-N)",14,0,0,0,14
1795536,1387559,2024-02-19,Senate,"Senate: Constitutional reading dispensed (38-Y 0-N)",38,0,0,2,40
1795536,1388706,2024-02-20,Senate,"Senate: Passed Senate (40-Y 0-N)",40,0,0,0,40
1795969,1364341,2024-01-16,House,"House: Subcommittee recommends reporting with amendments (7-Y 1-N)",7,1,0,0,8
1795969,1366087,2024-01-17,House,"House: Reported from Education with amendment(s) (15-Y 6-N)",15,6,0,1,22
1795969,1368071,2024-01-23,House,"House: VOTE: Passage (58-Y 40-N)",58,40,0,2,100
1795969,1368802,2024-01-23,House,"House: VOTE: Passage (58-Y 40-N)",58,40,0,2,100
1795969,1399226,2024-02-29,Senate,"Senate: Passed by indefinitely in Education and Health (15-Y 0-N)",15,0,0,0,15
1795978,1374003,2024-02-01,House,"House: Subcommittee recommends reporting (6-Y 3-N)",6,3,0,1,10
1795978,1374737,2024-02-02,House,"House: Reported from Public Safety (12-Y 10-N)",12,10,0,0,22
1795978,1378143,2024-02-07,House,"House: Subcommittee recommends reporting with substitute (5-Y 3-N)",5,3,0,1,9
1795978,1378822,2024-02-07,House,"House: Reported from Appropriations with substitute (12-Y 10-N)",12,10,0,0,22
1795978,1383730,2024-02-13,House,"House: VOTE: Passage (51-Y 48-N)",51,48,0,1,100
1795978,1394529,2024-02-26,Senate,"Senate: Reported from Courts of Justice with substitute (8-Y 4-N)",8,4,0,0,12
1795978,1397503,2024-02-28,Senate,"Senate: Reported from Finance and Appropriations (10-Y 5-N)",10,5,0,0,15
1795978,1399118,2024-02-29,Senate,"Senate: Constitutional reading dispensed (39-Y 0-N)",39,0,0,1,40
1795978,1400998,2024-03-01,Senate,"Senate: Passed Senate with substitute (20-Y 19-N)",20,19,0,1,40
1795978,1400999,2024-03-01,Senate,"Senate: Reconsideration of Senate passage agreed to by Senate (40-Y 0-N)",40,0,0,0,40
1795978,1401000,2024-03-01,Senate,"Senate: Passed Senate with substitute (21-Y 19-N)",21,19,0,0,40
1795978,1401622,2024-03-04,House,"House: VOTE: Adoption (51-Y 47-N)",51,47,0,2,100
1795987,1373385,2024-01-31,House,"House: Subcommittee recommends reporting (7-Y 1-N)",7,1,0,1,9
1795987,1375888,2024-02-02,House,"House: Reported from Courts of Justice (15-Y 6-N)",15,6,0,1,22
1795987,1380645,2024-02-09,House,"House: Subcommittee recommends reporting (4-Y 3-N)",4,3,0,2,9
1795987,1380646,2024-02-09,House,"House: Reported from Appropriations (12-Y 8-N)",12,8,0,2,22
1796007,1366489,2024-01-18,House,"House: Subcommittee recommends reporting with substitute (6-Y 2-N)",6,2,0,0,8
1796015,1367444,2024-01-22,House,"House: Subcommittee recommends reporting (7-Y 0-N)",7,0,0,2,9
1796015,1369800,2024-01-26,House,"House: Reported from Courts of Justice (21-Y 0-N)",21,0,0,1,22
1796015,1373882,2024-02-01,House,"House: VOTE: Block Vote Passage (99-Y 0-N)",99,0,0,1,100
1796015,1384434,2024-02-14,Senate,"Senate: Reported from Courts of Justice (15-Y 0-N)",15,0,0,0,15
1796015,1386632,2024-02-16,Senate,"Senate: Constitutional reading dispensed (38-Y 0-N)",38,0,0,2,40
1796015,1387389,2024-02-19,Senate,"Senate: Passed Senate (39-Y 0-N)",39,0,0,1,40
1796025,1366194,2024-01-17,House,"House: Subcommittee recommends reporting (5-Y 3-N)",5,3,0,1,9
1796025,1366964,2024-01-19,House,"House: Reported from Courts of Justice (12-Y 10-N)",12,10,0,0,22
1796025,1369856,2024-01-26,House,"House: VOTE: Passage (54-Y 40-N 1-A)",54,40,1,5,100
1796025,1384547,2024-02-14,Senate,"Senate: Reported from Courts of Justice (6-Y 5-N)",6,5,0,0,11
1796025,1386723,2024-02-16,Senate,"Senate: Constitutional reading dispensed (38-Y 0-N)",38,0,0,2,40
1796025,1387438,2024-02-19,Senate,"Senate: Passed Senate (22-Y 16-N 1-A)",22,16,1,1,40
1796025,1387439,2024-02-19,Senate,"Senate: Reconsideration of Senate passage agreed to by Senate (37-Y 2-N)",37,2,0,1,40
1796025,1387440,2024-02-19,Senate,"Senate: Passed Senate (21-Y 18-N)",21,18,0,1,40
1796025,1387441,2024-02-19,Senate,"Senate: Reconsideration of Senate passage agreed to by Senate (39-Y 0-N)",39,0,0,1,40
1796025,1387442,2024-02-19,Senate,"Senate: Passed Senate (22-Y 17-N)",22,17,0,1,40
1796036,1374707,2024-02-02,House,"House: Subcommittee recommends reporting (8-Y 0-N)",8,0,0,0,8
1796036,1374708,2024-02-02,House,"House: Reported from Counties, Cities and Towns (22-Y 0-N)",22,0,0,0,22
1796036,1380066,2024-02-08,House,"House: VOTE: Block Vote Passage (98-Y 0-N)",98,0,0,2,100
1796036,1387273,2024-02-19,Senate,"Senate: Reported from Local Government (15-Y 0-N)",15,0,0,0,15
1796036,1389094,2024-02-20,Senate,"Senate: Constitutional reading dispensed (39-Y 0-N)",39,0,0,1,40
1796036,1389998,2024-02-21,Senate,"Senate: Passed Senate (40-Y 0-N)",40,0,0,0,40
1796043,1370627,2024-01-29,House,"House: Subcommittee recommends reporting with substitute (5-Y 3-N)",5,3,0,0,8
1796043,1380851,2024-02-09,House,"House: Failed to report (defeated) in Privileges and Elections (9-Y 13-N)",9,13,0,0,22
1796059,1375327,2024-02-02,House,"House: Subcommittee recommends laying on the table (5-Y 0-N)",5,0,0,4,9
1796071,1373983,2024-02-01,House,"House: Reported from Rules with amendment(s) (17-Y 0-N)",17,0,0,1,18
1796071,1377589,2024-02-06,House,"House: VOTE: Block Vote Adoption (98-Y 0-N)",98,0,0,2,100
1796071,1394365,2024-02-26,Senate,"Senate: Reading waived (40-Y 0-N)",40,0,0,0,40
1796089,1364492,2024-01-16,House,"House: Reported from Health and Human Services (22-Y 0-N)",22,0,0,0,22
1796089,1375190,2024-02-02,House,"House: Subcommittee recommends laying on the table (8-Y 0-N)",8,0,0,1,9
1796100,1367199,2024-01-22,House,"House: Subcommittee recommends reporting with substitute (9-Y 1-N)",9,1,0,0,10
1796100,1368233,2024-01-24,House,"House: Reported from Education with substitute (20-Y 1-N)",20,1,0,1,22
1796100,1372123,2024-01-30,House,"House: VOTE: Passage (100-Y 0-N)",100,0,0,0,100
1796100,1392443,2024-02-22,Senate,"Senate: Reported from Education and Health (15-Y 0-N)",15,0,0,0,15
1796100,1393919,2024-02-23,Senate,"Senate: Constitutional reading dispensed (38-Y 0-N)",38,0,0,2,40
1796100,1395038,2024-02-26,Senate,"Senate: Passed Senate (40-Y 0-N)",40,0,0,0,40
1796109,1364342,2024-01-16,House,"House: Subcommittee recommends reporting with amendments (8-Y 0-N)",8,0,0,0,8
1796109,1366333,2024-01-17,House,"House: Reported from Education with amendment(s) (21-Y 0-N)",21,0,0,1,22
1796109,1367740,2024-01-23,House,"House: VOTE: Block Vote Passage (98-Y 0-N)",98,0,0,2,100
1796109,1368890,2024-01-23,House,"House: VOTE: Block Vote Passage (98-Y 0-N)",98,0,0,2,100
1796109,1392060,2024-02-22,Senate,"Senate: Reported from Education and Health (14-Y 1-N)",14,1,0,0,15
1796109,1393641,2024-02-23,Senate,"Senate: Constitutional reading dispensed (38-Y 0-N)",38,0,0,2,40
1796109,1395290,2024-02-26,Senate,"Senate: Passed Senate (39-Y 0-N)",39,0,0,1,40
1796129,1366688,2024-01-18,House,"House: Subcommittee recommends reporting with substitute (7-Y 3-N)",7,3,0,0,10
1796129,1367033,2024-01-19,House,"House: Reported from Public Safety with substitute (12-Y 9-N)",12,9,0,1,22
1796129,1368511,2024-01-24,House,"House: Subcommittee recommends reporting (5-Y 3-N)",5,3,0,1,9
1796129,1370865,2024-01-29,House,"House: Reported from Appropriations (12-Y 9-N)",12,9,0,1,22
1796129,1374935,2024-02-02,House,"House: VOTE: Passage (52-Y 48-N)",52,48,0,0,100
1796129,1387351,2024-02-19,Senate,"Senate: Reported from Courts of Justice with substitute (8-Y 5-N)",8,5,0,0,13
1796129,1397379,2024-02-28,Senate,"Senate: Reported from Finance and Appropriations (10-Y 5-N)",10,5,0,0,15
1796129,1399701,2024-02-29,Senate,"Senate: Constitutional reading dispensed (39-Y 0-N)",39,0,0,1,40
1796129,1400901,2024-03-01,Senate,"Senate: Passed Senate with substitute (21-Y 19-N)",21,19,0,0,40
1796129,1401553,2024-03-04,House,"House: VOTE: Adoption (52-Y 44-N 1-A)",52,44,1,3,100
1796163,1376532,2024-02-05,House,"House: Subcommittee recommends reporting (8-Y 0-N)",8,0,0,1,9
1796163,1378399,2024-02-07,House,"House: Reported from Courts of Justice (22-Y 0-N)",22,0,0,0,22
1796163,1383352,2024-02-13,House,"House: VOTE: Block Vote Passage (99-Y 0-N)",99,0,0,1,100
1796163,1395045,2024-02-26,Senate,"Senate: Reported from Courts of Justice (15-Y 0-N)",15,0,0,0,15
1796163,1398171,2024-02-28,Senate,"Senate: Reported from Finance and Appropriations (15-Y 0-N)",15,0,0,0,15
1796163,1399418,2024-02-29,Senate,"Senate: Constitutional reading dispensed (39-Y 0-N)",39,0,0,1,40
1796163,1400707,2024-03-01,Senate,"Senate: Passed Senate (40-Y 0-N)",40,0,0,0,40
1796232,1377406,2024-02-06,Senate,"Senate: Reported from Privileges and Elections with substitute (7-Y 6-N 1-A)",7,6,1,0,14
1796232,1378305,2024-02-07,Senate,"Senate: Constitutional reading dispensed (40-Y 0-N)",40,0,0,0,40
1796232,1380833,2024-02-09,Senate,"Senate: Amendments by Senator Stanley rejected (19-Y 20-N 1-A)",19,20,1,0,40
1796232,1381518,2024-02-12,Senate,"Senate: Read third time and defeated by Senate (19-Y 21-N)",19,21,0,0,40
1796244,1364279,2024-01-15,Senate,"Senate: Reported from Local Government (13-Y 0-N)",13,0,0,0,13
1796244,1368369,2024-01-16,Senate,"Senate: Constitutional reading dispensed (38-Y 0-N)",38,0,0,1,39
1796244,1368370,2024-01-18,Senate,"Senate: Read third time and passed Senate (40-Y 0-N)",40,0,0,0,40
1796244,1386271,2024-02-15,House,"House: Reported from General Laws (22-Y 0-N)",22,0,0,0,22
1796244,1389624,2024-02-20,House,"House: VOTE: Block Vote Passage (98-Y 0-N)",98,0,0,2,100
1796265,1368677,2024-01-24,Senate,"Senate: Reported from General Laws and Technology with substitute (12-Y 3-N)",12,3,0,0,15
1796265,1376864,2024-02-06,Senate,"Senate: Reported from Finance and Appropriations with substitute (10-Y 5-N)",10,5,0,0,15
1796265,1378599,2024-02-07,Senate,"Senate: Constitutional reading dispensed (40-Y 0-N)",40,0,0,0,40
1796265,1380883,2024-02-09,Senate,"Senate: Read third time and passed Senate (23-Y 17-N)",23,17,0,0,40
1796265,1380884,2024-02-09,Senate,"Senate: Reconsideration of passage agreed to by Senate (40-Y 0-N)",40,0,0,0,40
1796265,1380885,2024-02-09,Senate,"Senate: Passed Senate (22-Y 17-N)",22,17,0,1,40
1796265,1388520,2024-02-20,House,"House: Reported from General Laws with substitute (18-Y 3-N)",18,3,0,1,22
1796265,1394688,2024-02-26,House,"House: Tabled in Appropriations (22-Y 0-N)",22,0,0,0,22
1796284,1369428,2024-01-25,House,"House: Subcommittee recommends reporting (6-Y 4-N)",6,4,0,0,10
1796284,1369772,2024-01-26,House,"House: Reported from Public Safety (12-Y 10-N)",12,10,0,0,22
1796284,1373927,2024-02-01,House,"House: VOTE: Passage (51-Y 49-N)",51,49,0,0,100
1796284,1387316,2024-02-19,Senate,"Senate: Reported from Courts of Justice with amendments (8-Y 5-N)",8,5,0,0,13
1796284,1397397,2024-02-28,Senate,"Senate: Reported from Finance and Appropriations (10-Y 5-N)",10,5,0,0,15
1796284,1399698,2024-02-29,Senate,"Senate: Constitutional reading dispensed (39-Y 0-N)",39,0,0,1,40
1796284,1400904,2024-03-01,Senate,"Senate: Passed Senate with amendments (21-Y 19-N)",21,19,0,0,40
1796284,1401555,2024-03-04,House,"House: VOTE: Adoption (51-Y 47-N)",51,47,0,2,100
1796295,1367564,2024-01-22,Senate,"Senate: Reported from Commerce and Labor (9-Y 6-N)",9,6,0,0,15
1796295,1372448,2024-01-31,Senate,"Senate: Continued to 2025 in Finance and Appropriations (15-Y 0-N)",15,0,0,0,15
1796305,1369753,2024-01-26,House,"House: Stricken from docket by Privileges and Elections (22-Y 0-N)",22,0,0,0,22
1796317,1364389,2024-01-16,Senate,"Senate: Passed by indefinitely in Privileges and Elections (8-Y 6-N)",8,6,0,0,14
1796328,1364333,2024-01-16,House,"House: Subcommittee recommends reporting (8-Y 0-N)",8,0,0,0,8
1796328,1366094,2024-01-17,House,"House: Reported from Education (17-Y 4-N)",17,4,0,1,22
1796349,1373530,2024-01-31,Senate,"Senate: Reported from Courts of Justice with substitute (15-Y 0-N)",15,0,0,0,15
1796349,1378562,2024-02-07,Senate,"Senate: Reported from Finance and Appropriations (15-Y 0-N)",15,0,0,0,15
1796349,1379398,2024-02-08,Senate,"Senate: Constitutional reading dispensed (40-Y 0-N)",40,0,0,0,40
1796349,1380598,2024-02-09,Senate,"Senate: Constitutional reading dispensed (40-Y 0-N)",40,0,0,0,40
1796349,1380599,2024-02-09,Senate,"Senate: Read third time and passed Senate (40-Y 0-N)",40,0,0,0,40
1796349,1391446,2024-02-22,House,"House: Subcommittee recommends reporting with substitute (6-Y 0-N)",6,0,0,0,6
1796349,1393135,2024-02-23,House,"House: Reported from Public Safety with substitute (21-Y 0-N)",21,0,0,1,22
1796349,1398605,2024-02-28,House,"House: VOTE: Block Vote Passage (97-Y 0-N)",97,0,0,3,100
1796349,1401061,2024-03-01,Senate,"Senate: House substitute agreed to by Senate (39-Y 0-N)",39,0,0,1,40
1796358,1364383,2024-01-16,Senate,"Senate: Passed by indefinitely in Privileges and Elections (8-Y 6-N)",8,6,0,0,14
1796368,1366186,2024-01-17,House,"House: Subcommittee recommends reporting (8-Y 0-N)",8,0,0,1,9
1796368,1366897,2024-01-19,House,"House: Reported from Courts of Justice (22-Y 0-N)",22,0,0,0,22
1796368,1370008,2024-01-26,House,"House: VOTE: Passage (95-Y 0-N)",95,0,0,5,100
1796368,1385049,2024-02-14,Senate,"Senate: Reported from Courts of Justice (15-Y 0-N)",15,0,0,0,15
1796368,1386663,2024-02-16,Senate,"Senate: Constitutional reading dispensed (38-Y 0-N)",38,0,0,2,40
1796368,1387412,2024-02-19,Senate,"Senate: Passed Senate (39-Y 0-N)",39,0,0,1,40
1796380,1367795,2024-01-23,House,"House: Subcommittee recommends reporting (8-Y 0-N)",8,0,0,0,8
1796380,1369241,2024-01-25,House,"House: Reported from Health and Human Services (21-Y 1-N)",21,1,0,0,22
1796380,1372953,2024-01-31,House,"House: VOTE: Passage (100-Y 0-N)",100,0,0,0,100
1796380,1385496,2024-02-15,Senate,"Senate: Reported from Education and Health with substitute (14-Y 0-N)",14,0,0,0,14
1796380,1386509,2024-02-16,Senate,"Senate: Constitutional reading dispensed (38-Y 0-N)",38,0,0,2,40
1796380,1387719,2024-02-19,Senate,"Senate: Passed Senate (39-Y 0-N)",39,0,0,1,40
1796380,1390766,2024-02-21,House,"House: VOTE: Adoption (98-Y 0-N)",98,0,0,2,100
1796389,1366578,2024-01-18,Senate,"Senate: Passed by indefinitely in Education and Health (9-Y 6-N)",9,6,0,0,15
1796399,1364327,2024-01-16,House,"House: Subcommittee recommends reporting with substitute (7-Y 1-N)",7,1,0,0,8
1796399,1366095,2024-01-17,House,"House: Reported from Education with substitute (16-Y 5-N)",16,5,0,1,22
1796399,1376102,2024-02-05,House,"House: Subcommittee recommends reporting with substitute (8-Y 0-N)",8,0,0,1,9
1796399,1378627,2024-02-07,House,"House: Reported from Appropriations with substitute (15-Y 7-N)",15,7,0,0,22
1796399,1383214,2024-02-13,House,"House: VOTE: Passage (74-Y 24-N)",74,24,0,2,100
1796399,1391289,2024-02-22,Senate,"Senate: Reported from Education and Health with amendments (14-Y 0-N)",14,0,0,0,14
1796399,1392022,2024-02-22,Senate,"Senate: Reported from Finance and Appropriations with substitute (10-Y 5-N)",10,5,0,0,15
1796399,1393555,2024-02-23,Senate,"Senate: Constitutional reading dispensed (38-Y 0-N)",38,0,0,2,40
1796399,1396560,2024-02-27,Senate,"Senate: Passed Senate with amendments (21-Y 18-N)",21,18,0,1,40
1796399,1399631,2024-02-29,House,"House: VOTE: Adoption (69-Y 31-N)",69,31,0,0,100
1796399,1430171,2024-04-17,House,"House: VOTE: Adoption (50-Y 50-N)",50,50,0,0,100
1796410,1367354,2024-01-22,Senate,"Senate: Reported from Local Government (15-Y 0-N)",15,0,0,0,15
1796410,1368503,2024-01-23,Senate,"Senate: Constitutional reading dispensed (39-Y 0-N)",39,0,0,1,40
1796410,1369897,2024-01-26,Senate,"Senate: Read third time and passed Senate (38-Y 0-N)",38,0,0,2,40
1796410,1386264,2024-02-15,House,"House: Reported from General Laws (22-Y 0-N)",22,0,0,0,22
1796410,1389455,2024-02-20,House,"House: VOTE: Block Vote Passage (98-Y 0-N)",98,0,0,2,100
1796421,1366475,2024-01-18,Senate,"Senate: Passed by indefinitely in Education and Health (11-Y 4-N)",11,4,0,0,15
1796432,1374617,2024-02-02,Senate,"Senate: Reported from Rehabilitation and Social Services with substitute (15-Y 0-N)",15,0,0,0,15
1796432,1378337,2024-02-07,Senate,"Senate: Reported from Finance and Appropriations with substitute (15-Y 0-N)",15,0,0,0,15
1796432,1379376,2024-02-08,Senate,"Senate: Constitutional reading dispensed (40-Y 0-N)",40,0,0,0,40
1796432,1380590,2024-02-09,Senate,"Senate: Constitutional reading dispensed (40-Y 0-N)",40,0,0,0,40
1796432,1380591,2024-02-09,Senate,"Senate: Read third time and passed Senate (40-Y 0-N)",40,0,0,0,40
1796432,1393150,2024-02-23,House,"House: Subcommittee recommends reporting (6-Y 0-N)",6,0,0,0,6
1796432,1393265,2024-02-23,House,"House: Reported from Rules (16-Y 0-N)",16,0,0,2,18
1796432,1398435,2024-02-28,House,"House: Reported from Appropriations with substitute (22-Y 0-N)",22,0,0,0,22
1796432,1401829,2024-03-04,House,"House: VOTE: Passage (56-Y 40-N)",56,40,0,4,100
1796432,1402972,2024-03-05,Senate,"Senate: House substitute rejected by Senate (0-Y 40-N)",0,40,0,0,40
1796432,1405066,2024-03-07,Senate,"Senate: Senate acceded to request (40-Y 0-N)",40,0,0,0,40
1796432,1406377,2024-03-08,Senate,"Senate: Conference report agreed to by Senate (26-Y 14-N)",26,14,0,0,40
1796432,1406378,2024-03-08,House,"House: VOTE: Adoption (53-Y 43-N)",53,43,0,4,100
1796432,1430114,2024-04-17,Senate,"Senate: Passed in enrolled form rejected (20-Y 19-N)",20,19,0,1,40
1796442,1364293,2024-01-15,Senate,"Senate: Passed by indefinitley in Courts of Justice (8-Y 7-N)",8,7,0,0,15
1796454,1367177,2024-01-22,Senate,"Senate: Passed by indefinitely in Courts of Justice (9-Y 6-N)",9,6,0,0,15
1796466,1371061,2024-01-29,Senate,"Senate: Reported from Commerce and Labor with substitute (15-Y 0-N)",15,0,0,0,15
1796466,1377876,2024-02-07,Senate,"Senate: Reported from Finance and Appropriations (15-Y 0-N)",15,0,0,0,15
1796466,1379852,2024-02-08,Senate,"Senate: Constitutional reading dispensed (40-Y 0-N)",40,0,0,0,40
1796466,1380853,2024-02-09,Senate,"Senate: Constitutional reading dispensed (40-Y 0-N)",40,0,0,0,40
1796466,1380854,2024-02-09,Senate,"Senate: Passed Senate (40-Y 0-N)",40,0,0,0,40
1796466,1388537,2024-02-20,House,"House: Subcommittee recommends reporting (7-Y 0-N)",7,0,0,1,8
1796466,1392045,2024-02-22,House,"House: Reported from Labor and Commerce (22-Y 0-N)",22,0,0,0,22
1796466,1396524,2024-02-27,House,"House: VOTE: Block Vote Passage (97-Y 0-N)",97,0,0,3,100
1796479,1366402,2024-01-17,House,"House: Subcommittee recommends reporting (7-Y 1-N)",7,1,0,1,9
1796479,1369877,2024-01-26,House,"House: Reported from Courts of Justice (21-Y 0-N)",21,0,0,1,22
1796479,1374094,2024-02-01,House,"House: VOTE: Block Vote Passage (99-Y 0-N)",99,0,0,1,100
1796479,1398717,2024-02-28,Senate,"Senate: Reported from Courts of Justice with substitute (8-Y 7-N)",8,7,0,0,15
1796479,1401009,2024-03-01,Senate,"Senate: Constitutional reading dispensed (40-Y 0-N)",40,0,0,0,40
1796479,1401645,2024-03-04,Senate,"Senate: Passed Senate with substitute with amendments (20-Y 19-N)",20,19,0,1,40
1796479,1402746,2024-03-05,House,"House: VOTE: Adoption (100-Y 0-N)",100,0,0,0,100
1796479,1429517,2024-04-17,Senate,"Senate: Senate concurred in Governor's recommendation (40-Y 0-N)",40,0,0,0,40
1796479,1430299,2024-04-17,House,"House: VOTE: (100-Y 0-N)",100,0,0,0,100
1796491,1382807,2024-02-12,Senate,"Senate: Stricken at request of Patron in Courts of Justice (15-Y 0-N)",15,0,0,0,15
1796502,1364284,2024-01-15,House,"House: Stricken from docket by Courts of Justice (22-Y 0-N)",22,0,0,0,22
1796510,1369447,2024-01-25,House,"House: Subcommittee recommends striking from docket (8-Y 0-N)",8,0,0,0,8
1796521,1371452,2024-01-30,House,"House: Subcommittee recommends reporting with substitute (8-Y 0-N)",8,0,0,0,8
1796521,1373564,2024-02-01,House,"House: Reported from Transportation with substitute (22-Y 0-N)",22,0,0,0,22
1796521,1378927,2024-02-07,House,"House: VOTE: Block Vote Passage (100-Y 0-N)",100,0,0,0,100
1796521,1386419,2024-02-15,Senate,"Senate: Reported from Transportation (12-Y 0-N)",12,0,0,0,12
1796521,1387927,2024-02-19,Senate,"Senate: Constitutional reading dispensed (38-Y 0-N)",38,0,0,2,40
1796521,1389270,2024-02-20,Senate,"Senate: Passed Senate (40-Y 0-N)",40,0,0,0,40
1796521,1430253,2024-04-17,House,"House: VOTE: (100-Y 0-N)",100,0,0,0,100
1796521,1430254,2024-04-17,Senate,"Senate: Senate concurred in Governor's recommendation (40-Y 0-N)",40,0,0,0,40
1796530,1366466,2024-01-17,Senate,"Senate: Reported from General Laws and Technology (14-Y 0-N 1-A)",14,0,1,0,15
1796530,1368397,2024-01-19,Senate,"Senate: Constitutional reading dispensed (37-Y 0-N)",37,0,0,3,40
1796530,1368398,2024-01-23,Senate,"Senate: Read third time and passed Senate (28-Y 11-N)",28,11,0,1,40
1796530,1388479,2024-02-20,House,"House: Reported from General Laws (21-Y 0-N)",21,0,0,1,22
1796530,1393386,2024-02-23,House,"House: VOTE: Passage (95-Y 3-N)",95,3,0,2,100
1796535,1371463,2024-01-30,House,"House: Subcommittee recommends reporting with substitute (8-Y 0-N)",8,0,0,0,8
1796535,1373794,2024-02-01,House,"House: Reported from Transportation with substitute (22-Y 0-N)",22,0,0,0,22
1796535,1378369,2024-02-07,House,"House: VOTE: Block Vote Passage (100-Y 0-N)",100,0,0,0,100
1796535,1386413,2024-02-15,Senate,"Senate: Reported from Transportation (15-Y 0-N)",15,0,0,0,15
1796535,1388057,2024-02-19,Senate,"Senate: Constitutional reading dispensed (38-Y 0-N)",38,0,0,2,40
1796535,1389406,2024-02-20,Senate,"Senate: Passed Senate (40-Y 0-N)",40,0,0,0,40
1796543,1372425,2024-01-31,House,"House: Subcommittee recommends reporting (10-Y 0-N)",10,0,0,0,10
1796543,1378455,2024-02-07,House,"House: Reported from Agriculture, Chesapeake and Natural Resources (22-Y 0-N)",22,0,0,0,22
1796543,1383144,2024-02-13,House,"House: VOTE: Passage (92-Y 7-N)",92,7,0,1,100
1796543,1386705,2024-02-16,Senate,"Senate: Reported from Agriculture, Conservation and Natural Resources (11-Y 0-N)",11,0,0,0,11
1796543,1397424,2024-02-28,Senate,"Senate: Reported from Finance and Appropriations (13-Y 0-N)",13,0,0,0,13
1796543,1399755,2024-02-29,Senate,"Senate: Constitutional reading dispensed (39-Y 0-N)",39,0,0,1,40
1796543,1400908,2024-03-01,Senate,"Senate: Passed Senate (40-Y 0-N)",40,0,0,0,40
1796562,1379198,2024-02-08,House,"House: Reported from Rules (18-Y 0-N)",18,0,0,0,18
1796562,1382792,2024-02-13,House,"House: VOTE: Block Vote Passage (99-Y 0-N)",99,0,0,1,100
1796562,1400459,2024-03-01,Senate,"Senate: Reported from Rules (14-Y 0-N)",14,0,0,0,14
1796562,1402231,2024-03-04,Senate,"Senate: Constitutional reading dispensed (40-Y 0-N)",40,0,0,0,40
1796562,1403443,2024-03-05,Senate,"Senate: Passed Senate (40-Y 0-N)",40,0,0,0,40
1796569,1367964,2024-01-23,House,"House: Subcommittee recommends reporting with substitute (8-Y 0-N)",8,0,0,1,9
1796569,1369646,2024-01-25,House,"House: Reported from General Laws with substitute (22-Y 0-N)",22,0,0,0,22
1796569,1372786,2024-01-31,House,"House: Subcommittee recommends reporting (7-Y 1-N)",7,1,0,1,9
1796569,1375819,2024-02-02,House,"House: Reported from Courts of Justice (17-Y 4-N)",17,4,0,1,22
1796569,1380294,2024-02-08,House,"House: VOTE: Passage (84-Y 14-N)",84,14,0,2,100
1796569,1390317,2024-02-21,Senate,"Senate: Failed to report (defeated) in General Laws and Technology (7-Y 7-N 1-A)",7,7,1,0,15
1796576,1366235,2024-01-17,House,"House: Subcommittee recommends reporting with amendments (10-Y 0-N)",10,0,0,0,10
1796576,1368258,2024-01-24,House,"House: Stricken from docket by Agriculture, Chesapeake and Natural Resources (22-Y 0-N)",22,0,0,0,22
1796596,1370979,2024-01-29,House,"House: Subcommittee recommends reporting with amendments (6-Y 0-N)",6,0,0,0,6
1796596,1374313,2024-02-01,House,"House: Reported from Rules with amendment(s) (18-Y 0-N)",18,0,0,0,18
1796596,1376524,2024-02-05,House,"House: Subcommittee recommends reporting (8-Y 0-N)",8,0,0,1,9
1796596,1378981,2024-02-07,House,"House: Reported from Appropriations (22-Y 0-N)",22,0,0,0,22
1796596,1382389,2024-02-12,House,"House: VOTE: Block vote adoption (97-Y 0-N)",97,0,0,3,100
1796596,1401602,2024-03-04,Senate,"Senate: Reading waived (40-Y 0-N)",40,0,0,0,40
1796596,1406790,2024-03-06,House,"House: VOTE: Adoption (95-Y 4-N)",95,4,0,1,100
1796827,1366878,2024-01-19,House,"House: Subcommittee recommends reporting with substitute (6-Y 2-N)",6,2,0,0,8
1796827,1366879,2024-01-19,House,"House: Reported from Counties, Cities and Towns with substitute (14-Y 8-N)",14,8,0,0,22
1796827,1369874,2024-01-26,House,"House: VOTE: Passage (49-Y 45-N)",49,45,0,6,100
1796827,1387276,2024-02-19,Senate,"Senate: Reported from Local Government with amendment (9-Y 5-N)",9,5,0,0,14
1796827,1389144,2024-02-20,Senate,"Senate: Constitutional reading dispensed (39-Y 0-N)",39,0,0,1,40
1796827,1390038,2024-02-21,Senate,"Senate: Passed Senate with amendment (25-Y 15-N)",25,15,0,0,40
1796827,1393849,2024-02-23,House,"House: VOTE: Adoption (50-Y 46-N)",50,46,0,4,100
1796834,1368283,2024-01-24,House,"House: Subcommittee recommends laying on the table (6-Y 2-N)",6,2,0,0,8
1796842,1368957,2024-01-24,House,"House: Subcommittee recommends reporting with substitute (7-Y 3-N)",7,3,0,1,11
1796842,1372404,2024-01-31,House,"House: Reported from Agriculture, Chesapeake and Natural Resources with substitute (16-Y 6-N)",16,6,0,0,22
1796842,1374963,2024-02-02,House,"House: Subcommittee recommends reporting with amendments (7-Y 1-N)",7,1,0,1,9
1796842,1380995,2024-02-09,House,"House: Reported from Courts of Justice with amendment(s) (18-Y 4-N)",18,4,0,0,22
1796842,1383436,2024-02-13,House,"House: VOTE: Passage (83-Y 15-N)",83,15,0,2,100
1796842,1396699,2024-02-27,Senate,"Senate: Reported from Agriculture, Conservation and Natural Resources with substitute (14-Y 0-N)",14,0,0,0,14
1796842,1399668,2024-02-29,Senate,"Senate: Constitutional reading dispensed (39-Y 0-N)",39,0,0,1,40
1796842,1400862,2024-03-01,Senate,"Senate: Passed Senate with substitute (40-Y 0-N)",40,0,0,0,40
1796842,1401511,2024-03-04,House,"House: VOTE: Adoption (87-Y 11-N)",87,11,0,2,100
1796849,1376033,2024-02-05,Senate,"Senate: Reading waived (39-Y 0-N)",39,0,0,1,40
1796849,1393195,2024-02-23,House,"House: Reported from Rules (17-Y 0-N)",17,0,0,1,18
1796849,1398487,2024-02-28,House,"House: VOTE: Block Vote Adoption (99-Y 0-N)",99,0,0,1,100
1796849,1398488,2024-02-28,House,"House: VOTE: Block Vote Adoption #2 (99-Y 0-N)",99,0,0,1,100
1796856,1368623,2024-01-24,House,"House: Subcommittee recommends reporting with substitute (8-Y 0-N)",8,0,0,0,8
1796856,1371570,2024-01-30,House,"House: Reported from Transportation with substitute (20-Y 2-N)",20,2,0,0,22
1796856,1375777,2024-02-05,House,"House: VOTE: Passage (61-Y 37-N)",61,37,0,2,100
1796856,1386607,2024-02-15,Senate,"Senate: Rereferred from Transportation (11-Y 1-N)",11,1,0,0,12
1796856,1389379,2024-02-20,Senate,"Senate: Reported from Agriculture, Conservation and Natural Resources with substitute (13-Y 1-N)",13,1,0,0,14
1796856,1395832,2024-02-27,Senate,"Senate: Constitutional reading dispensed (39-Y 0-N)",39,0,0,1,40
1796856,1395833,2024-02-27,Senate,"Senate: Reported from Finance and Appropriations (10-Y 5-N)",10,5,0,0,15
1796856,1398190,2024-02-28,Senate,"Senate: Passed Senate with substitute (25-Y 14-N)",25,14,0,1,40
1796856,1400469,2024-03-01,House,"House: VOTE: Adoption (58-Y 38-N)",58,38,0,4,100
1796862,1364275,2024-01-15,Senate,"Senate: Reported from Local Government (11-Y 1-N)",11,1,0,0,12
1796862,1432073,2024-01-16,Senate,"Senate: Constitutional reading dispensed (38-Y 0-N)",38,0,0,1,39
1796862,1432074,2024-01-18,Senate,"Senate: Read third time and passed Senate (38-Y 2-N)",38,2,0,0,40
1796862,1432075,2024-01-18,Senate,"Senate: Reconsideration of passage agreed to by Senate (40-Y 0-N)",40,0,0,0,40
1796862,1432076,2024-01-18,Senate,"Senate: Passed Senate (40-Y 0-N)",40,0,0,0,40
1796862,1432077,2024-02-16,House,"House: Reported from Counties, Cities and Towns (22-Y 0-N)",22,0,0,0,22
1796862,1432078,2024-02-21,House,"House: VOTE: Block Vote Passage (100-Y 0-N)",100,0,0,0,100
1796877,1366536,2024-01-18,House,"House: Subcommittee recommends reporting with substitute (7-Y 1-N)",7,1,0,0,8
1796877,1367613,2024-01-23,House,"House: Reported from Health and Human Services with substitute (20-Y 2-N)",20,2,0,0,22
1796877,1371798,2024-01-30,House,"House: VOTE: Adoption (51-Y 49-N)",51,49,0,0,100
1796884,1379596,2024-02-08,Senate,"Senate: Reported from Transportation with amendments (14-Y 0-N)",14,0,0,0,14
1796884,1380775,2024-02-09,Senate,"Senate: Constitutional reading dispensed (39-Y 0-N)",39,0,0,1,40
1796884,1381426,2024-02-12,Senate,"Senate: Constitutional reading dispensed (40-Y 0-N)",40,0,0,0,40
1796884,1381427,2024-02-12,Senate,"Senate: Passed Senate (40-Y 0-N)",40,0,0,0,40
1796884,1388355,2024-02-20,House,"House: Subcommittee recommends reporting (8-Y 0-N)",8,0,0,0,8
1796884,1391523,2024-02-22,House,"House: Reported from Transportation (22-Y 0-N)",22,0,0,0,22
1796884,1395955,2024-02-27,House,"House: VOTE: Block Vote Passage (97-Y 0-N)",97,0,0,3,100
1796893,1382545,2024-02-12,Senate,"Senate: Reported from Courts of Justice (11-Y 0-N)",11,0,0,0,11
1796893,1383691,2024-02-13,Senate,"Senate: Constitutional reading dispensed (40-Y 0-N)",40,0,0,0,40
1796893,1383692,2024-02-13,Senate,"Senate: Passed Senate (40-Y 0-N)",40,0,0,0,40
1796893,1383693,2024-02-13,Senate,"Senate: Constitutional reading dispensed (40-Y 0-N)",40,0,0,0,40
1796893,1386811,2024-02-16,House,"House: Subcommittee recommends reporting (8-Y 0-N)",8,0,0,1,9
1796893,1394094,2024-02-23,House,"House: Reported from Courts of Justice (20-Y 0-N)",20,0,0,2,22
1796893,1398498,2024-02-28,House,"House: VOTE: Block Vote Passage (97-Y 0-N)",97,0,0,3,100
1796900,1370470,2024-01-29,House,"House: Subcommittee recommends reporting (8-Y 0-N)",8,0,0,1,9
1796900,1375565,2024-02-02,House,"House: Reported from Courts of Justice (20-Y 0-N)",20,0,0,2,22
1796900,1379335,2024-02-08,House,"House: VOTE: Block Vote Passage (98-Y 0-N)",98,0,0,2,100
1796900,1387345,2024-02-19,Senate,"Senate: Reported from Courts of Justice (11-Y 0-N)",11,0,0,0,11
1796900,1388577,2024-02-20,Senate,"Senate: Constitutional reading dispensed (39-Y 0-N)",39,0,0,1,40
1796900,1390536,2024-02-21,Senate,"Senate: Passed Senate (40-Y 0-N)",40,0,0,0,40
1796907,1367643,2024-01-23,House,"House: Subcommittee recommends reporting with amendments (6-Y 2-N)",6,2,0,1,9
1796907,1370725,2024-01-29,House,"House: Reported from Education with amendment(s) (13-Y 9-N)",13,9,0,0,22
1796907,1376056,2024-02-05,House,"House: Subcommittee recommends reporting with amendments (7-Y 1-N)",7,1,0,1,9
1796907,1378752,2024-02-07,House,"House: Reported from Appropriations with amendment(s) (14-Y 8-N)",14,8,0,0,22
1796907,1383525,2024-02-13,House,"House: VOTE: Passage (54-Y 45-N)",54,45,0,1,100
1796907,1399135,2024-02-29,Senate,"Senate: Reported from Education and Health with substitute (12-Y 2-N 1-A)",12,2,1,0,15
1796907,1401021,2024-03-01,Senate,"Senate: Constitutional reading dispensed (40-Y 0-N)",40,0,0,0,40
1796907,1401748,2024-03-04,Senate,"Senate: Passed Senate with substitute (22-Y 16-N)",22,16,0,2,40
1796907,1402833,2024-03-05,House,"House: VOTE: Adoption (55-Y 45-N)",55,45,0,0,100
1796907,1430255,2024-04-17,House,"House: VOTE: Adoption (56-Y 41-N)",56,41,0,3,100
1796907,1430256,2024-04-17,Senate,"Senate: Senate concurred in Governor's recommendation (40-Y 0-N)",40,0,0,0,40
1796915,1364522,2024-01-16,Senate,"Senate: Reported from Privileges and Elections (10-Y 4-N)",10,4,0,0,14
1796915,1368408,2024-01-18,Senate,"Senate: Constitutional reading dispensed (40-Y 0-N)",40,0,0,0,40
1796915,1368409,2024-01-22,Senate,"Senate: Read third time and passed Senate (30-Y 10-N)",30,10,0,0,40
1796915,1386737,2024-02-16,House,"House: Reported from Privileges and Elections with substitute (17-Y 4-N)",17,4,0,1,22
1796915,1390689,2024-02-21,House,"House: VOTE: Passage (89-Y 11-N)",89,11,0,0,100
1796915,1393514,2024-02-23,Senate,"Senate: House substitute rejected by Senate (19-Y 20-N)",19,20,0,1,40
1796915,1397996,2024-02-28,Senate,"Senate: Senate acceded to request (37-Y 2-N)",37,2,0,1,40
1796915,1401510,2024-03-04,House,"House: VOTE: Adoption (87-Y 8-N)",87,8,0,5,100
1796915,1403371,2024-03-05,Senate,"Senate: Conference report agreed to by Senate (38-Y 2-N)",38,2,0,0,40
1796923,1377281,2024-02-06,Senate,"Senate: Reported from Privileges and Elections with substitute (11-Y 3-N)",11,3,0,0,14
1796923,1378172,2024-02-07,Senate,"Senate: Constitutional reading dispensed (40-Y 0-N)",40,0,0,0,40
1796930,1374380,2024-02-01,House,"House: Reported from Labor and Commerce (12-Y 10-N)",12,10,0,0,22
1796930,1378463,2024-02-07,House,"House: Subcommittee recommends reporting with substitute (5-Y 3-N)",5,3,0,1,9
1796930,1378464,2024-02-07,House,"House: Reported from Appropriations with substitute (12-Y 10-N)",12,10,0,0,22
1796930,1382867,2024-02-13,House,"House: VOTE: Passage (51-Y 48-N)",51,48,0,1,100
1796930,1400342,2024-03-01,Senate,"Senate: Reported from Rules with substitute (9-Y 4-N)",9,4,0,0,13
1796930,1402146,2024-03-04,Senate,"Senate: Constitutional reading dispensed (40-Y 0-N)",40,0,0,0,40
1796930,1403395,2024-03-05,Senate,"Senate: Passed Senate with substitute (21-Y 19-N)",21,19,0,0,40
1796930,1404161,2024-03-06,House,"House: VOTE: REJECTED (0-Y 97-N)",0,97,0,3,100
1796930,1405865,2024-03-07,Senate,"Senate: Senate insisted on substitute (40-Y 0-N)",40,0,0,0,40
1796930,1406142,2024-03-08,Senate,"Senate: Conference report agreed to by Senate (21-Y 19-N)",21,19,0,0,40
1796930,1406575,2024-03-08,House,"House: VOTE: Adoption (49-Y 46-N)",49,46,0,5,100
1796939,1378995,2024-02-07,Senate,"Senate: Reported from Courts of Justice with amendments (15-Y 0-N)",15,0,0,0,15
1796939,1379617,2024-02-08,Senate,"Senate: Constitutional reading dispensed (40-Y 0-N)",40,0,0,0,40
1796939,1380801,2024-02-09,Senate,"Senate: Constitutional reading dispensed (40-Y 0-N)",40,0,0,0,40
1796939,1380802,2024-02-09,Senate,"Senate: Passed Senate (40-Y 0-N)",40,0,0,0,40
1796939,1387678,2024-02-19,House,"House: Subcommittee recommends reporting with amendments (8-Y 0-N)",8,0,0,1,9
1796939,1394071,2024-02-23,House,"House: Reported from Courts of Justice with amendment(s) (21-Y 0-N)",21,0,0,1,22
1796939,1398576,2024-02-28,House,"House: VOTE: Passage (88-Y 11-N)",88,11,0,1,100
1796939,1401235,2024-03-01,Senate,"Senate: House amendments agreed to by Senate (40-Y 0-N)",40,0,0,0,40
1796947,1371868,2024-01-30,House,"House: Subcommittee recommends laying on the table (8-Y 0-N)",8,0,0,0,8
1796963,1367498,2024-01-22,Senate,"Senate: Reported from Commerce and Labor with substitute (15-Y 0-N)",15,0,0,0,15
1796963,1368522,2024-01-24,Senate,"Senate: Constitutional reading dispensed (40-Y 0-N)",40,0,0,0,40
1796963,1369730,2024-01-26,Senate,"Senate: Read third time and passed Senate (38-Y 0-N)",38,0,0,2,40
1796963,1389293,2024-02-20,House,"House: Reported from Labor and Commerce with amendment(s) (22-Y 0-N)",22,0,0,0,22
1796963,1393366,2024-02-23,House,"House: VOTE: Block Vote Passage (98-Y 0-N)",98,0,0,2,100
1796963,1396276,2024-02-27,Senate,"Senate: House amendment agreed to by Senate (39-Y 0-N)",39,0,0,1,40
1796969,1367425,2024-01-22,Senate,"Senate: Reported from Courts of Justice with substitute (9-Y 6-N)",9,6,0,0,15
1796969,1372837,2024-01-31,Senate,"Senate: Reported from Finance and Appropriations (10-Y 5-N)",10,5,0,0,15
1796969,1374277,2024-02-01,Senate,"Senate: Constitutional reading dispensed (40-Y 0-N)",40,0,0,0,40
1796969,1376029,2024-02-05,Senate,"Senate: Read third time and passed Senate (21-Y 19-N)",21,19,0,0,40
1796969,1386485,2024-02-16,House,"House: Reported from Public Safety (12-Y 10-N)",12,10,0,0,22
1796969,1389943,2024-02-21,House,"House: VOTE: Passage (52-Y 48-N)",52,48,0,0,100
1796978,1367449,2024-01-22,House,"House: Subcommittee recommends reporting with amendments (7-Y 0-N)",7,0,0,2,9
1796978,1369999,2024-01-26,House,"House: Reported from Courts of Justice (21-Y 0-N)",21,0,0,1,22
1796978,1370228,2024-01-26,House,"House: Reported from Courts of Justice with amendment(s) (21-Y 0-N)",21,0,0,1,22
1796978,1373633,2024-02-01,House,"House: VOTE: Block Vote Passage (99-Y 0-N)",99,0,0,1,100
1796978,1390892,2024-02-21,Senate,"Senate: Reported from Courts of Justice with amendment (8-Y 7-N)",8,7,0,0,15
1796978,1393938,2024-02-23,Senate,"Senate: Constitutional reading dispensed (38-Y 0-N)",38,0,0,2,40
1796978,1396229,2024-02-27,Senate,"Senate: Defeated by Senate (19-Y 20-N)",19,20,0,1,40
1796990,1367168,2024-01-22,Senate,"Senate: Reported from Courts of Justice (9-Y 6-N)",9,6,0,0,15
1796990,1372817,2024-01-31,Senate,"Senate: Reported from Finance and Appropriations with substitute (10-Y 5-N)",10,5,0,0,15
1796990,1374248,2024-02-01,Senate,"Senate: Constitutional reading dispensed (40-Y 0-N)",40,0,0,0,40
1796990,1375910,2024-02-05,Senate,"Senate: Read third time and passed Senate (21-Y 19-N)",21,19,0,0,40
1796990,1386863,2024-02-16,House,"House: Reported from Public Safety with substitute (12-Y 10-N)",12,10,0,0,22
1796990,1390756,2024-02-21,House,"House: VOTE: Passage (52-Y 48-N)",52,48,0,0,100
1796990,1393795,2024-02-23,Senate,"Senate: House substitute agreed to by Senate (21-Y 18-N)",21,18,0,1,40
1796990,1430277,2024-04-17,Senate,"Senate: Passed in enrolled form rejected (21-Y 19-N)",21,19,0,0,40
1796997,1377454,2024-02-06,Senate,"Senate: Continued to 2025 in Finance and Appropriations (15-Y 0-N)",15,0,0,0,15
1797014,1364017,2024-01-11,Senate,"Senate: Reported from Education and Health (15-Y 0-N)",15,0,0,0,15
1797014,1368426,2024-01-16,Senate,"Senate: Read third time and passed Senate (38-Y 0-N)",38,0,0,1,39
1797014,1391272,2024-02-22,House,"House: Reported from Health and Human Services (21-Y 0-N)",21,0,0,1,22
1797014,1396362,2024-02-27,House,"House: VOTE: Block Vote Passage (97-Y 0-N)",97,0,0,3,100
1797021,1379824,2024-02-08,Senate,"Senate: Continued to 2025 in Education and Health (15-Y 0-N)",15,0,0,0,15
1797028,1369650,2024-01-25,House,"House: Subcommittee recommends reporting (5-Y 3-N)",5,3,0,0,8
1797028,1372093,2024-01-30,House,"House: Reported from General Laws (12-Y 10-N)",12,10,0,0,22
1797028,1376104,2024-02-05,House,"House: VOTE: Passage (52-Y 45-N)",52,45,0,3,100
1797028,1384582,2024-02-14,Senate,"Senate: Reported from General Laws and Technology (12-Y 3-N)",12,3,0,0,15
1797028,1386834,2024-02-16,Senate,"Senate: Constitutional reading dispensed (38-Y 0-N)",38,0,0,2,40
1797028,1387949,2024-02-19,Senate,"Senate: Passed Senate (37-Y 2-N)",37,2,0,1,40
1797028,1387950,2024-02-19,Senate,"Senate: Reconsideration of Senate passage agreed to by Senate (38-Y 1-N)",38,1,0,1,40
1797028,1387951,2024-02-19,Senate,"Senate: Passed Senate (39-Y 0-N)",39,0,0,1,40
1797028,1429770,2024-04-17,House,"House: VOTE: Adoption (0-Y 99-N)",0,99,0,1,100
1797035,1377097,2024-02-06,Senate,"Senate: Passed by indefinitely in Finance and Appropriations (14-Y 1-N)",14,1,0,0,15
1797044,1382574,2024-02-12,Senate,"Senate: Reported from Courts of Justice (8-Y 5-N 1-A)",8,5,1,0,14
1797044,1383118,2024-02-13,Senate,"Senate: Constitutional reading dispensed (40-Y 0-N)",40,0,0,0,40
1797044,1383119,2024-02-13,Senate,"Senate: Passed Senate (22-Y 18-N)",22,18,0,0,40
1797044,1383120,2024-02-13,Senate,"Senate: Constitutional reading dispensed (40-Y 0-N)",40,0,0,0,40
1797044,1386973,2024-02-16,House,"House: Reported from Courts of Justice (12-Y 10-N)",12,10,0,0,22
1797044,1390580,2024-02-21,House,"House: VOTE: Passage (58-Y 42-N)",58,42,0,0,100
1797051,1370317,2024-01-29,House,"House: Subcommittee recommends laying on the table (6-Y 0-N)",6,0,0,0,6
1797058,1364418,2024-01-16,House,"House: Reported from Health and Human Services (22-Y 0-N)",22,0,0,0,22
1797058,1366882,2024-01-19,House,"House: Subcommittee recommends reporting with amendments (7-Y 0-N)",7,0,0,2,9
1797058,1368488,2024-01-24,House,"House: Reported from Appropriations with amendment(s) (22-Y 0-N)",22,0,0,0,22
1797058,1371607,2024-01-30,House,"House: VOTE: Block Vote Passage (100-Y 0-N)",100,0,0,0,100
1797058,1393214,2024-02-23,Senate,"Senate: Reported from Rehabilitation and Social Services (15-Y 0-N)",15,0,0,0,15
1797058,1394588,2024-02-26,Senate,"Senate: Constitutional reading dispensed (40-Y 0-N)",40,0,0,0,40
1797058,1395945,2024-02-27,Senate,"Senate: Passed Senate (39-Y 0-N)",39,0,0,1,40
1797066,1368150,2024-01-23,Senate,"Senate: Reported from Agriculture, Conservation and Natural Resources (15-Y 0-N)",15,0,0,0,15
1797066,1369419,2024-01-25,Senate,"Senate: Constitutional reading dispensed (40-Y 0-N)",40,0,0,0,40
1797066,1370324,2024-01-29,Senate,"Senate: Read third time and passed Senate (40-Y 0-N)",40,0,0,0,40
1797066,1390852,2024-02-21,House,"House: Subcommittee recommends reporting (5-Y 4-N)",5,4,1,0,10
1797066,1397390,2024-02-28,House,"House: Reported from Agriculture, Chesapeake and Natural Resources (12-Y 10-N)",12,10,0,0,22
1797066,1401524,2024-03-04,House,"House: VOTE: Passage (70-Y 27-N)",70,27,0,3,100
1797073,1366722,2024-01-18,Senate,"Senate: Rereferred from Transportation (12-Y 0-N)",12,0,0,0,12
1797073,1382488,2024-02-12,Senate,"Senate: Failed to report (defeated) in Courts of Justice (6-Y 8-N)",6,8,0,0,14
1797081,1366831,2024-01-18,House,"House: Subcommittee recommends reporting (8-Y 0-N)",8,0,0,0,8
1797081,1367867,2024-01-23,House,"House: Reported from Labor and Commerce (17-Y 4-N)",17,4,0,1,22
1797081,1370472,2024-01-29,House,"House: VOTE: Passage (97-Y 1-N)",97,1,0,2,100
1797081,1395195,2024-02-26,Senate,"Senate: Reported from Commerce and Labor (14-Y 0-N 1-A)",14,0,1,0,15
1797081,1398307,2024-02-28,Senate,"Senate: Constitutional reading dispensed (39-Y 0-N)",39,0,0,1,40
1797081,1399097,2024-02-29,Senate,"Senate: Passed Senate (39-Y 0-N)",39,0,0,1,40
1797088,1364024,2024-01-11,Senate,"Senate: Reported from Education and Health (15-Y 0-N)",15,0,0,0,15
1797088,1379782,2024-02-08,Senate,"Senate: Reported from Finance and Appropriations with substitute (15-Y 0-N)",15,0,0,0,15
1797088,1380817,2024-02-09,Senate,"Senate: Constitutional reading dispensed (39-Y 0-N)",39,0,0,1,40
1797088,1381506,2024-02-12,Senate,"Senate: Constitutional reading dispensed (40-Y 0-N)",40,0,0,0,40
1797088,1381507,2024-02-12,Senate,"Senate: Passed Senate (40-Y 0-N)",40,0,0,0,40
1797088,1387312,2024-02-19,House,"House: Reported from Education with substitute (14-Y 8-N)",14,8,0,0,22
1797088,1390618,2024-02-21,House,"House: Reported from Appropriations with amendment(s) (16-Y 6-N)",16,6,0,0,22
1797088,1395009,2024-02-26,House,"House: VOTE: Passage (70-Y 26-N)",70,26,0,4,100
1797088,1397982,2024-02-28,Senate,"Senate: House substitute with amendments agreed to by Senate (20-Y 19-N)",20,19,0,1,40
1797088,1429606,2024-04-17,Senate,"Senate: Senate rejected Governor's recommendation (19-Y 21-N)",19,21,0,0,40
1797095,1364295,2024-01-15,Senate,"Senate: Reported from Local Government with amendments (13-Y 0-N)",13,0,0,0,13
1797095,1432042,2024-01-16,Senate,"Senate: Constitutional reading dispensed (38-Y 0-N)",38,0,0,1,39
1797095,1432043,2024-01-18,Senate,"Senate: Read third time and passed Senate (40-Y 0-N)",40,0,0,0,40
1797095,1432044,2024-02-16,House,"House: Reported from Counties, Cities and Towns (22-Y 0-N)",22,0,0,0,22
1797095,1432045,2024-02-21,House,"House: VOTE: Block Vote Passage (100-Y 0-N)",100,0,0,0,100
1797104,1367308,2024-01-22,House,"House: Subcommittee recommends laying on the table (8-Y 0-N)",8,0,0,1,9
1797111,1371508,2024-01-30,Senate,"Senate: Passed by indefinitely in Finance and Appropriations (10-Y 5-N)",10,5,0,0,15
1797118,1368992,2024-01-25,House,"House: Subcommittee recommends reporting (6-Y 0-N)",6,0,0,0,6
1797118,1369745,2024-01-26,House,"House: Reported from Public Safety with amendment(s) (22-Y 0-N)",22,0,0,0,22
1797118,1370440,2024-01-26,House,"House: Reported from Public Safety (22-Y 0-N)",22,0,0,0,22
1797118,1372780,2024-01-31,House,"House: Subcommittee recommends reporting (7-Y 0-N)",7,0,0,2,9
1797118,1374603,2024-02-02,House,"House: Reported from Appropriations (22-Y 0-N)",22,0,0,0,22
1797118,1380131,2024-02-08,House,"House: VOTE: Block Vote Passage (98-Y 0-N)",98,0,0,2,100
1797118,1387314,2024-02-19,Senate,"Senate: Reported from Courts of Justice (14-Y 0-N)",14,0,0,0,14
1797118,1388528,2024-02-20,Senate,"Senate: Constitutional reading dispensed (39-Y 0-N)",39,0,0,1,40
1797118,1390416,2024-02-21,Senate,"Senate: Passed Senate (40-Y 0-N)",40,0,0,0,40
1797127,1366300,2024-01-17,House,"House: Subcommittee recommends reporting with amendments (8-Y 2-N)",8,2,0,0,10
1797127,1368267,2024-01-24,House,"House: Reported from Agriculture, Chesapeake and Natural Resources with amendment(s) (15-Y 7-N)",15,7,0,0,22
1797135,1367567,2024-01-22,House,"House: Subcommittee recommends reporting with substitute (9-Y 0-N)",9,0,0,1,10
1797135,1368807,2024-01-24,House,"House: Reported from Agriculture, Chesapeake and Natural Resources with substitute (22-Y 0-N)",22,0,0,0,22
1797135,1372261,2024-01-30,House,"House: VOTE: Block Vote Passage (100-Y 0-N)",100,0,0,0,100
1797135,1386836,2024-02-16,Senate,"Senate: Reported from Agriculture, Conservation and Natural Resources (14-Y 0-N)",14,0,0,0,14
1797135,1387714,2024-02-19,Senate,"Senate: Constitutional reading dispensed (38-Y 0-N)",38,0,0,2,40
1797135,1389011,2024-02-20,Senate,"Senate: Passed Senate (40-Y 0-N)",40,0,0,0,40
1797143,1364471,2024-01-16,Senate,"Senate: Continued to 2025 in Privileges and Elections (14-Y 0-N)",14,0,0,0,14
1797150,1364018,2024-01-11,Senate,"Senate: Reported from Education and Health (15-Y 0-N)",15,0,0,0,15
1797150,1379684,2024-02-08,Senate,"Senate: Reported from Finance and Appropriations with substitute (15-Y 0-N)",15,0,0,0,15
1797150,1380784,2024-02-09,Senate,"Senate: Constitutional reading dispensed (39-Y 0-N)",39,0,0,1,40
1797150,1382103,2024-02-12,Senate,"Senate: Constitutional reading dispensed (40-Y 0-N)",40,0,0,0,40
1797150,1382104,2024-02-12,Senate,"Senate: Passed Senate (40-Y 0-N)",40,0,0,0,40
1797150,1388293,2024-02-20,House,"House: Subcommittee recommends reporting with substitute (7-Y 1-N)",7,1,0,0,8
1797150,1389742,2024-02-21,House,"House: Reported from Education with substitute (22-Y 0-N)",22,0,0,0,22
1797150,1394470,2024-02-26,House,"House: VOTE: Block Vote Passage (96-Y 0-N)",96,0,0,4,100
1797150,1398253,2024-02-28,Senate,"Senate: House substitute rejected by Senate (0-Y 39-N)",0,39,0,1,40
1797150,1402274,2024-03-04,Senate,"Senate: Senate acceded to request (38-Y 0-N)",38,0,0,2,40
1797150,1406204,2024-03-08,Senate,"Senate: Conference report agreed to by Senate (40-Y 0-N)",40,0,0,0,40
1797150,1406205,2024-03-08,House,"House: VOTE: Adoption (96-Y 0-N)",96,0,0,4,100
1797150,1430284,2024-04-17,Senate,"Senate: Senate rejected Governor's recommendation (19-Y 21-N)",19,21,0,0,40
1797158,1378665,2024-02-07,Senate,"Senate: Reported from General Laws and Technology (15-Y 0-N)",15,0,0,0,15
1797158,1381383,2024-02-12,Senate,"Senate: Continued to 2025 in Finance and Appropriations (10-Y 5-N)",10,5,0,0,15
1797166,1377747,2024-02-06,House,"House: Subcommittee recommends reporting with substitute (7-Y 0-N)",7,0,0,0,7
1797166,1380104,2024-02-08,House,"House: Reported from Labor and Commerce with substitute (22-Y 0-N)",22,0,0,0,22
1797166,1380527,2024-02-09,House,"House: Subcommittee recommends reporting (7-Y 0-N)",7,0,0,2,9
1797166,1380683,2024-02-09,House,"House: Reported from Appropriations (20-Y 0-N)",20,0,0,2,22
1797166,1382847,2024-02-13,House,"House: VOTE: Block Vote Passage (99-Y 0-N)",99,0,0,1,100
1797166,1395210,2024-02-26,Senate,"Senate: Reported from Commerce and Labor (15-Y 0-N)",15,0,0,0,15
1797166,1398363,2024-02-28,Senate,"Senate: Constitutional reading dispensed (39-Y 0-N)",39,0,0,1,40
1797166,1399156,2024-02-29,Senate,"Senate: Passed Senate (39-Y 0-N)",39,0,0,1,40
1797174,1367624,2024-01-23,House,"House: Subcommittee recommends reporting with substitute (7-Y 1-N)",7,1,0,1,9
1797174,1368262,2024-01-24,House,"House: Reported from Education with substitute (13-Y 8-N)",13,8,0,1,22
1797174,1371860,2024-01-30,House,"House: VOTE: Passage (62-Y 36-N)",62,36,0,2,100
1797174,1399191,2024-02-29,Senate,"Senate: Reported from Education and Health with amendments (9-Y 6-N)",9,6,0,0,15
1797174,1400995,2024-03-01,Senate,"Senate: Constitutional reading dispensed (40-Y 0-N)",40,0,0,0,40
1797174,1401657,2024-03-04,Senate,"Senate: Passed Senate with amendments (20-Y 19-N)",20,19,0,1,40
1797174,1402759,2024-03-05,House,"House: VOTE: Adoption (66-Y 32-N)",66,32,0,2,100
1797174,1430274,2024-04-17,House,"House: VOTE: Adoption (0-Y 100-N)",0,100,0,0,100
1797284,1369221,2024-01-25,House,"House: Reported from Health and Human Services with amendment(s) (22-Y 0-N)",22,0,0,0,22
1797284,1372859,2024-01-31,House,"House: VOTE: Block Vote Passage (100-Y 0-N)",100,0,0,0,100
1797284,1385467,2024-02-15,Senate,"Senate: Reported from Education and Health (13-Y 0-N)",13,0,0,0,13
1797284,1389827,2024-02-21,Senate,"Senate: Reported from Finance and Appropriations (14-Y 0-N)",14,0,0,0,14
1797284,1391958,2024-02-22,Senate,"Senate: Constitutional reading dispensed (40-Y 0-N)",40,0,0,0,40
1797284,1393549,2024-02-23,Senate,"Senate: Passed Senate (39-Y 0-N)",39,0,0,1,40
1797347,1374890,2024-02-02,House,"House: Subcommittee recommends reporting (8-Y 0-N)",8,0,0,0,8
1797347,1374891,2024-02-02,House,"House: Reported from Counties, Cities and Towns (22-Y 0-N)",22,0,0,0,22
1797347,1380177,2024-02-08,House,"House: VOTE: Block Vote Passage (98-Y 0-N)",98,0,0,2,100
1797347,1394652,2024-02-26,Senate,"Senate: Reported from Local Government (11-Y 0-N)",11,0,0,0,11
1797347,1396322,2024-02-27,Senate,"Senate: Constitutional reading dispensed (39-Y 0-N)",39,0,0,1,40
1797347,1397815,2024-02-28,Senate,"Senate: Passed Senate (39-Y 0-N)",39,0,0,1,40
1797411,1364421,2024-01-16,House,"House: Subcommittee recommends reporting (8-Y 0-N)",8,0,0,1,9
1797411,1366134,2024-01-17,House,"House: Reported from Finance (20-Y 1-N)",20,1,0,1,22
1798472,1367644,2024-01-23,Senate,"Senate: Failed to report (defeated) in Finance and Appropriations (7-Y 7-N)",7,7,0,0,14
1798474,1380972,2024-02-09,House,"House: Stricken from docket by Privileges and Elections (22-Y 0-N)",22,0,0,0,22
1798479,1364336,2024-01-16,Senate,"Senate: Reported from Finance and Appropriations with substitute (15-Y 0-N)",15,0,0,0,15
1798479,1368691,2024-01-19,Senate,"Senate: Read third time and passed Senate (37-Y 0-N)",37,0,0,3,40
1798479,1384491,2024-02-14,House,"House: Reported from Finance with substitute (22-Y 0-N)",22,0,0,0,22
1798479,1387963,2024-02-19,House,"House: VOTE: Block Vote Passage (99-Y 0-N)",99,0,0,1,100
1798479,1390930,2024-02-21,Senate,"Senate: House substitute rejected by Senate (0-Y 40-N)",0,40,0,0,40
1798479,1395391,2024-02-26,Senate,"Senate: Senate acceded to request (40-Y 0-N)",40,0,0,0,40
1798479,1404290,2024-03-06,Senate,"Senate: Conference report agreed to by Senate (40-Y 0-N)",40,0,0,0,40
1798479,1404291,2024-03-06,House,"House: VOTE: Adoption (99-Y 0-N)",99,0,0,1,100
1798482,1369358,2024-01-25,House,"House: Subcommittee recommends reporting with substitute (8-Y 0-N)",8,0,0,0,8
1798482,1371511,2024-01-30,House,"House: Reported from Health and Human Services with substitute (22-Y 0-N)",22,0,0,0,22
1798482,1374800,2024-02-02,House,"House: Subcommittee recommends laying on the table (8-Y 0-N)",8,0,0,1,9
1798484,1367621,2024-01-23,House,"House: Subcommittee recommends reporting with amendments (7-Y 1-N)",7,1,0,1,9
1798484,1368237,2024-01-24,House,"House: Reported from Education with amendment(s) (13-Y 8-N)",13,8,0,1,22
1798484,1371620,2024-01-30,House,"House: VOTE: Passage (56-Y 44-N)",56,44,0,0,100
1798484,1391491,2024-02-22,Senate,"Senate: Reported from Education and Health with amendment (15-Y 0-N)",15,0,0,0,15
1798484,1393787,2024-02-23,Senate,"Senate: Constitutional reading dispensed (38-Y 0-N)",38,0,0,2,40
1798484,1394577,2024-02-26,Senate,"Senate: Passed Senate with amendment (38-Y 2-N)",38,2,0,0,40
1798484,1398294,2024-02-28,House,"House: VOTE: Adoption (54-Y 45-N)",54,45,0,1,100
1798489,1368477,2024-01-24,House,"House: Subcommittee recommends reporting with amendments (8-Y 0-N)",8,0,0,0,8
1798489,1371476,2024-01-30,House,"House: Reported from Transportation with amendment(s) (19-Y 3-N)",19,3,0,0,22
1798489,1375824,2024-02-05,House,"House: VOTE: Passage (56-Y 42-N)",56,42,0,2,100
1798489,1386629,2024-02-15,Senate,"Senate: Reported from Transportation with substitute (7-Y 6-N)",7,6,0,0,13
1798489,1388071,2024-02-19,Senate,"Senate: Constitutional reading dispensed (38-Y 0-N)",38,0,0,2,40
1798489,1388584,2024-02-20,Senate,"Senate: Passed Senate with substitute (23-Y 17-N)",23,17,0,0,40
1798489,1392505,2024-02-22,House,"House: VOTE: Adoption (62-Y 37-N)",62,37,0,1,100
1798496,1375856,2024-02-05,House,"House: Subcommittee recommends reporting with substitute (5-Y 3-N)",5,3,0,1,9
1798496,1381080,2024-02-09,House,"House: Reported from Courts of Justice with substitute (12-Y 10-N)",12,10,0,0,22
1798496,1383258,2024-02-13,House,"House: VOTE: Passage (51-Y 48-N)",51,48,0,1,100
1798496,1394460,2024-02-26,Senate,"Senate: Reported from Courts of Justice (13-Y 1-N)",13,1,0,0,14
1798496,1396053,2024-02-27,Senate,"Senate: Constitutional reading dispensed (39-Y 0-N)",39,0,0,1,40
1798496,1398699,2024-02-28,Senate,"Senate: Passed Senate (32-Y 6-N)",32,6,0,2,40
1798498,1364521,2024-01-16,House,"House: Subcommittee recommends reporting with amendments (8-Y 0-N)",8,0,0,0,8
1798498,1366640,2024-01-18,House,"House: Reported from General Laws with amendment(s) (22-Y 0-N)",22,0,0,0,22
1798498,1369012,2024-01-24,House,"House: VOTE: Block Vote Passage (99-Y 0-N)",99,0,0,1,100
1798498,1384522,2024-02-14,Senate,"Senate: Reported from General Laws and Technology (15-Y 0-N)",15,0,0,0,15
1798498,1396124,2024-02-27,Senate,"Senate: Constitutional reading dispensed (39-Y 0-N)",39,0,0,1,40
1798498,1396125,2024-02-27,Senate,"Senate: Reported from Finance and Appropriations (15-Y 0-N)",15,0,0,0,15
1798498,1397676,2024-02-28,Senate,"Senate: Passed Senate (39-Y 0-N)",39,0,0,1,40
1798503,1378535,2024-02-07,Senate,"Senate: Reported from Courts of Justice (15-Y 0-N)",15,0,0,0,15
1798503,1379753,2024-02-08,Senate,"Senate: Constitutional reading dispensed (40-Y 0-N)",40,0,0,0,40
1798503,1380762,2024-02-09,Senate,"Senate: Constitutional reading dispensed (40-Y 0-N)",40,0,0,0,40
1798503,1380763,2024-02-09,Senate,"Senate: Passed Senate (40-Y 0-N)",40,0,0,0,40
1798503,1386928,2024-02-16,House,"House: Reported from Courts of Justice (11-Y 9-N)",11,9,0,2,22
1798503,1389966,2024-02-21,House,"House: VOTE: Passage (54-Y 45-N)",54,45,0,1,100
1798506,1369821,2024-01-26,House,"House: Subcommittee recommends laying on the table (5-Y 3-N)",5,3,0,0,8
1798508,1366484,2024-01-18,House,"House: Subcommittee failed to recommend reporting (2-Y 4-N)",2,4,0,0,6
1798511,1368801,2024-01-24,Senate,"Senate: Incorporated by Courts of Justice ",14,0,0,0,14
1798516,1368017,2024-01-23,House,"House: Subcommittee recommends reporting with substitute (7-Y 0-N)",7,0,0,0,7
1798516,1369372,2024-01-25,House,"House: Reported from Labor and Commerce with substitute (21-Y 0-N)",21,0,0,1,22
1798519,1367987,2024-01-23,House,"House: Subcommittee recommends reporting with substitute (8-Y 0-N)",8,0,0,0,8
1798519,1369156,2024-01-25,House,"House: Reported from Health and Human Services with substitute (22-Y 0-N)",22,0,0,0,22
1798519,1373254,2024-01-31,House,"House: VOTE: Block Vote Passage (100-Y 0-N)",100,0,0,0,100
1798519,1392036,2024-02-22,Senate,"Senate: Reported from Education and Health (15-Y 0-N)",15,0,0,0,15
1798519,1393615,2024-02-23,Senate,"Senate: Constitutional reading dispensed (38-Y 0-N)",38,0,0,2,40
1798519,1395416,2024-02-26,Senate,"Senate: Passed Senate (40-Y 0-N)",40,0,0,0,40
1798526,1368666,2024-01-24,House,"House: Subcommittee recommends reporting (8-Y 0-N)",8,0,0,1,9
1798526,1371204,2024-01-29,House,"House: Reported from Appropriations (21-Y 0-N)",21,0,0,1,22
1798526,1374592,2024-02-02,House,"House: VOTE: Block Vote Passage (92-Y 0-N)",92,0,0,8,100
1798526,1388013,2024-02-19,Senate,"Senate: Rereferred from Commerce and Labor (14-Y 0-N)",14,0,0,0,14
1798526,1390232,2024-02-21,Senate,"Senate: Reported from Finance and Appropriations with substitute (14-Y 0-N)",14,0,0,0,14
1798526,1391917,2024-02-22,Senate,"Senate: Constitutional reading dispensed (40-Y 0-N)",40,0,0,0,40
1798526,1393640,2024-02-23,Senate,"Senate: Passed Senate with substitute (39-Y 0-N)",39,0,0,1,40
1798526,1396330,2024-02-27,House,"House: VOTE: Adoption (96-Y 0-N)",96,0,0,4,100
1798534,1376408,2024-02-05,Senate,"Senate: Reported from Commerce and Labor with substitute (15-Y 0-N)",15,0,0,0,15
1798534,1379706,2024-02-08,Senate,"Senate: Reported from Finance and Appropriations (15-Y 0-N)",15,0,0,0,15
1798534,1380776,2024-02-09,Senate,"Senate: Constitutional reading dispensed (39-Y 0-N)",39,0,0,1,40
1798534,1381523,2024-02-12,Senate,"Senate: Constitutional reading dispensed (40-Y 0-N)",40,0,0,0,40
1798534,1381524,2024-02-12,Senate,"Senate: Passed Senate (40-Y 0-N)",40,0,0,0,40
1798534,1389335,2024-02-20,House,"House: Reported from Labor and Commerce (22-Y 0-N)",22,0,0,0,22
1798534,1393367,2024-02-23,House,"House: VOTE: Passage (96-Y 0-N)",96,0,0,4,100
1798537,1378514,2024-02-07,House,"House: Reported from Finance with amendment(s) (21-Y 0-N)",21,0,0,1,22
1798537,1382872,2024-02-13,House,"House: VOTE: Block Vote Passage (99-Y 0-N)",99,0,0,1,100
1798537,1396100,2024-02-27,Senate,"Senate: Continued to 2025 in Finance and Appropriations (15-Y 0-N)",15,0,0,0,15
1798544,1364417,2024-01-16,House,"House: Subcommittee recommends reporting (8-Y 0-N)",8,0,0,1,9
1798544,1366132,2024-01-17,House,"House: Reported from Finance (20-Y 1-N)",20,1,0,1,22
1798544,1367724,2024-01-23,House,"House: VOTE: Passage (76-Y 22-N)",76,22,0,2,100
1798544,1368678,2024-01-23,House,"House: VOTE: Passage (76-Y 22-N)",76,22,0,2,100
1798544,1395946,2024-02-27,Senate,"Senate: Constitutional reading dispensed (39-Y 0-N)",39,0,0,1,40
1798544,1395947,2024-02-27,Senate,"Senate: Reported from Finance and Appropriations (15-Y 0-N)",15,0,0,0,15
1798544,1398736,2024-02-28,Senate,"Senate: Passed Senate (39-Y 0-N)",39,0,0,1,40
1798547,1369406,2024-01-25,House,"House: Subcommittee recommends reporting (5-Y 3-N)",5,3,0,0,8
1798549,1369957,2024-01-26,House,"House: Subcommittee recommends striking from docket (8-Y 0-N)",8,0,0,1,9
1798552,1370924,2024-01-29,House,"House: Subcommittee recommends reporting (8-Y 0-N)",8,0,0,1,9
1798552,1375634,2024-02-02,House,"House: Reported from Courts of Justice (20-Y 0-N)",20,0,0,2,22
1798552,1380190,2024-02-08,House,"House: VOTE: Block Vote Passage (98-Y 0-N)",98,0,0,2,100
1798552,1387823,2024-02-19,Senate,"Senate: Reported from Courts of Justice (11-Y 0-N)",11,0,0,0,11
1798552,1389200,2024-02-20,Senate,"Senate: Constitutional reading dispensed (39-Y 0-N)",39,0,0,1,40
1798552,1391037,2024-02-21,Senate,"Senate: Passed Senate (38-Y 2-N)",38,2,0,0,40
1798558,1373584,2024-02-01,Senate,"Senate: Reported from Education and Health (15-Y 0-N)",15,0,0,0,15
1798558,1378277,2024-02-07,Senate,"Senate: Reported from Finance and Appropriations (15-Y 0-N)",15,0,0,0,15
1798558,1379731,2024-02-08,Senate,"Senate: Constitutional reading dispensed (40-Y 0-N)",40,0,0,0,40
1798558,1380601,2024-02-09,Senate,"Senate: Constitutional reading dispensed (40-Y 0-N)",40,0,0,0,40
1798558,1380602,2024-02-09,Senate,"Senate: Read third time and passed Senate (40-Y 0-N)",40,0,0,0,40
1798558,1395551,2024-02-27,House,"House: Subcommittee recommends reporting (8-Y 0-N)",8,0,0,1,9
1798558,1395552,2024-02-27,House,"House: Reported from Health and Human Services (20-Y 1-N)",20,1,0,1,22
1798558,1400495,2024-03-01,House,"House: VOTE: Passage (92-Y 5-N)",92,5,0,3,100
1798558,1430294,2024-04-17,Senate,"Senate: Senate rejected Governor's recommendation (19-Y 21-N)",19,21,0,0,40
1798563,1368749,2024-01-24,Senate,"Senate: Rereferred from General Laws and Technology (15-Y 0-N)",15,0,0,0,15
1798563,1378265,2024-02-07,Senate,"Senate: Continued to 2025 in Finance and Appropriations (15-Y 0-N)",15,0,0,0,15
1798568,1366313,2024-01-17,House,"House: Subcommittee recommends reporting with amendments (8-Y 0-N)",8,0,0,1,9
1798568,1368845,2024-01-24,House,"House: Reported from Appropriations with amendment(s) (21-Y 0-N)",21,0,0,1,22
1798568,1371748,2024-01-30,House,"House: VOTE: Block Vote Passage (100-Y 0-N)",100,0,0,0,100
1798568,1387271,2024-02-19,Senate,"Senate: Reported from Local Government (14-Y 0-N)",14,0,0,0,14
1798568,1398209,2024-02-28,Senate,"Senate: Reported from Finance and Appropriations with substitute (14-Y 0-N)",14,0,0,0,14
1798568,1399854,2024-02-29,Senate,"Senate: Constitutional reading dispensed (39-Y 0-N)",39,0,0,1,40
1798568,1401037,2024-03-01,Senate,"Senate: Passed Senate with substitute (40-Y 0-N)",40,0,0,0,40
1798568,1402311,2024-03-04,House,"House: VOTE: Adoption (96-Y 0-N)",96,0,0,4,100
1798571,1379155,2024-02-08,House,"House: Subcommittee recommends striking from docket (7-Y 0-N)",7,0,0,1,8
1798571,1380749,2024-02-09,House,"House: Stricken from docket by Counties, Cities and Towns (21-Y 0-N)",21,0,0,1,22
1798573,1368119,2024-01-23,House,"House: Subcommittee recommends striking from docket (8-Y 0-N)",8,0,0,0,8
1798578,1369960,2024-01-26,Senate,"Senate: Reported from Rules (14-Y 0-N)",14,0,0,0,14
1798578,1371022,2024-01-29,Senate,"Senate: Constitutional reading dispensed (39-Y 0-N)",39,0,0,1,40
1798578,1373253,2024-01-31,Senate,"Senate: Read third time and passed Senate (40-Y 0-N)",40,0,0,0,40
1798578,1393272,2024-02-23,House,"House: Reported from Rules (17-Y 0-N)",17,0,0,1,18
1798578,1398663,2024-02-28,House,"House: VOTE: Block Vote Passage (97-Y 0-N)",97,0,0,3,100
1798583,1369037,2024-01-25,House,"House: Subcommittee recommends reporting with amendments (4-Y 2-N)",4,2,0,0,6
1798583,1369702,2024-01-26,House,"House: Reported from Public Safety with amendment(s) (13-Y 9-N)",13,9,0,0,22
1798583,1372770,2024-01-31,House,"House: Subcommittee recommends reporting (5-Y 3-N)",5,3,0,1,9
1798583,1374675,2024-02-02,House,"House: Reported from Appropriations (12-Y 10-N)",12,10,0,0,22
1798583,1379979,2024-02-08,House,"House: VOTE: Passage (51-Y 47-N)",51,47,0,2,100
1798583,1391066,2024-02-21,Senate,"Senate: Reported from Courts of Justice (9-Y 6-N)",9,6,0,0,15
1798583,1397730,2024-02-28,Senate,"Senate: Reported from Finance and Appropriations (10-Y 5-N)",10,5,0,0,15
1798583,1399503,2024-02-29,Senate,"Senate: Constitutional reading dispensed (39-Y 0-N)",39,0,0,1,40
1798583,1401959,2024-03-04,Senate,"Senate: Passed Senate (20-Y 19-N)",20,19,0,1,40
1798585,1367245,2024-01-22,House,"House: Subcommittee recommends reporting with substitute (7-Y 1-N)",7,1,0,1,9
1798585,1369878,2024-01-26,House,"House: Reported from Courts of Justice with substitute (15-Y 6-N)",15,6,0,1,22
1798585,1370778,2024-01-29,House,"House: Subcommittee recommends reporting with amendments (7-Y 0-N)",7,0,0,2,9
1798585,1373152,2024-01-31,House,"House: Reported from Appropriations with amendment(s) (22-Y 0-N)",22,0,0,0,22
1798585,1377229,2024-02-06,House,"House: VOTE: Passage (64-Y 35-N)",64,35,0,1,100
1798585,1387331,2024-02-19,Senate,"Senate: Reported from Courts of Justice (14-Y 0-N)",14,0,0,0,14
1798585,1388549,2024-02-20,Senate,"Senate: Constitutional reading dispensed (39-Y 0-N)",39,0,0,1,40
1798585,1390388,2024-02-21,Senate,"Senate: Passed Senate (40-Y 0-N)",40,0,0,0,40
1798585,1430127,2024-04-17,House,"House: VOTE: Adoption (0-Y 100-N)",0,100,0,0,100
1798590,1374942,2024-02-02,House,"House: Subcommittee recommends striking from docket (8-Y 0-N)",8,0,0,0,8
1798592,1370359,2024-01-29,House,"House: Subcommittee recommends laying on the table (6-Y 0-N)",6,0,0,0,6
1798597,1374340,2024-02-01,House,"House: Reported from Rules (17-Y 0-N)",17,0,0,1,18
1798597,1378228,2024-02-07,House,"House: VOTE: Adoption (99-Y 0-N)",99,0,0,1,100
1798597,1395420,2024-02-26,Senate,"Senate: Reading waived (40-Y 0-N)",40,0,0,0,40
1798600,1372081,2024-01-30,House,"House: Subcommittee recommends reporting with substitute (7-Y 0-N)",7,0,0,0,7
1798600,1374165,2024-02-01,House,"House: Reported from Labor and Commerce with substitute (22-Y 0-N)",22,0,0,0,22
1798600,1378632,2024-02-07,House,"House: VOTE: Block Vote Passage (100-Y 0-N)",100,0,0,0,100
1798600,1387609,2024-02-19,Senate,"Senate: Reported from Commerce and Labor (15-Y 0-N)",15,0,0,0,15
1798600,1389868,2024-02-21,Senate,"Senate: Constitutional reading dispensed (40-Y 0-N)",40,0,0,0,40
1798600,1392175,2024-02-22,Senate,"Senate: Passed Senate (40-Y 0-N)",40,0,0,0,40
1798602,1367790,2024-01-23,House,"House: Subcommittee recommends reporting (8-Y 0-N)",8,0,0,0,8
1798602,1369183,2024-01-25,House,"House: Reported from Health and Human Services (22-Y 0-N)",22,0,0,0,22
1798602,1374812,2024-02-02,House,"House: Subcommittee recommends reporting (8-Y 0-N)",8,0,0,1,9
1798602,1375774,2024-02-05,House,"House: Reported from Appropriations (21-Y 0-N)",21,0,0,1,22
1798602,1380542,2024-02-09,House,"House: VOTE: Passage (96-Y 0-N)",96,0,0,4,100
1798602,1391489,2024-02-22,Senate,"Senate: Reported from Education and Health with amendment (15-Y 0-N)",15,0,0,0,15
1798602,1399402,2024-02-29,Senate,"Senate: Reported from Finance and Appropriations with amendment (14-Y 0-N)",14,0,0,0,14
1798602,1401912,2024-03-04,Senate,"Senate: Constitutional reading dispensed (40-Y 0-N)",40,0,0,0,40
1798602,1403006,2024-03-05,Senate,"Senate: Passed Senate with amendments (40-Y 0-N)",40,0,0,0,40
1798602,1404223,2024-03-06,House,"House: VOTE: Adoption (97-Y 0-N)",97,0,0,3,100
1798602,1404224,2024-03-06,House,"House: VOTE: REJECTED (0-Y 98-N)",0,98,0,2,100
1798602,1405073,2024-03-07,Senate,"Senate: Senate insisted on amendment (40-Y 0-N)",40,0,0,0,40
1798602,1406397,2024-03-08,Senate,"Senate: Conference report agreed to by Senate (40-Y 0-N)",40,0,0,0,40
1798602,1406398,2024-03-08,House,"House: VOTE: Adoption (95-Y 0-N)",95,0,0,5,100
1798606,1367971,2024-01-23,House,"House: Subcommittee recommends reporting (6-Y 2-N)",6,2,0,0,8
1798606,1369189,2024-01-25,House,"House: Reported from Health and Human Services (15-Y 7-N)",15,7,0,0,22
1798606,1373243,2024-01-31,House,"House: VOTE: Passage (63-Y 35-N)",63,35,0,2,100
1798606,1399833,2024-02-29,Senate,"Senate: Reported from Education and Health (13-Y 2-N)",13,2,0,0,15
1798606,1400959,2024-03-01,Senate,"Senate: Constitutional reading dispensed (40-Y 0-N)",40,0,0,0,40
1798606,1402228,2024-03-04,Senate,"Senate: Passed Senate (39-Y 0-N)",39,0,0,1,40
1798609,1364315,2024-01-15,House,"House: Stricken from docket by Courts of Justice (22-Y 0-N)",22,0,0,0,22
1798622,1373898,2024-02-01,House,"House: Subcommittee recommends reporting with substitute (7-Y 2-N)",7,2,0,1,10
1798622,1374701,2024-02-02,House,"House: Reported from Public Safety with substitute (12-Y 10-N)",12,10,0,0,22
1798638,1368287,2024-01-24,House,"House: Subcommittee recommends reporting with substitute (10-Y 0-N)",10,0,0,0,10
1798638,1368288,2024-01-24,House,"House: Subcommittee recommends reporting with substitute (10-Y 0-N)",10,0,0,0,10
1798638,1372406,2024-01-31,House,"House: Reported from Agriculture, Chesapeake and Natural Resources with substitute (22-Y 0-N)",22,0,0,0,22
1798638,1378355,2024-02-07,House,"House: Subcommittee recommends reporting (8-Y 0-N)",8,0,0,1,9
1798638,1378356,2024-02-07,House,"House: Reported from Appropriations (22-Y 0-N)",22,0,0,0,22
1798638,1383434,2024-02-13,House,"House: VOTE: Block Vote Passage (99-Y 0-N)",99,0,0,1,100
1798638,1396775,2024-02-27,Senate,"Senate: Reported from Agriculture, Conservation and Natural Resources (14-Y 0-N)",14,0,0,0,14
1798638,1399968,2024-02-29,Senate,"Senate: Reported from Finance and Appropriations with substitute (14-Y 0-N)",14,0,0,0,14
1798638,1401817,2024-03-04,Senate,"Senate: Constitutional reading dispensed (40-Y 0-N)",40,0,0,0,40
1798638,1402920,2024-03-05,Senate,"Senate: Passed Senate with substitute (40-Y 0-N)",40,0,0,0,40
1798638,1404184,2024-03-06,House,"House: VOTE: REJECTED (1-Y 96-N)",1,96,0,3,100
1798638,1405701,2024-03-07,Senate,"Senate: Senate insisted on substitute (40-Y 0-N)",40,0,0,0,40
1798638,1406675,2024-03-09,House,"House: VOTE: Adoption (98-Y 0-N)",98,0,0,2,100
1798638,1406676,2024-03-09,Senate,"Senate: Conference report agreed to by Senate (40-Y 0-N)",40,0,0,0,40
1798645,1367108,2024-01-19,House,"House: Subcommittee recommends reporting with amendments (8-Y 0-N)",8,0,0,1,9
1798645,1370007,2024-01-26,House,"House: Reported from Courts of Justice with amendment(s) (21-Y 0-N)",21,0,0,1,22
1798645,1370777,2024-01-29,House,"House: Subcommittee recommends reporting (6-Y 0-N)",6,0,1,2,9
1798645,1372771,2024-01-31,House,"House: Reported from Appropriations (21-Y 0-N)",21,0,0,1,22
1798645,1377381,2024-02-06,House,"House: VOTE: Block Vote Passage (99-Y 0-N)",99,0,0,1,100
1798645,1390671,2024-02-21,Senate,"Senate: Reported from Courts of Justice (15-Y 0-N)",15,0,0,0,15
1798645,1396113,2024-02-27,Senate,"Senate: Constitutional reading dispensed (39-Y 0-N)",39,0,0,1,40
1798645,1396114,2024-02-27,Senate,"Senate: Reported from Finance and Appropriations (15-Y 0-N)",15,0,0,0,15
1798645,1397675,2024-02-28,Senate,"Senate: Passed Senate (39-Y 0-N)",39,0,0,1,40
1798652,1367106,2024-01-19,House,"House: Stricken from docket by Courts of Justice (22-Y 0-N)",22,0,0,0,22
1798661,1366429,2024-01-17,House,"House: Subcommittee failed to recommend reporting (2-Y 8-N)",2,8,0,0,10
1798667,1373541,2024-02-01,House,"House: Subcommittee recommends reporting with amendments (8-Y 0-N)",8,0,0,0,8
1798667,1377429,2024-02-06,House,"House: Reported from Health and Human Services with amendment(s) (22-Y 0-N)",22,0,0,0,22
1798667,1382270,2024-02-12,House,"House: VOTE: Block Vote Passage (100-Y 0-N)",100,0,0,0,100
1798667,1391475,2024-02-22,Senate,"Senate: Reported from Education and Health with amendment (14-Y 0-N)",14,0,0,0,14
1798667,1393927,2024-02-23,Senate,"Senate: Constitutional reading dispensed (38-Y 0-N)",38,0,0,2,40
1798667,1394618,2024-02-26,Senate,"Senate: Passed Senate with amendment (40-Y 0-N)",40,0,0,0,40
1798667,1398270,2024-02-28,House,"House: VOTE: Adoption (100-Y 0-N)",100,0,0,0,100
1798673,1366587,2024-01-18,House,"House: Subcommittee recommends reporting (8-Y 0-N)",8,0,0,0,8
1798673,1366963,2024-01-19,House,"House: Reported from Counties, Cities and Towns (22-Y 0-N)",22,0,0,0,22
1798673,1373170,2024-01-31,House,"House: VOTE: Block Vote Passage (100-Y 0-N)",100,0,0,0,100
1798673,1387277,2024-02-19,Senate,"Senate: Reported from Local Government (15-Y 0-N)",15,0,0,0,15
1798673,1389407,2024-02-20,Senate,"Senate: Constitutional reading dispensed (39-Y 0-N)",39,0,0,1,40
1798673,1390745,2024-02-21,Senate,"Senate: Passed Senate (40-Y 0-N)",40,0,0,0,40
1798682,1370014,2024-01-26,House,"House: Subcommittee recommends reporting with substitute (8-Y 0-N)",8,0,0,1,9
1798682,1375889,2024-02-02,House,"House: Reported from Courts of Justice with substitute (21-Y 0-N)",21,0,0,1,22
1798682,1379734,2024-02-08,House,"House: VOTE: Block Vote Passage (98-Y 0-N)",98,0,0,2,100
1798682,1398847,2024-02-28,Senate,"Senate: Reported from Courts of Justice with amendment (15-Y 0-N)",15,0,0,0,15
1798682,1401034,2024-03-01,Senate,"Senate: Constitutional reading dispensed (40-Y 0-N)",40,0,0,0,40
1798682,1402124,2024-03-04,Senate,"Senate: Passed Senate with amendment (39-Y 0-N)",39,0,0,1,40
1798682,1403363,2024-03-05,House,"House: VOTE: Adoption (97-Y 3-N)",97,3,0,0,100
1798690,1364422,2024-01-16,House,"House: Subcommittee recommends reporting with amendments (5-Y 3-N)",5,3,0,1,9
1798690,1368469,2024-01-24,House,"House: Reported from Finance with amendment(s) (22-Y 0-N)",22,0,0,0,22
1798690,1371622,2024-01-30,House,"House: VOTE: Block Vote Passage (100-Y 0-N)",100,0,0,0,100
1798690,1387388,2024-02-19,Senate,"Senate: Reported from Local Government (15-Y 0-N)",15,0,0,0,15
1798690,1388651,2024-02-20,Senate,"Senate: Constitutional reading dispensed (39-Y 0-N)",39,0,0,1,40
1798690,1390590,2024-02-21,Senate,"Senate: Passed Senate (40-Y 0-N)",40,0,0,0,40
1798701,1367112,2024-01-19,House,"House: Subcommittee recommends laying on the table (5-Y 3-N)",5,3,0,1,9
1798709,1366745,2024-01-18,House,"House: Subcommittee recommends reporting with amendments (8-Y 0-N)",8,0,0,0,8
1798709,1367954,2024-01-23,House,"House: Reported from General Laws with amendment(s) (21-Y 0-N)",21,0,0,1,22
1798709,1371251,2024-01-29,House,"House: VOTE: Block Vote Passage (98-Y 0-N)",98,0,0,2,100
1798709,1385052,2024-02-14,Senate,"Senate: Reported from General Laws and Technology (13-Y 0-N)",13,0,0,0,13
1798709,1386669,2024-02-16,Senate,"Senate: Constitutional reading dispensed (38-Y 0-N)",38,0,0,2,40
1798709,1387448,2024-02-19,Senate,"Senate: Passed Senate (39-Y 0-N)",39,0,0,1,40
1798717,1366608,2024-01-18,House,"House: Subcommittee recommends reporting with amendments (5-Y 3-N)",5,3,0,0,8
1798717,1368052,2024-01-23,House,"House: Reported from Labor and Commerce with amendment(s) (13-Y 7-N)",13,7,0,2,22
1798724,1376798,2024-02-06,House,"House: Subcommittee recommends reporting with amendments (8-Y 0-N)",8,0,0,0,8
1798724,1378194,2024-02-07,House,"House: Reported from Education with amendment(s) (22-Y 0-N)",22,0,0,0,22
1798724,1383176,2024-02-13,House,"House: VOTE: Block Vote Passage (99-Y 0-N)",99,0,0,1,100
1798724,1399182,2024-02-29,Senate,"Senate: Reported from Education and Health (15-Y 0-N)",15,0,0,0,15
1798724,1401013,2024-03-01,Senate,"Senate: Constitutional reading dispensed (40-Y 0-N)",40,0,0,0,40
1798724,1401698,2024-03-04,Senate,"Senate: Passed Senate (39-Y 0-N)",39,0,0,1,40
1798732,1379436,2024-02-08,House,"House: Subcommittee recommends reporting with amendments (7-Y 0-N)",7,0,0,1,8
1798732,1380242,2024-02-08,House,"House: Reported from General Laws with amendment(s) (20-Y 0-N)",20,0,0,2,22
1798732,1383573,2024-02-13,House,"House: VOTE: Block Vote Passage (99-Y 0-N)",99,0,0,1,100
1798732,1390795,2024-02-21,Senate,"Senate: Reported from General Laws and Technology (15-Y 0-N)",15,0,0,0,15
1798732,1395885,2024-02-27,Senate,"Senate: Continued to 2025 in Finance and Appropriations (15-Y 0-N)",15,0,0,0,15
1798732,1401820,2024-03-04,Senate,"Senate: Reported from Finance and Appropriations with substitute (15-Y 0-N)",15,0,0,0,15
1798732,1402869,2024-03-05,Senate,"Senate: Constitutional reading dispensed (39-Y 0-N)",39,0,0,1,40
1798732,1404156,2024-03-06,Senate,"Senate: Passed Senate with substitute (40-Y 0-N)",40,0,0,0,40
1798732,1405662,2024-03-07,House,"House: VOTE: REJECTED (0-Y 99-N)",0,99,0,1,100
1798732,1405663,2024-03-07,Senate,"Senate: Senate insisted on substitute (40-Y 0-N)",40,0,0,0,40
1798732,1406346,2024-03-08,Senate,"Senate: Conference report agreed to by Senate (40-Y 0-N)",40,0,0,0,40
1798732,1406347,2024-03-08,House,"House: VOTE: Adoption (99-Y 0-N)",99,0,0,1,100
1798732,1429767,2024-04-17,House,"House: VOTE: (100-Y 0-N)",100,0,0,0,100
1798732,1429768,2024-04-17,Senate,"Senate: Senate concurred in Governor's recommendation (40-Y 0-N)",40,0,0,0,40
1798739,1376245,2024-02-05,House,"House: Subcommittee recommends reporting with substitute (5-Y 3-N)",5,3,0,1,9
1798739,1380850,2024-02-09,House,"House: Reported from Courts of Justice with substitute (12-Y 9-N)",12,9,0,1,22
1798739,1383003,2024-02-13,House,"House: VOTE: Passage (56-Y 42-N)",56,42,0,2,100
1798739,1398420,2024-02-28,Senate,"Senate: Reported from Courts of Justice with substitute (7-Y 5-N)",7,5,0,0,12
1798739,1401016,2024-03-01,Senate,"Senate: Constitutional reading dispensed (40-Y 0-N)",40,0,0,0,40
1798739,1401634,2024-03-04,Senate,"Senate: Passed Senate with substitute (20-Y 19-N)",20,19,0,1,40
1798739,1402765,2024-03-05,House,"House: VOTE: REJECTED (1-Y 99-N)",1,99,0,0,100
1798739,1404112,2024-03-06,Senate,"Senate: Senate insisted on substitute (40-Y 0-N)",40,0,0,0,40
1798739,1406662,2024-03-09,House,"House: VOTE: Adoption (51-Y 46-N)",51,46,0,3,100
1798739,1406663,2024-03-09,Senate,"Senate: Conference report agreed to by Senate (21-Y 19-N)",21,19,0,0,40
1798755,1373966,2024-02-01,House,"House: Subcommittee recommends reporting with substitute (7-Y 0-N)",7,0,0,1,8
1798755,1377265,2024-02-06,House,"House: Reported from Health and Human Services with substitute (21-Y 1-N)",21,1,0,0,22
1798755,1378640,2024-02-07,House,"House: Subcommittee recommends laying on the table (7-Y 0-N)",7,0,0,2,9
1798762,1372248,2024-01-30,House,"House: Subcommittee recommends reporting with substitute (8-Y 0-N)",8,0,0,0,8
1798762,1374290,2024-02-01,House,"House: Reported from General Laws with substitute (22-Y 0-N)",22,0,0,0,22
1798762,1378675,2024-02-07,House,"House: VOTE: Block Vote Passage (100-Y 0-N)",100,0,0,0,100
1798762,1384561,2024-02-14,Senate,"Senate: Reported from General Laws and Technology with amendments (15-Y 0-N)",15,0,0,0,15
1798762,1386810,2024-02-16,Senate,"Senate: Constitutional reading dispensed (38-Y 0-N)",38,0,0,2,40
1798762,1387673,2024-02-19,Senate,"Senate: Passed Senate (39-Y 0-N)",39,0,0,1,40
1798762,1389985,2024-02-21,House,"House: VOTE: Adoption (99-Y 0-N)",99,0,0,1,100
1798770,1370973,2024-01-29,House,"House: Subcommittee recommends reporting with amendments (10-Y 0-N)",10,0,0,0,10
1798770,1373075,2024-01-31,House,"House: Reported from Agriculture, Chesapeake and Natural Resources with substitute (21-Y 1-N)",21,1,0,0,22
1798770,1377380,2024-02-06,House,"House: VOTE: Passage (90-Y 9-N)",90,9,0,1,100
1798770,1389584,2024-02-20,Senate,"Senate: Reported from Agriculture, Conservation and Natural Resources (15-Y 0-N)",15,0,0,0,15
1798770,1392923,2024-02-22,Senate,"Senate: Constitutional reading dispensed (40-Y 0-N)",40,0,0,0,40
1798770,1394107,2024-02-23,Senate,"Senate: Passed Senate (39-Y 0-N)",39,0,0,1,40
1798781,1368028,2024-01-23,House,"House: Subcommittee recommends reporting with amendments (10-Y 0-N)",10,0,0,0,10
1798781,1369399,2024-01-25,House,"House: Reported from Labor and Commerce with amendment(s) (21-Y 0-N)",21,0,0,1,22
1798781,1372481,2024-01-31,House,"House: VOTE: Block Vote Passage (100-Y 0-N)",100,0,0,0,100
1798781,1401886,2024-03-04,Senate,"Senate: Reported from Commerce and Labor with amendment (12-Y 0-N)",12,0,0,0,12
1798781,1402955,2024-03-05,Senate,"Senate: Constitutional reading dispensed (40-Y 0-N)",40,0,0,0,40
1798781,1404210,2024-03-06,Senate,"Senate: Passed Senate with amendment (40-Y 0-N)",40,0,0,0,40
1798781,1405734,2024-03-07,House,"House: VOTE: Adoption (99-Y 0-N)",99,0,0,1,100
1798788,1367768,2024-01-23,House,"House: Subcommittee recommends striking from docket (8-Y 0-N)",8,0,0,0,8
1798788,1369486,2024-01-25,House,"House: Stricken from docket by Transportation (21-Y 0-N)",21,0,0,1,22
1798797,1366590,2024-01-18,House,"House: Subcommittee failed to recommend reporting (3-Y 5-N)",3,5,0,0,8
1798806,1375656,2024-02-05,House,"House: Subcommittee recommends reporting with substitute (8-Y 0-N)",8,0,0,1,9
1798806,1378836,2024-02-07,House,"House: Reported from Courts of Justice with substitute (22-Y 0-N)",22,0,0,0,22
1798806,1380670,2024-02-09,House,"House: Subcommittee recommends reporting (7-Y 0-N)",7,0,0,2,9
1798806,1380671,2024-02-09,House,"House: Reported from Appropriations (20-Y 0-N)",20,0,0,2,22
1798806,1383729,2024-02-13,House,"House: VOTE: Block Vote Passage (99-Y 0-N)",99,0,0,1,100
1798806,1391076,2024-02-21,Senate,"Senate: Reported from Courts of Justice with amendment (13-Y 2-N)",13,2,0,0,15
1798806,1396134,2024-02-27,Senate,"Senate: Constitutional reading dispensed (39-Y 0-N)",39,0,0,1,40
1798806,1396135,2024-02-27,Senate,"Senate: Reported from Finance and Appropriations with substitute (15-Y 0-N)",15,0,0,0,15
1798806,1398773,2024-02-28,Senate,"Senate: Committee substitute agreed to 24108305D-S1 (20-Y 19-N)",20,19,0,1,40
1798806,1398774,2024-02-28,Senate,"Senate: Passed Senate with substitute (39-Y 0-N)",39,0,0,1,40
1798806,1400717,2024-03-01,House,"House: VOTE: REJECTED (1-Y 94-N)",1,94,0,5,100
1798806,1403725,2024-03-05,Senate,"Senate: Senate insisted on substitute (40-Y 0-N)",40,0,0,0,40
1798806,1406457,2024-03-08,Senate,"Senate: Conference report agreed to by Senate (40-Y 0-N)",40,0,0,0,40
1798806,1406458,2024-03-08,House,"House: VOTE: Adoption (99-Y 0-N)",99,0,0,1,100
1798823,1366491,2024-01-18,House,"House: Reported from Health and Human Services (18-Y 4-N)",18,4,0,0,22
1798823,1369284,2024-01-25,House,"House: VOTE: Passage Emergency (98-Y 0-N)",98,0,0,2,100
1798823,1385447,2024-02-15,Senate,"Senate: Reported from Education and Health (13-Y 0-N)",13,0,0,0,13
1798823,1386914,2024-02-16,Senate,"Senate: Constitutional reading dispensed (38-Y 0-N)",38,0,0,2,40
1798823,1387669,2024-02-19,Senate,"Senate: Passed Senate (39-Y 0-N)",39,0,0,1,40
1798828,1368948,2024-01-24,House,"House: Subcommittee recommends reporting (8-Y 0-N)",8,0,0,0,8
1798828,1371853,2024-01-30,House,"House: Reported from Transportation (21-Y 1-N)",21,1,0,0,22
1798828,1376015,2024-02-05,House,"House: VOTE: Passage (93-Y 5-N)",93,5,0,2,100
1798828,1386423,2024-02-15,Senate,"Senate: Reported from Transportation (12-Y 3-N)",12,3,0,0,15
1798828,1387580,2024-02-19,Senate,"Senate: Constitutional reading dispensed (38-Y 0-N)",38,0,0,2,40
1798828,1388422,2024-02-20,Senate,"Senate: Passed Senate (33-Y 7-N)",33,7,0,0,40
1798837,1368219,2024-01-24,House,"House: Subcommittee recommends reporting (5-Y 3-N)",5,3,0,0,8
1798846,1367294,2024-01-22,House,"House: Subcommittee recommends reporting (8-Y 0-N)",8,0,0,1,9
1798846,1369892,2024-01-26,House,"House: Reported from Courts of Justice (21-Y 0-N)",21,0,0,1,22
1798846,1373702,2024-02-01,House,"House: VOTE: Block Vote Passage (99-Y 0-N)",99,0,0,1,100
1798846,1384451,2024-02-14,Senate,"Senate: Reported from Courts of Justice (9-Y 0-N)",9,0,0,0,9
1798846,1386598,2024-02-16,Senate,"Senate: Constitutional reading dispensed (38-Y 0-N)",38,0,0,2,40
1798846,1387889,2024-02-19,Senate,"Senate: Passed Senate (39-Y 0-N)",39,0,0,1,40
1798855,1373593,2024-02-01,House,"House: Subcommittee recommends laying on the table (5-Y 3-N)",5,3,0,0,8
1798862,1366724,2024-01-18,House,"House: Subcommittee recommends reporting (8-Y 0-N)",8,0,0,0,8
1798862,1367986,2024-01-23,House,"House: Reported from General Laws (21-Y 0-N)",21,0,0,1,22
1798862,1371263,2024-01-29,House,"House: VOTE: Block Vote Passage (98-Y 0-N)",98,0,0,2,100
1798862,1384449,2024-02-14,Senate,"Senate: Reported from Courts of Justice (9-Y 0-N)",9,0,0,0,9
1798862,1386883,2024-02-16,Senate,"Senate: Constitutional reading dispensed (38-Y 0-N)",38,0,0,2,40
1798862,1387769,2024-02-19,Senate,"Senate: Passed Senate (39-Y 0-N)",39,0,0,1,40
1798873,1369605,2024-01-25,House,"House: Subcommittee recommends laying on the table (6-Y 4-N)",6,4,0,0,10
1798881,1367163,2024-01-22,House,"House: Subcommittee recommends laying on the table (5-Y 3-N)",5,3,0,1,9
1798889,1369830,2024-01-26,House,"House: Subcommittee recommends reporting with substitute (8-Y 0-N)",8,0,0,1,9
1798889,1375569,2024-02-02,House,"House: Reported from Courts of Justice with substitute (21-Y 0-N)",21,0,0,1,22
1798889,1379856,2024-02-08,House,"House: VOTE: Block Vote Passage (98-Y 0-N)",98,0,0,2,100
1798889,1398733,2024-02-28,Senate,"Senate: Reported from Courts of Justice with substitute (15-Y 0-N)",15,0,0,0,15
1798889,1401044,2024-03-01,Senate,"Senate: Constitutional reading dispensed (40-Y 0-N)",40,0,0,0,40
1798889,1401701,2024-03-04,Senate,"Senate: Passed Senate with substitute (39-Y 0-N)",39,0,0,1,40
1798889,1402807,2024-03-05,House,"House: VOTE: Adoption (100-Y 0-N)",100,0,0,0,100
1798899,1367827,2024-01-23,House,"House: Subcommittee recommends striking from docket (7-Y 0-N)",7,0,0,1,8
1798899,1369449,2024-01-25,House,"House: Stricken from docket by Transportation (20-Y 0-N)",20,0,0,2,22
1798913,1370989,2024-01-29,House,"House: Subcommittee recommends laying on the table (5-Y 1-N)",5,1,0,0,6
1798922,1369045,2024-01-25,House,"House: Subcommittee recommends reporting (6-Y 0-N)",6,0,0,0,6
1798922,1369959,2024-01-26,House,"House: Reported from Public Safety (22-Y 0-N)",22,0,0,0,22
1798922,1373696,2024-02-01,House,"House: VOTE: Block Vote Passage (99-Y 0-N)",99,0,0,1,100
1798922,1384458,2024-02-14,Senate,"Senate: Reported from General Laws and Technology (13-Y 0-N)",13,0,0,0,13
1798922,1397697,2024-02-28,Senate,"Senate: Reported from Finance and Appropriations (13-Y 0-N)",13,0,0,0,13
1798922,1399466,2024-02-29,Senate,"Senate: Constitutional reading dispensed (39-Y 0-N)",39,0,0,1,40
1798922,1400740,2024-03-01,Senate,"Senate: Passed Senate (40-Y 0-N)",40,0,0,0,40
1798938,1369962,2024-01-26,House,"House: Subcommittee recommends laying on the table (7-Y 1-N)",7,1,0,1,9
1798965,1366427,2024-01-17,House,"House: Subcommittee recommends reporting (8-Y 0-N)",8,0,0,1,9
1798965,1366883,2024-01-19,House,"House: Reported from Courts of Justice (22-Y 0-N)",22,0,0,0,22
1798965,1369490,2024-01-25,House,"House: VOTE: Block Vote Passage (98-Y 0-N)",98,0,0,2,100
1798965,1384322,2024-02-14,Senate,"Senate: Reported from Courts of Justice (14-Y 0-N)",14,0,0,0,14
1798965,1386609,2024-02-16,Senate,"Senate: Constitutional reading dispensed (38-Y 0-N)",38,0,0,2,40
1798965,1387454,2024-02-19,Senate,"Senate: Passed Senate (39-Y 0-N)",39,0,0,1,40
1798975,1366397,2024-01-17,House,"House: Subcommittee recommends laying on the table (5-Y 3-N)",5,3,0,1,9
1798984,1373587,2024-02-01,House,"House: Subcommittee recommends reporting (7-Y 1-N)",7,1,0,0,8
1798984,1374941,2024-02-02,House,"House: Failed to report (defeated) in Counties, Cities and Towns (10-Y 12-N)",10,12,0,0,22
1798991,1367772,2024-01-23,House,"House: Subcommittee failed to recommend reporting (3-Y 5-N)",3,5,0,1,9
1799007,1371581,2024-01-30,House,"House: Subcommittee recommends reporting with substitute (8-Y 0-N)",8,0,0,0,8
1799007,1373709,2024-02-01,House,"House: Reported from Health and Human Services with substitute (22-Y 0-N)",22,0,0,0,22
1799007,1378736,2024-02-07,House,"House: VOTE: Block Vote Passage (100-Y 0-N)",100,0,0,0,100
1799007,1385488,2024-02-15,Senate,"Senate: Reported from Education and Health (13-Y 0-N)",13,0,0,0,13
1799007,1399960,2024-02-29,Senate,"Senate: Reported from Finance and Appropriations (14-Y 0-N)",14,0,0,0,14
1799007,1401873,2024-03-04,Senate,"Senate: Constitutional reading dispensed (40-Y 0-N)",40,0,0,0,40
1799007,1403010,2024-03-05,Senate,"Senate: Passed Senate (40-Y 0-N)",40,0,0,0,40
1799016,1369328,2024-01-25,House,"House: Subcommittee recommends reporting with amendments (8-Y 0-N)",8,0,0,0,8
1799016,1372002,2024-01-30,House,"House: Reported from Labor and Commerce with amendment(s) (19-Y 3-N)",19,3,0,0,22
1799016,1376611,2024-02-05,House,"House: VOTE: Passage (74-Y 24-N)",74,24,0,2,100
1799016,1395441,2024-02-26,Senate,"Senate: Reported from Commerce and Labor with substitute (11-Y 4-N)",11,4,0,0,15
1799016,1399957,2024-02-29,Senate,"Senate: Reported from Finance and Appropriations with amendment (14-Y 0-N)",14,0,0,0,14
1799016,1401931,2024-03-04,Senate,"Senate: Constitutional reading dispensed (40-Y 0-N)",40,0,0,0,40
1799016,1403011,2024-03-05,Senate,"Senate: Passed Senate with substitute with amendment (38-Y 2-N)",38,2,0,0,40
1799016,1405089,2024-03-07,Senate,"Senate: Senate insisted on substitute with amendment (40-Y 0-N)",40,0,0,0,40
1799016,1405746,2024-03-07,House,"House: VOTE: Adoption (1-Y 97-N)",1,97,0,2,100
1799016,1406690,2024-03-09,House,"House: VOTE: Adoption (52-Y 46-N)",52,46,0,2,100
1799016,1406691,2024-03-09,Senate,"Senate: Conference report rejected by Senate (17-Y 23-N)",17,23,0,0,40
1799016,1406692,2024-03-09,Senate,"Senate: Reconsideration of conference report agreed to by Senate (39-Y 0-N)",39,0,0,1,40
1799016,1406693,2024-03-09,Senate,"Senate: Conference report rejected by Senate (19-Y 19-N)",19,19,0,2,40
1799024,1366360,2024-01-17,House,"House: Subcommittee recommends reporting (8-Y 0-N)",8,0,0,1,9
1799024,1366957,2024-01-19,House,"House: Reported from Courts of Justice (22-Y 0-N)",22,0,0,0,22
1799024,1374793,2024-02-02,House,"House: Subcommittee recommends reporting with amendments (8-Y 0-N)",8,0,0,1,9
1799024,1375757,2024-02-05,House,"House: Reported from Appropriations with amendment(s) (20-Y 1-N)",20,1,0,1,22
1799024,1380898,2024-02-09,House,"House: VOTE: Passage (96-Y 0-N)",96,0,0,4,100
1799024,1387337,2024-02-19,Senate,"Senate: Reported from Courts of Justice (13-Y 0-N)",13,0,0,0,13
1799024,1399406,2024-02-29,Senate,"Senate: Reported from Finance and Appropriations with substitute (14-Y 0-N)",14,0,0,0,14
1799024,1401852,2024-03-04,Senate,"Senate: Constitutional reading dispensed (40-Y 0-N)",40,0,0,0,40
1799024,1402985,2024-03-05,Senate,"Senate: Passed Senate with substitute (40-Y 0-N)",40,0,0,0,40
1799024,1404201,2024-03-06,House,"House: VOTE: Adoption (95-Y 0-N)",95,0,0,5,100
1799024,1430168,2024-04-17,House,"House: VOTE: (100-Y 0-N)",100,0,0,0,100
1799024,1430169,2024-04-17,Senate,"Senate: Senate concurred in Governor's recommendation (40-Y 0-N)",40,0,0,0,40
1799032,1366557,2024-01-18,House,"House: Subcommittee failed to recommend reporting (2-Y 4-N)",2,4,0,0,6
1799039,1371055,2024-01-29,House,"House: Subcommittee recommends reporting (8-Y 0-N)",8,0,0,0,8
1799039,1374648,2024-02-02,House,"House: Reported from Privileges and Elections (21-Y 1-N)",21,1,0,0,22
1799039,1379730,2024-02-08,House,"House: VOTE: Passage (58-Y 37-N)",58,37,0,5,100
1799039,1396496,2024-02-27,Senate,"Senate: Reported from Privileges and Elections with substitute (10-Y 5-N)",10,5,0,0,15
1799039,1399600,2024-02-29,Senate,"Senate: Constitutional reading dispensed (39-Y 0-N)",39,0,0,1,40
1799039,1402168,2024-03-04,Senate,"Senate: Passed Senate with substitute (22-Y 17-N)",22,17,0,1,40
1799039,1403302,2024-03-05,House,"House: VOTE: Adoption (63-Y 37-N)",63,37,0,0,100
1799049,1366311,2024-01-17,House,"House: Subcommittee recommends reporting (8-Y 0-N)",8,0,0,1,9
1799049,1366900,2024-01-19,House,"House: Reported from Courts of Justice (22-Y 0-N)",22,0,0,0,22
1799049,1369602,2024-01-25,House,"House: VOTE: Block Vote Passage (98-Y 0-N)",98,0,0,2,100
1799049,1387363,2024-02-19,Senate,"Senate: Reported from Courts of Justice (11-Y 0-N)",11,0,0,0,11
1799049,1388444,2024-02-20,Senate,"Senate: Constitutional reading dispensed (39-Y 0-N)",39,0,0,1,40
1799049,1389968,2024-02-21,Senate,"Senate: Passed Senate (40-Y 0-N)",40,0,0,0,40
1799054,1373951,2024-02-01,House,"House: Subcommittee recommends reporting with substitute (3-Y 2-N)",3,2,0,3,8
1799054,1377286,2024-02-06,House,"House: Reported from General Laws with substitute (10-Y 9-N)",10,9,0,3,22
1799054,1382244,2024-02-12,House,"House: VOTE: Passage (51-Y 49-N)",51,49,0,0,100
1799054,1390799,2024-02-21,Senate,"Senate: Reported from General Laws and Technology with amendments (9-Y 6-N)",9,6,0,0,15
1799054,1397510,2024-02-28,Senate,"Senate: Reported from Finance and Appropriations (9-Y 5-N)",9,5,0,0,14
1799054,1399161,2024-02-29,Senate,"Senate: Constitutional reading dispensed (39-Y 0-N)",39,0,0,1,40
1799054,1401656,2024-03-04,Senate,"Senate: Passed Senate with amendments (20-Y 19-N)",20,19,0,1,40
1799054,1402758,2024-03-05,House,"House: VOTE: Adoption (51-Y 48-N)",51,48,0,1,100
1799060,1375551,2024-02-05,House,"House: Subcommittee recommends reporting (8-Y 0-N)",8,0,0,1,9
1799060,1378552,2024-02-07,House,"House: Reported from Finance (18-Y 0-N)",18,0,0,4,22
1799060,1378553,2024-02-07,House,"House: Reported from Finance (21-Y 0-N)",21,0,0,1,22
1799060,1383471,2024-02-13,House,"House: VOTE: Block Vote Passage (99-Y 0-N)",99,0,0,1,100
1799060,1396184,2024-02-27,Senate,"Senate: Passed by indefinitely in Finance and Appropriations (15-Y 0-N)",15,0,0,0,15
1799065,1373906,2024-02-01,House,"House: Subcommittee recommends reporting (6-Y 3-N)",6,3,0,1,10
1799065,1374740,2024-02-02,House,"House: Reported from Public Safety (12-Y 10-N)",12,10,0,0,22
1799065,1375738,2024-02-05,House,"House: Subcommittee recommends reporting (5-Y 3-N)",5,3,0,1,9
1799065,1380990,2024-02-09,House,"House: Reported from Courts of Justice (12-Y 10-N)",12,10,0,0,22
1799065,1383688,2024-02-13,House,"House: VOTE: Passage (50-Y 48-N)",50,48,0,2,100
1799065,1394265,2024-02-26,Senate,"Senate: Reported from Courts of Justice with amendments (8-Y 5-N)",8,5,0,0,13
1799065,1396168,2024-02-27,Senate,"Senate: Constitutional reading dispensed (39-Y 0-N)",39,0,0,1,40
1799065,1398499,2024-02-28,Senate,"Senate: Passed Senate with amendments (20-Y 19-N)",20,19,0,1,40
1799065,1400601,2024-03-01,House,"House: VOTE: Adoption (49-Y 47-N)",49,47,0,4,100
1799070,1366825,2024-01-18,House,"House: Subcommittee recommends reporting with substitute (5-Y 3-N)",5,3,0,0,8
1799070,1368018,2024-01-23,House,"House: Reported from Labor and Commerce with substitute (12-Y 9-N)",12,9,0,1,22
1799070,1372725,2024-01-31,House,"House: Subcommittee recommends reporting with substitute (5-Y 3-N)",5,3,0,1,9
1799070,1374600,2024-02-02,House,"House: Reported from Appropriations with substitute (12-Y 10-N)",12,10,0,0,22
1799070,1379585,2024-02-08,House,"House: VOTE: Passage (49-Y 47-N)",49,47,0,4,100
1799070,1395192,2024-02-26,Senate,"Senate: Reported from Commerce and Labor with amendments (9-Y 6-N)",9,6,0,0,15
1799070,1398293,2024-02-28,Senate,"Senate: Constitutional reading dispensed (39-Y 0-N)",39,0,0,1,40
1799070,1399098,2024-02-29,Senate,"Senate: Passed Senate with amendments (20-Y 19-N)",20,19,0,1,40
1799070,1401564,2024-03-04,House,"House: VOTE: Adoption (51-Y 47-N)",51,47,0,2,100
1799076,1367573,2024-01-22,House,"House: Subcommittee recommends laying on the table (5-Y 3-N)",5,3,0,0,8
1799081,1374028,2024-02-01,House,"House: Subcommittee recommends reporting with amendments (5-Y 0-N)",5,0,0,3,8
1799081,1377713,2024-02-06,House,"House: Reported from General Laws with amendment(s) (20-Y 0-N)",20,0,0,2,22
1799081,1382301,2024-02-12,House,"House: VOTE: Block Vote Passage (100-Y 0-N)",100,0,0,0,100
1799081,1390348,2024-02-21,Senate,"Senate: Reported from General Laws and Technology (15-Y 0-N)",15,0,0,0,15
1799081,1393614,2024-02-23,Senate,"Senate: Constitutional reading dispensed (38-Y 0-N)",38,0,0,2,40
1799081,1394803,2024-02-26,Senate,"Senate: Passed Senate (40-Y 0-N)",40,0,0,0,40
1799087,1378500,2024-02-07,House,"House: Subcommittee recommends reporting with amendments (8-Y 0-N)",8,0,0,0,8
1799087,1379122,2024-02-08,House,"House: Reported from Health and Human Services with amendment(s) (22-Y 0-N)",22,0,0,0,22
1799087,1383636,2024-02-13,House,"House: VOTE: Block Vote Passage (99-Y 0-N)",99,0,0,1,100
1799087,1389273,2024-02-20,Senate,"Senate: Rereferred from Privileges and Elections (13-Y 1-N)",13,1,0,0,14
1799087,1399190,2024-02-29,Senate,"Senate: Reported from Education and Health (15-Y 0-N)",15,0,0,0,15
1799087,1401006,2024-03-01,Senate,"Senate: Constitutional reading dispensed (40-Y 0-N)",40,0,0,0,40
1799087,1401749,2024-03-04,Senate,"Senate: Passed Senate (33-Y 7-N)",33,7,0,0,40
1799097,1373995,2024-02-01,House,"House: Subcommittee recommends reporting with amendments (6-Y 3-N)",6,3,0,1,10
1799097,1374714,2024-02-02,House,"House: Reported from Public Safety with amendment(s) (12-Y 10-N)",12,10,0,0,22
1799103,1369298,2024-01-25,House,"House: Subcommittee recommends reporting (8-Y 0-N)",8,0,0,0,8
1799103,1372219,2024-01-30,House,"House: Reported from General Laws (22-Y 0-N)",22,0,0,0,22
1799103,1374079,2024-02-01,House,"House: Reported from Health and Human Services (22-Y 0-N)",22,0,0,0,22
1799103,1378283,2024-02-07,House,"House: VOTE: Block Vote Passage (100-Y 0-N)",100,0,0,0,100
1799103,1393267,2024-02-23,Senate,"Senate: Reported from Rehabilitation and Social Services (15-Y 0-N)",15,0,0,0,15
1799103,1395064,2024-02-26,Senate,"Senate: Constitutional reading dispensed (40-Y 0-N)",40,0,0,0,40
1799103,1396463,2024-02-27,Senate,"Senate: Passed Senate (39-Y 0-N)",39,0,0,1,40
1799109,1372433,2024-01-31,House,"House: Subcommittee recommends reporting with substitute (10-Y 0-N)",10,0,0,0,10
1799109,1378506,2024-02-07,House,"House: Reported from Agriculture, Chesapeake and Natural Resources with substitute (22-Y 0-N)",22,0,0,0,22
1799109,1380654,2024-02-09,House,"House: Subcommittee recommends reporting (8-Y 0-N)",8,0,0,1,9
1799109,1380655,2024-02-09,House,"House: Reported from Appropriations (20-Y 0-N)",20,0,0,2,22
1799109,1382892,2024-02-13,House,"House: VOTE: Passage (89-Y 10-N)",89,10,0,1,100
1799109,1396763,2024-02-27,Senate,"Senate: Reported from Agriculture, Conservation and Natural Resources with substitute (14-Y 0-N)",14,0,0,0,14
1799109,1399372,2024-02-29,Senate,"Senate: Reported from Finance and Appropriations with substitute (14-Y 0-N)",14,0,0,0,14
1799109,1401847,2024-03-04,Senate,"Senate: Constitutional reading dispensed (40-Y 0-N)",40,0,0,0,40
1799109,1402948,2024-03-05,Senate,"Senate: Passed Senate with substitute (40-Y 0-N)",40,0,0,0,40
1799109,1404213,2024-03-06,House,"House: VOTE: REJECTED (1-Y 97-N)",1,97,0,2,100
1799109,1405074,2024-03-07,Senate,"Senate: Senate insisted on substitute (40-Y 0-N)",40,0,0,0,40
1799114,1374327,2024-02-01,House,"House: Subcommittee recommends reporting with amendments (5-Y 0-N)",5,0,0,3,8
1799114,1377321,2024-02-06,House,"House: Reported from General Laws with amendment(s) (14-Y 5-N)",14,5,1,2,22
1799114,1379176,2024-02-08,House,"House: Reported from Health and Human Services (22-Y 0-N)",22,0,0,0,22
1799114,1383336,2024-02-13,House,"House: VOTE: Passage (86-Y 13-N)",86,13,0,1,100
1799114,1389294,2024-02-20,Senate,"Senate: Rereferred from Privileges and Elections (13-Y 1-N)",13,1,0,0,14
1799114,1391419,2024-02-22,Senate,"Senate: Reported from Education and Health (10-Y 4-N)",10,4,0,0,14
1799114,1399966,2024-02-29,Senate,"Senate: Reported from Finance and Appropriations (12-Y 2-N)",12,2,0,0,14
1799114,1401838,2024-03-04,Senate,"Senate: Constitutional reading dispensed (40-Y 0-N)",40,0,0,0,40
1799114,1402952,2024-03-05,Senate,"Senate: Passed Senate (26-Y 14-N)",26,14,0,0,40
1799121,1372084,2024-01-30,House,"House: Subcommittee recommends laying on the table (7-Y 3-N)",7,3,0,0,10
1799126,1366588,2024-01-18,House,"House: Subcommittee recommends reporting (8-Y 0-N)",8,0,0,0,8
1799142,1366594,2024-01-18,House,"House: Subcommittee recommends reporting with amendments (8-Y 0-N)",8,0,0,0,8
1799142,1367990,2024-01-23,House,"House: Reported from General Laws with amendment(s) (21-Y 0-N)",21,0,0,1,22
1799142,1375642,2024-02-05,House,"House: Subcommittee recommends reporting (8-Y 0-N)",8,0,0,1,9
1799142,1375779,2024-02-05,House,"House: Reported from Appropriations (21-Y 0-N)",21,0,0,1,22
1799142,1380614,2024-02-09,House,"House: VOTE: Block Vote Passage (96-Y 0-N)",96,0,0,4,100
1799142,1399447,2024-02-29,Senate,"Senate: Reported from Finance and Appropriations with substitute (14-Y 0-N)",14,0,0,0,14
1799142,1401899,2024-03-04,Senate,"Senate: Constitutional reading dispensed (40-Y 0-N)",40,0,0,0,40
1799142,1403245,2024-03-05,Senate,"Senate: Passed Senate with substitute (40-Y 0-N)",40,0,0,0,40
1799142,1404413,2024-03-06,House,"House: VOTE: Adoption (98-Y 0-N)",98,0,0,2,100
1799142,1404414,2024-03-06,House,"House: VOTE: REJECTED #2 (0-Y 98-N)",0,98,0,2,100
1799142,1405427,2024-03-07,Senate,"Senate: Senate insisted on substitute (40-Y 0-N)",40,0,0,0,40
1799142,1406566,2024-03-08,Senate,"Senate: Conference report agreed to by Senate (40-Y 0-N)",40,0,0,0,40
1799142,1406567,2024-03-08,House,"House: VOTE: Adoption (93-Y 0-N)",93,0,0,7,100
1799147,1368517,2024-01-24,House,"House: Subcommittee recommends reporting with substitute (10-Y 0-N)",10,0,0,1,11
1799147,1372411,2024-01-31,House,"House: Reported from Agriculture, Chesapeake and Natural Resources with substitute (22-Y 0-N)",22,0,0,0,22
1799147,1377184,2024-02-06,House,"House: VOTE: Block Vote Passage (99-Y 0-N)",99,0,0,1,100
1799147,1386659,2024-02-16,Senate,"Senate: Reported from Agriculture, Conservation and Natural Resources (14-Y 0-N)",14,0,0,0,14
1799147,1387382,2024-02-19,Senate,"Senate: Constitutional reading dispensed (38-Y 0-N)",38,0,0,2,40
1799147,1388644,2024-02-20,Senate,"Senate: Passed Senate (40-Y 0-N)",40,0,0,0,40
1799155,1366295,2024-01-17,House,"House: Subcommittee recommends reporting with substitute (8-Y 0-N)",8,0,0,1,9
1799155,1367107,2024-01-19,House,"House: Reported from Courts of Justice with substitute (22-Y 0-N)",22,0,0,0,22
1799155,1369626,2024-01-25,House,"House: VOTE: Block Vote Passage (98-Y 0-N)",98,0,0,2,100
1799155,1387373,2024-02-19,Senate,"Senate: Reported from Courts of Justice (11-Y 0-N)",11,0,0,0,11
1799155,1388460,2024-02-20,Senate,"Senate: Constitutional reading dispensed (39-Y 0-N)",39,0,0,1,40
1799155,1389914,2024-02-21,Senate,"Senate: Passed Senate (40-Y 0-N)",40,0,0,0,40
1799160,1374458,2024-02-01,House,"House: Subcommittee recommends reporting with substitute (8-Y 0-N)",8,0,0,0,8
1799160,1376819,2024-02-06,House,"House: Reported from Health and Human Services with substitute (22-Y 0-N)",22,0,0,0,22
1799160,1381978,2024-02-12,House,"House: VOTE: Block Vote Passage (100-Y 0-N)",100,0,0,0,100
1799160,1399858,2024-02-29,Senate,"Senate: Reported from Education and Health (15-Y 0-N)",15,0,0,0,15
1799160,1401452,2024-03-04,Senate,"Senate: Reported from Finance and Appropriations with substitute (15-Y 0-N)",15,0,0,0,15
1799160,1403701,2024-03-05,Senate,"Senate: Constitutional reading dispensed (39-Y 0-N)",39,0,0,1,40
1799160,1404765,2024-03-06,Senate,"Senate: Passed Senate with substitute (40-Y 0-N)",40,0,0,0,40
1799160,1405448,2024-03-07,House,"House: VOTE: REJECTED (0-Y 99-N)",0,99,0,1,100
1799160,1405449,2024-03-07,Senate,"Senate: Senate insisted on substitute (40-Y 0-N)",40,0,0,0,40
1799160,1406388,2024-03-08,Senate,"Senate: Conference report agreed to by Senate (40-Y 0-N)",40,0,0,0,40
1799160,1406389,2024-03-08,House,"House: VOTE: Adoption (95-Y 0-N)",95,0,0,5,100
1799167,1373913,2024-02-01,House,"House: Subcommittee recommends reporting with amendments (5-Y 0-N)",5,0,0,3,8
1799167,1377323,2024-02-06,House,"House: Reported from General Laws with amendment(s) (20-Y 0-N)",20,0,0,2,22
1799167,1382217,2024-02-12,House,"House: VOTE: Block Vote Passage (100-Y 0-N)",100,0,0,0,100
1799167,1389128,2024-02-20,Senate,"Senate: Rereferred from Privileges and Elections (14-Y 0-N)",14,0,0,0,14
1799167,1398606,2024-02-28,Senate,"Senate: Reported from General Laws and Technology (15-Y 0-N)",15,0,0,0,15
1799167,1400749,2024-03-01,Senate,"Senate: Constitutional reading dispensed (40-Y 0-N)",40,0,0,0,40
1799167,1402076,2024-03-04,Senate,"Senate: Passed Senate (39-Y 0-N)",39,0,0,1,40
1799173,1374043,2024-02-01,House,"House: Reported from Labor and Commerce with substitute (12-Y 10-N)",12,10,0,0,22
1799178,1366388,2024-01-17,House,"House: Subcommittee recommends reporting with amendments (8-Y 2-N)",8,2,0,0,10
1799178,1372427,2024-01-31,House,"House: Reported from Agriculture, Chesapeake and Natural Resources with amendment(s) (17-Y 5-N)",17,5,0,0,22
1799178,1377310,2024-02-06,House,"House: VOTE: Passage (74-Y 25-N)",74,25,0,1,100
1799178,1389387,2024-02-20,Senate,"Senate: Reported from Agriculture, Conservation and Natural Resources (15-Y 0-N)",15,0,0,0,15
1799178,1392692,2024-02-22,Senate,"Senate: Constitutional reading dispensed (40-Y 0-N)",40,0,0,0,40
1799178,1394030,2024-02-23,Senate,"Senate: Passed Senate (39-Y 0-N)",39,0,0,1,40
1799183,1374320,2024-02-01,House,"House: Subcommittee recommends reporting with amendments (3-Y 2-N)",3,2,0,3,8
1799183,1377268,2024-02-06,House,"House: Reported from General Laws with amendment(s) (12-Y 8-N)",12,8,0,2,22
1799189,1379105,2024-02-08,House,"House: Subcommittee recommends reporting with amendments (6-Y 1-N)",6,1,0,1,8
1799189,1380692,2024-02-09,House,"House: Reported from Counties, Cities and Towns with amendment(s) (13-Y 8-N)",13,8,0,1,22
1799189,1383457,2024-02-13,House,"House: VOTE: Passage (55-Y 42-N 1-A)",55,42,1,2,100
1799189,1398581,2024-02-28,Senate,"Senate: Continued to 2025 in General Laws and Technology (9-Y 3-N 3-A)",9,3,3,0,15
1799194,1379147,2024-02-08,House,"House: Subcommittee recommends laying on the table (7-Y 0-N)",7,0,0,1,8
1799200,1369181,2024-01-25,House,"House: Subcommittee recommends reporting with substitute (6-Y 2-N)",6,2,0,0,8
1799200,1371568,2024-01-30,House,"House: Reported from Health and Human Services with substitute (13-Y 9-N)",13,9,0,0,22
1799200,1379355,2024-02-08,House,"House: Subcommittee recommends reporting with substitute (6-Y 2-N)",6,2,0,0,8
1799200,1380257,2024-02-08,House,"House: Reported from General Laws with substitute (14-Y 6-N)",14,6,0,2,22
1799200,1383499,2024-02-13,House,"House: VOTE: Passage (63-Y 36-N)",63,36,0,1,100
1799200,1393194,2024-02-23,Senate,"Senate: Reported from Rehabilitation and Social Services with amendments (14-Y 1-N)",14,1,0,0,15
1799200,1394614,2024-02-26,Senate,"Senate: Constitutional reading dispensed (40-Y 0-N)",40,0,0,0,40
1799200,1395968,2024-02-27,Senate,"Senate: Passed Senate with amendments (37-Y 2-N)",37,2,0,1,40
1799200,1399246,2024-02-29,House,"House: VOTE: Adoption (56-Y 29-N)",56,29,0,15,100
1799200,1399247,2024-02-29,House,"House: VOTE: Adoption #2 (61-Y 39-N)",61,39,0,0,100
1799205,1366603,2024-01-18,House,"House: Subcommittee recommends laying on the table (8-Y 0-N)",8,0,0,0,8
1799216,1369425,2024-01-25,House,"House: Subcommittee recommends reporting (6-Y 4-N)",6,4,0,0,10
1799216,1369769,2024-01-26,House,"House: Reported from Public Safety (12-Y 10-N)",12,10,0,0,22
1799216,1378139,2024-02-07,House,"House: Subcommittee recommends reporting (5-Y 3-N)",5,3,0,1,9
1799216,1378780,2024-02-07,House,"House: Reported from Appropriations (12-Y 10-N)",12,10,0,0,22
1799216,1382868,2024-02-13,House,"House: VOTE: Passage (51-Y 48-N)",51,48,0,1,100
1799216,1398762,2024-02-28,Senate,"Senate: Reported from Courts of Justice with substitute (9-Y 6-N)",9,6,0,0,15
1799216,1401410,2024-03-04,Senate,"Senate: Reported from Finance and Appropriations (10-Y 5-N)",10,5,0,0,15
1799216,1402921,2024-03-05,Senate,"Senate: Constitutional reading dispensed (39-Y 0-N)",39,0,0,1,40
1799216,1404193,2024-03-06,Senate,"Senate: Passed Senate with substitute (21-Y 19-N)",21,19,0,0,40
1799216,1405704,2024-03-07,House,"House: VOTE: REJECTED (1-Y 98-N)",1,98,0,1,100
1799216,1405705,2024-03-07,Senate,"Senate: Senate insisted on substitute (40-Y 0-N)",40,0,0,0,40
1799216,1406372,2024-03-08,Senate,"Senate: Conference report agreed to by Senate (21-Y 19-N)",21,19,0,0,40
1799216,1406373,2024-03-08,House,"House: VOTE: Adoption (50-Y 46-N)",50,46,0,4,100
1799226,1366581,2024-01-18,House,"House: Subcommittee recommends reporting with amendments (8-Y 0-N)",8,0,0,0,8
1799226,1367771,2024-01-23,House,"House: Reported from Health and Human Services with amendment(s) (21-Y 1-N)",21,1,0,0,22
1799226,1370521,2024-01-29,House,"House: VOTE: Passage (95-Y 3-N)",95,3,0,2,100
1799226,1391522,2024-02-22,Senate,"Senate: Reported from Education and Health (14-Y 0-N)",14,0,0,0,14
1799226,1393995,2024-02-23,Senate,"Senate: Constitutional reading dispensed (38-Y 0-N)",38,0,0,2,40
1799226,1394704,2024-02-26,Senate,"Senate: Passed Senate (40-Y 0-N)",40,0,0,0,40
1799232,1369367,2024-01-25,House,"House: Subcommittee recommends reporting (5-Y 3-N)",5,3,0,0,8
1799232,1372074,2024-01-30,House,"House: Reported from Labor and Commerce (12-Y 10-N)",12,10,0,0,22
1799237,1366723,2024-01-18,House,"House: Subcommittee recommends reporting (8-Y 0-N)",8,0,0,0,8
1799237,1367961,2024-01-23,House,"House: Reported from Health and Human Services (22-Y 0-N)",22,0,0,0,22
1799237,1371214,2024-01-29,House,"House: VOTE: Block Vote Passage (98-Y 0-N)",98,0,0,2,100
1799237,1391464,2024-02-22,Senate,"Senate: Reported from Education and Health (14-Y 0-N)",14,0,0,0,14
1799237,1393952,2024-02-23,Senate,"Senate: Constitutional reading dispensed (38-Y 0-N)",38,0,0,2,40
1799237,1394681,2024-02-26,Senate,"Senate: Passed Senate (40-Y 0-N)",40,0,0,0,40
1799243,1369258,2024-01-25,House,"House: Subcommittee recommends reporting with amendments (8-Y 0-N)",8,0,0,0,8
1799243,1371839,2024-01-30,House,"House: Reported from General Laws with amendment(s) (22-Y 0-N)",22,0,0,0,22
1799243,1377355,2024-02-06,House,"House: VOTE: Passage Emergency (99-Y 0-N)",99,0,0,1,100
1799243,1384468,2024-02-14,Senate,"Senate: Reported from General Laws and Technology (14-Y 0-N)",14,0,0,0,14
1799243,1386888,2024-02-16,Senate,"Senate: Constitutional reading dispensed (38-Y 0-N)",38,0,0,2,40
1799243,1388000,2024-02-19,Senate,"Senate: Passed Senate (39-Y 0-N)",39,0,0,1,40
1799250,1366358,2024-01-17,House,"House: Subcommittee recommends laying on the table (8-Y 0-N)",8,0,0,1,9
1799462,1367773,2024-01-23,House,"House: Subcommittee recommends reporting with amendments (8-Y 0-N)",8,0,0,0,8
1799462,1369223,2024-01-25,House,"House: Reported from Health and Human Services with amendment(s) (22-Y 0-N)",22,0,0,0,22
1799462,1372707,2024-01-31,House,"House: VOTE: Passage (81-Y 19-N)",81,19,0,0,100
1799462,1385361,2024-02-15,Senate,"Senate: Reported from Education and Health (14-Y 0-N)",14,0,0,0,14
1799462,1399388,2024-02-29,Senate,"Senate: Reported from Finance and Appropriations (14-Y 0-N)",14,0,0,0,14
1799462,1401926,2024-03-04,Senate,"Senate: Constitutional reading dispensed (40-Y 0-N)",40,0,0,0,40
1799462,1403031,2024-03-05,Senate,"Senate: Passed Senate (40-Y 0-N)",40,0,0,0,40
1799464,1371554,2024-01-30,House,"House: Subcommittee recommends reporting (7-Y 1-N)",7,1,0,0,8
1799464,1374076,2024-02-01,House,"House: Reported from Health and Human Services (15-Y 7-N)",15,7,0,0,22
1799464,1378587,2024-02-07,House,"House: VOTE: Passage (55-Y 45-N)",55,45,0,0,100
1799464,1392379,2024-02-22,Senate,"Senate: Reported from Education and Health (8-Y 6-N 1-A)",8,6,1,0,15
1799464,1393791,2024-02-23,Senate,"Senate: Constitutional reading dispensed (38-Y 0-N)",38,0,0,2,40
1799464,1395400,2024-02-26,Senate,"Senate: Passed Senate (21-Y 18-N)",21,18,0,1,40
1799465,1367623,2024-01-23,House,"House: Subcommittee recommends reporting with substitute (7-Y 0-N)",7,0,0,1,8
1799465,1368241,2024-01-24,House,"House: Reported from Education with substitute (21-Y 0-N)",21,0,0,1,22
1799465,1371670,2024-01-30,House,"House: VOTE: Block Vote Passage (100-Y 0-N)",100,0,0,0,100
1799465,1385333,2024-02-15,Senate,"Senate: Reported from Education and Health with substitute (15-Y 0-N)",15,0,0,0,15
1799465,1386742,2024-02-16,Senate,"Senate: Constitutional reading dispensed (38-Y 0-N)",38,0,0,2,40
1799465,1387476,2024-02-19,Senate,"Senate: Passed Senate (39-Y 0-N)",39,0,0,1,40
1799465,1390765,2024-02-21,House,"House: VOTE: REJECTED (1-Y 99-N)",1,99,0,0,100
1799465,1393637,2024-02-23,Senate,"Senate: Senate insisted on amendment (39-Y 0-N)",39,0,0,1,40
1799465,1401518,2024-03-04,House,"House: VOTE: Adoption (95-Y 0-N)",95,0,0,5,100
1799465,1403410,2024-03-05,Senate,"Senate: Conference report agreed to by Senate (39-Y 0-N)",39,0,0,1,40
1799466,1368213,2024-01-24,House,"House: Subcommittee recommends reporting with substitute (8-Y 0-N)",8,0,0,0,8
1799466,1371027,2024-01-29,House,"House: Reported from Education with substitute (21-Y 0-N)",21,0,1,0,22
1799466,1374904,2024-02-02,House,"House: VOTE: Passage (96-Y 2-N)",96,2,0,2,100
1799466,1392493,2024-02-22,Senate,"Senate: Reported from Education and Health (15-Y 0-N)",15,0,0,0,15
1799466,1393771,2024-02-23,Senate,"Senate: Constitutional reading dispensed (38-Y 0-N)",38,0,0,2,40
1799466,1395365,2024-02-26,Senate,"Senate: Passed Senate (40-Y 0-N)",40,0,0,0,40
1799467,1367622,2024-01-23,House,"House: Subcommittee recommends reporting with substitute (6-Y 2-N)",6,2,0,1,9
1799467,1368249,2024-01-24,House,"House: Reported from Education with substitute (12-Y 9-N)",12,9,0,1,22
1799470,1374000,2024-02-01,House,"House: Subcommittee recommends reporting with substitute (6-Y 3-N)",6,3,0,1,10
1799470,1374724,2024-02-02,House,"House: Reported from Public Safety with substitute (12-Y 10-N)",12,10,0,0,22
1799470,1378159,2024-02-07,House,"House: Subcommittee recommends reporting (5-Y 3-N)",5,3,0,1,9
1799470,1378759,2024-02-07,House,"House: Reported from Appropriations (13-Y 9-N)",13,9,0,0,22
1799470,1383518,2024-02-13,House,"House: VOTE: Passage (53-Y 46-N)",53,46,0,1,100
1799470,1394247,2024-02-26,Senate,"Senate: Reported from Courts of Justice with substitute (8-Y 5-N)",8,5,0,0,13
1799470,1397526,2024-02-28,Senate,"Senate: Reported from Finance and Appropriations (10-Y 5-N)",10,5,0,0,15
1799470,1399163,2024-02-29,Senate,"Senate: Constitutional reading dispensed (39-Y 0-N)",39,0,0,1,40
1799470,1401023,2024-03-01,Senate,"Senate: Passed Senate with substitute (21-Y 19-N)",21,19,0,0,40
1799470,1401624,2024-03-04,House,"House: VOTE: Adoption (52-Y 46-N)",52,46,0,2,100
1799472,1374658,2024-02-02,House,"House: Subcommittee recommends reporting with substitute (8-Y 0-N)",8,0,0,1,9
1799472,1374659,2024-02-02,House,"House: Reported from Appropriations with substitute (22-Y 0-N)",22,0,0,0,22
1799472,1379329,2024-02-08,House,"House: VOTE: Block Vote Passage (98-Y 0-N)",98,0,0,2,100
1799472,1390263,2024-02-21,Senate,"Senate: Reported from Finance and Appropriations (14-Y 0-N)",14,0,0,0,14
1799472,1392927,2024-02-22,Senate,"Senate: Constitutional reading dispensed (40-Y 0-N)",40,0,0,0,40
1799472,1393381,2024-02-23,Senate,"Senate: Passed Senate (39-Y 0-N)",39,0,0,1,40
1799473,1367810,2024-01-23,House,"House: Subcommittee recommends reporting (8-Y 0-N)",8,0,0,1,9
1799473,1368292,2024-01-24,House,"House: Reported from Education (21-Y 0-N)",21,0,0,1,22
1799473,1371812,2024-01-30,House,"House: VOTE: Block Vote Passage (100-Y 0-N)",100,0,0,0,100
1799473,1391457,2024-02-22,Senate,"Senate: Reported from Education and Health (15-Y 0-N)",15,0,0,0,15
1799473,1395824,2024-02-27,Senate,"Senate: Continued to 2025 in Finance and Appropriations (15-Y 0-N)",15,0,0,0,15
1799476,1366638,2024-01-18,House,"House: Subcommittee recommends reporting with amendments (8-Y 0-N)",8,0,0,0,8
1799476,1367782,2024-01-23,House,"House: Reported from Health and Human Services with amendment(s) (21-Y 1-N)",21,1,0,0,22
1799476,1370510,2024-01-29,House,"House: VOTE: Passage (99-Y 0-N)",99,0,0,1,100
1799476,1386658,2024-02-16,Senate,"Senate: Reported from Rehabilitation and Social Services (14-Y 0-N)",14,0,0,0,14
1799476,1387381,2024-02-19,Senate,"Senate: Constitutional reading dispensed (38-Y 0-N)",38,0,0,2,40
1799476,1388649,2024-02-20,Senate,"Senate: Passed Senate (40-Y 0-N)",40,0,0,0,40
1799505,1366592,2024-01-18,House,"House: Subcommittee recommends reporting with substitute (8-Y 0-N)",8,0,0,0,8
1799505,1366949,2024-01-19,House,"House: Reported from Counties, Cities and Towns with substitute (22-Y 0-N)",22,0,0,0,22
1799505,1369651,2024-01-25,House,"House: Subcommittee recommends laying on the table (6-Y 0-N)",6,0,2,0,8
1799506,1367224,2024-01-22,House,"House: Subcommittee recommends reporting with amendments (10-Y 0-N)",10,0,0,0,10
1799506,1368235,2024-01-24,House,"House: Reported from Education with amendment(s) (21-Y 0-N)",21,0,0,1,22
1799506,1372431,2024-01-31,House,"House: Subcommittee recommends reporting with amendments (8-Y 0-N)",8,0,0,1,9
1799506,1372998,2024-01-31,House,"House: Reported from Appropriations with amendment(s) (22-Y 0-N)",22,0,0,0,22
1799506,1377388,2024-02-06,House,"House: VOTE: Block Vote Passage (99-Y 0-N)",99,0,0,1,100
1799506,1385473,2024-02-15,Senate,"Senate: Reported from Education and Health (13-Y 0-N)",13,0,0,0,13
1799506,1395865,2024-02-27,Senate,"Senate: Continued to 2025 in Finance and Appropriations (13-Y 2-N)",13,2,0,0,15
1799507,1372761,2024-01-31,House,"House: Subcommittee recommends laying on the table (7-Y 1-N)",7,1,0,1,9
1799508,1379476,2024-02-08,House,"House: Subcommittee recommends reporting with amendments (8-Y 0-N)",8,0,0,0,8
1799508,1380441,2024-02-08,House,"House: Reported from General Laws with amendment(s) (20-Y 0-N)",20,0,0,2,22
1799508,1382994,2024-02-13,House,"House: VOTE: Block Vote Passage (99-Y 0-N)",99,0,0,1,100
1799508,1393229,2024-02-23,Senate,"Senate: Rereferred from Rules (15-Y 0-N)",15,0,0,0,15
1799508,1398776,2024-02-28,Senate,"Senate: Reported from General Laws and Technology with amendment (11-Y 0-N)",11,0,0,0,11
1799508,1400701,2024-03-01,Senate,"Senate: Constitutional reading dispensed (40-Y 0-N)",40,0,0,0,40
1799508,1402514,2024-03-04,Senate,"Senate: Passed Senate with amendment (39-Y 0-N)",39,0,0,1,40
1799508,1403633,2024-03-05,House,"House: VOTE: Adoption (100-Y 0-N)",100,0,0,0,100
1799509,1370684,2024-01-29,House,"House: Subcommittee recommends laying on the table (6-Y 0-N)",6,0,0,0,6
1799534,1366711,2024-01-18,House,"House: Subcommittee recommends laying on the table (7-Y 1-N)",7,1,0,0,8
1799535,1373631,2024-02-01,House,"House: Reported from Rules with amendment(s) (18-Y 0-N)",18,0,0,0,18
1799535,1376318,2024-02-05,House,"House: Subcommittee recommends reporting with substitute (8-Y 0-N)",8,0,0,1,9
1799535,1378751,2024-02-07,House,"House: Reported from Appropriations with substitute (22-Y 0-N)",22,0,0,0,22
1799535,1383535,2024-02-13,House,"House: VOTE: Block Vote Passage (99-Y 0-N)",99,0,0,1,100
1799535,1400466,2024-03-01,Senate,"Senate: Reported from Rules (15-Y 0-N)",15,0,0,0,15
1799535,1402256,2024-03-04,Senate,"Senate: Constitutional reading dispensed (40-Y 0-N)",40,0,0,0,40
1799535,1403543,2024-03-05,Senate,"Senate: Passed Senate (40-Y 0-N)",40,0,0,0,40
1799537,1369051,2024-01-25,House,"House: Subcommittee recommends reporting with substitute (5-Y 3-N)",5,3,1,0,9
1799537,1373676,2024-02-01,House,"House: Tabled in Health and Human Services (22-Y 0-N)",22,0,0,0,22
1799538,1373602,2024-02-01,House,"House: Subcommittee recommends laying on the table (5-Y 3-N)",5,3,0,0,8
1799539,1369469,2024-01-25,House,"House: Reported from Transportation with substitute (21-Y 0-N)",21,0,0,1,22
1799539,1372972,2024-01-31,House,"House: VOTE: Passage (100-Y 0-N)",100,0,0,0,100
1799539,1386631,2024-02-15,Senate,"Senate: Reported from Transportation (15-Y 0-N)",15,0,0,0,15
1799539,1398246,2024-02-28,Senate,"Senate: Reported from Finance and Appropriations (15-Y 0-N)",15,0,0,0,15
1799539,1399877,2024-02-29,Senate,"Senate: Constitutional reading dispensed (39-Y 0-N)",39,0,0,1,40
1799539,1401065,2024-03-01,Senate,"Senate: Passed Senate (40-Y 0-N)",40,0,0,0,40
1799540,1369829,2024-01-26,House,"House: Reported from Counties, Cities and Towns with amendment(s) (19-Y 1-N)",19,1,0,2,22
1799540,1378542,2024-02-07,House,"House: VOTE: Passage (98-Y 2-N)",98,2,0,0,100
1799540,1394644,2024-02-26,Senate,"Senate: Reported from Local Government (14-Y 0-N)",14,0,0,0,14
1799540,1396311,2024-02-27,Senate,"Senate: Constitutional reading dispensed (39-Y 0-N)",39,0,0,1,40
1799540,1397829,2024-02-28,Senate,"Senate: Passed Senate (39-Y 0-N)",39,0,0,1,40
1799542,1373586,2024-02-01,House,"House: Subcommittee recommends reporting (7-Y 1-N)",7,1,0,0,8
1799542,1374881,2024-02-02,House,"House: Reported from Counties, Cities and Towns (17-Y 5-N)",17,5,0,0,22
1799542,1382999,2024-02-13,House,"House: VOTE: Defeated (47-Y 52-N)",47,52,0,1,100
1799550,1366352,2024-01-17,House,"House: Subcommittee recommends laying on the table (5-Y 3-N)",5,3,0,1,9
1799554,1377217,2024-02-06,House,"House: Subcommittee recommends laying on the table (5-Y 2-N)",5,2,0,1,8
1799559,1379440,2024-02-08,House,"House: Subcommittee recommends reporting with substitute (7-Y 1-N)",7,1,0,0,8
1799559,1380426,2024-02-08,House,"House: Reported from Labor and Commerce with substitute (15-Y 7-N)",15,7,0,0,22
1799559,1383265,2024-02-13,House,"House: VOTE: Passage (56-Y 42-N)",56,42,0,2,100
1799559,1395079,2024-02-26,Senate,"Senate: Reported from Commerce and Labor with amendment (15-Y 0-N)",15,0,0,0,15
1799559,1397817,2024-02-28,Senate,"Senate: Constitutional reading dispensed (39-Y 0-N)",39,0,0,1,40
1799559,1399569,2024-02-29,Senate,"Senate: Passed Senate with amendment (39-Y 0-N)",39,0,0,1,40
1799559,1402051,2024-03-04,House,"House: VOTE: Adoption (53-Y 45-N)",53,45,0,2,100
1799564,1368020,2024-01-23,House,"House: Subcommittee recommends laying on the table (9-Y 1-N)",9,1,0,0,10
1799573,1367391,2024-01-22,House,"House: Subcommittee recommends laying on the table (8-Y 0-N)",8,0,0,0,8
1799578,1366374,2024-01-17,House,"House: Subcommittee recommends laying on the table (5-Y 3-N)",5,3,0,1,9
1799581,1368059,2024-01-23,House,"House: Stricken from docket by Labor and Commerce (22-Y 0-N)",22,0,0,0,22
1799585,1371894,2024-01-30,House,"House: Subcommittee recommends reporting with substitute (5-Y 3-N)",5,3,0,0,8
1799585,1375843,2024-02-05,House,"House: Reported from Education with substitute (12-Y 10-N)",12,10,0,0,22
1799585,1378377,2024-02-07,House,"House: Reported from Appropriations with substitute (14-Y 8-N)",14,8,0,0,22
1799585,1383462,2024-02-13,House,"House: VOTE: Passage (52-Y 47-N)",52,47,0,1,100
1799585,1399141,2024-02-29,Senate,"Senate: Reported from Education and Health with substitute (9-Y 6-N)",9,6,0,0,15
1799585,1401004,2024-03-01,Senate,"Senate: Constitutional reading dispensed (40-Y 0-N)",40,0,0,0,40
1799585,1401697,2024-03-04,Senate,"Senate: Passed Senate with substitute (21-Y 19-N)",21,19,0,0,40
1799585,1402755,2024-03-05,House,"House: VOTE: REJECTED (0-Y 99-N)",0,99,0,1,100
1799585,1404081,2024-03-06,Senate,"Senate: Senate insisted on substitute (40-Y 0-N)",40,0,0,0,40
1799585,1406207,2024-03-08,Senate,"Senate: Conference report agreed to by Senate (21-Y 19-N)",21,19,0,0,40
1799585,1406208,2024-03-08,House,"House: VOTE: Adoption (52-Y 47-N)",52,47,0,1,100
1799587,1370360,2024-01-29,House,"House: Subcommittee recommends striking from docket (8-Y 0-N)",8,0,0,1,9
1799587,1373159,2024-01-31,House,"House: Stricken from docket by Appropriations (22-Y 0-N)",22,0,0,0,22
1799592,1366331,2024-01-17,House,"House: Subcommittee recommends laying on the table (6-Y 2-N)",6,2,0,1,9
1799598,1371980,2024-01-30,House,"House: Subcommittee recommends reporting with substitute (6-Y 4-N)",6,4,0,0,10
1799598,1373931,2024-02-01,House,"House: Reported from Labor and Commerce with substitute (12-Y 10-N)",12,10,0,0,22
1799598,1378548,2024-02-07,House,"House: VOTE: Defeated (50-Y 50-N)",50,50,0,0,100
1799598,1378549,2024-02-07,House,"House: VOTE: Passage #2 (51-Y 49-N)",51,49,0,0,100
1799598,1386876,2024-02-15,Senate,"Senate: Rereferred from Transportation (10-Y 2-N)",10,2,0,0,12
1799598,1395297,2024-02-26,Senate,"Senate: Reported from Commerce and Labor (9-Y 5-N)",9,5,0,0,14
1799598,1398612,2024-02-28,Senate,"Senate: Constitutional reading dispensed (39-Y 0-N)",39,0,0,1,40
1799598,1399651,2024-02-29,Senate,"Senate: Passed Senate (20-Y 19-N)",20,19,0,1,40
1799602,1376311,2024-02-05,House,"House: Subcommittee recommends reporting (5-Y 3-N)",5,3,0,1,9
1799602,1380814,2024-02-09,House,"House: Failed to report (defeated) in Privileges and Elections (11-Y 11-N)",11,11,0,0,22
1799606,1379199,2024-02-08,House,"House: Reported from Rules (12-Y 6-N)",12,6,0,0,18
1799606,1382085,2024-02-12,House,"House: VOTE: Adoption (51-Y 48-N)",51,48,0,1,100
1799606,1382086,2024-02-12,House,"House: VOTE: Sustain ruling of the Chair (51-Y 48-N)",51,48,0,1,100
1799606,1382087,2024-02-12,House,"House: VOTE: Engrossment (1-Y 95-N 2-A)",1,95,2,2,100
1799609,1367216,2024-01-22,House,"House: Subcommittee recommends laying on the table (8-Y 0-N)",8,0,0,1,9
1799614,1367630,2024-01-23,House,"House: Subcommittee recommends reporting (7-Y 0-N)",7,0,0,1,8
1799614,1368229,2024-01-24,House,"House: Reported from Education (18-Y 3-N)",18,3,0,1,22
1799622,1366262,2024-01-17,House,"House: Subcommittee recommends reporting (6-Y 1-N)",6,1,0,1,8
1799622,1367176,2024-01-22,House,"House: Reported from Education (13-Y 8-N)",13,8,0,1,22
1799628,1379435,2024-02-08,House,"House: Subcommittee recommends reporting with substitute (5-Y 3-N)",5,3,0,0,8
1799628,1380362,2024-02-08,House,"House: Reported from General Laws with substitute (13-Y 7-N)",13,7,0,2,22
1799628,1382858,2024-02-13,House,"House: VOTE: Passage (58-Y 41-N)",58,41,0,1,100
1799628,1394292,2024-02-26,Senate,"Senate: Rereferred from Local Government (9-Y 0-N)",9,0,0,0,9
1799628,1398621,2024-02-28,Senate,"Senate: Reported from General Laws and Technology (9-Y 6-N)",9,6,0,0,15
1799628,1400841,2024-03-01,Senate,"Senate: Constitutional reading dispensed (40-Y 0-N)",40,0,0,0,40
1799628,1404136,2024-03-06,Senate,"Senate: Passed Senate with substitute (21-Y 19-N)",21,19,0,0,40
1799628,1404137,2024-03-06,Senate,"Senate: Reconsideration of Senate passage agreed to by Senate (40-Y 0-N)",40,0,0,0,40
1799628,1404138,2024-03-06,Senate,"Senate: Passed Senate with substitute (21-Y 19-N)",21,19,0,0,40
1799628,1405178,2024-03-07,House,"House: VOTE: Adoption (66-Y 32-N)",66,32,0,2,100
1799634,1366340,2024-01-17,House,"House: Subcommittee recommends laying on the table (5-Y 3-N)",5,3,0,1,9
1799638,1368248,2024-01-24,House,"House: Continued to 2025 in Agriculture, Chesapeake and Natural Resources (22-Y 0-N)",22,0,0,0,22
1799645,1367172,2024-01-22,House,"House: Referred from Communications, Technology and Innovation (22-Y 0-N)",22,0,0,0,22
1799645,1372703,2024-01-31,House,"House: Subcommittee recommends laying on the table (8-Y 0-N)",8,0,0,1,9
1799649,1366819,2024-01-18,House,"House: Subcommittee recommends passing by indefinitely (8-Y 2-N)",8,2,0,0,10
1799653,1366674,2024-01-18,House,"House: Subcommittee recommends reporting (8-Y 0-N)",8,0,0,0,8
1799653,1372240,2024-01-30,House,"House: Reported from General Laws (22-Y 0-N)",22,0,0,0,22
1799653,1376617,2024-02-05,House,"House: VOTE: Block Vote Passage (98-Y 0-N)",98,0,0,2,100
1799653,1384472,2024-02-14,Senate,"Senate: Reported from General Laws and Technology (14-Y 0-N)",14,0,0,0,14
1799653,1386744,2024-02-16,Senate,"Senate: Constitutional reading dispensed (38-Y 0-N)",38,0,0,2,40
1799653,1387582,2024-02-19,Senate,"Senate: Passed Senate (39-Y 0-N)",39,0,0,1,40
1799658,1369364,2024-01-25,House,"House: Subcommittee recommends reporting (7-Y 1-N)",7,1,0,0,8
1799660,1366673,2024-01-18,House,"House: Subcommittee recommends passing by indefinitely (6-Y 4-N)",6,4,0,0,10
1799665,1366082,2024-01-17,House,"House: Subcommittee recommends reporting with amendments (7-Y 0-N)",7,0,0,1,8
1799665,1367197,2024-01-22,House,"House: Reported from Education with amendment(s) (21-Y 0-N)",21,0,0,1,22
1799665,1369936,2024-01-26,House,"House: VOTE: Block Vote Passage (95-Y 0-N)",95,0,0,5,100
1799665,1391541,2024-02-22,Senate,"Senate: Reported from Education and Health (15-Y 0-N)",15,0,0,0,15
1799665,1395883,2024-02-27,Senate,"Senate: Constitutional reading dispensed (39-Y 0-N)",39,0,0,1,40
1799665,1395884,2024-02-27,Senate,"Senate: Reported from Finance and Appropriations (15-Y 0-N)",15,0,0,0,15
1799665,1398330,2024-02-28,Senate,"Senate: Passed Senate (39-Y 0-N)",39,0,0,1,40
1799669,1367181,2024-01-22,House,"House: Subcommittee recommends laying on the table (8-Y 0-N)",8,0,0,1,9
1799680,1379434,2024-02-08,House,"House: Subcommittee recommends laying on the table (3-Y 1-N)",3,1,0,1,5
1799737,1367450,2024-01-22,House,"House: Subcommittee recommends reporting (7-Y 0-N)",7,0,0,2,9
1799737,1369846,2024-01-26,House,"House: Reported from Courts of Justice (21-Y 0-N)",21,0,0,1,22
1799737,1374346,2024-02-01,House,"House: VOTE: Block Vote Passage (99-Y 0-N)",99,0,0,1,100
1799737,1385087,2024-02-14,Senate,"Senate: Reported from Courts of Justice (14-Y 0-N)",14,0,0,0,14
1799737,1396130,2024-02-27,Senate,"Senate: Passed by indefinitely in Finance and Appropriations (15-Y 0-N)",15,0,0,0,15
1799757,1376299,2024-02-05,House,"House: Subcommittee recommends reporting (5-Y 3-N)",5,3,0,1,9
1799757,1380800,2024-02-09,House,"House: Failed to report (defeated) in Privileges and Elections (11-Y 11-N)",11,11,0,0,22
1799777,1366876,2024-01-19,House,"House: Subcommittee recommends reporting with substitute (5-Y 2-N)",5,2,0,1,8
1799777,1366877,2024-01-19,House,"House: Reported from Counties, Cities and Towns with substitute (12-Y 9-N)",12,9,0,1,22
1799777,1378440,2024-02-07,House,"House: VOTE: Passage (75-Y 24-N 1-A)",75,24,1,0,100
1799777,1394347,2024-02-26,Senate,"Senate: Reported from Local Government (14-Y 0-N)",14,0,0,0,14
1799777,1396495,2024-02-27,Senate,"Senate: Constitutional reading dispensed (39-Y 0-N)",39,0,0,1,40
1799777,1397945,2024-02-28,Senate,"Senate: Passed Senate (39-Y 0-N)",39,0,0,1,40
1799799,1368664,2024-01-24,House,"House: Subcommittee recommends reporting with substitute (5-Y 3-N)",5,3,0,1,9
1799799,1369836,2024-01-26,House,"House: Reported from Courts of Justice with substitute (11-Y 10-N)",11,10,0,1,22
1799799,1371072,2024-01-29,House,"House: Subcommittee recommends reporting (4-Y 3-N)",4,3,0,2,9
1799799,1376142,2024-02-05,House,"House: Reported from Appropriations (12-Y 9-N)",12,9,0,1,22
1799799,1381025,2024-02-09,House,"House: VOTE: Passage (50-Y 46-N)",50,46,0,4,100
1799799,1384917,2024-02-14,Senate,"Senate: Reported from Courts of Justice with substitute (7-Y 6-N)",7,6,0,0,13
1799799,1386566,2024-02-16,Senate,"Senate: Constitutional reading dispensed (38-Y 0-N)",38,0,0,2,40
1799799,1388154,2024-02-19,Senate,"Senate: Passed Senate with substitute (21-Y 18-N)",21,18,0,1,40
1799799,1390721,2024-02-21,House,"House: VOTE: Adoption (51-Y 49-N)",51,49,0,0,100
1799861,1366976,2024-01-19,House,"House: Subcommittee recommends reporting (8-Y 0-N)",8,0,0,0,8
1799861,1366977,2024-01-19,House,"House: Reported from Counties, Cities and Towns (22-Y 0-N)",22,0,0,0,22
1799861,1378940,2024-02-07,House,"House: VOTE: Block Vote Passage (100-Y 0-N)",100,0,0,0,100
1799861,1387278,2024-02-19,Senate,"Senate: Reported from Local Government (14-Y 0-N)",14,0,0,0,14
1799861,1389427,2024-02-20,Senate,"Senate: Constitutional reading dispensed (39-Y 0-N)",39,0,0,1,40
1799861,1391061,2024-02-21,Senate,"Senate: Passed Senate (40-Y 0-N)",40,0,0,0,40
1799881,1367733,2024-01-23,House,"House: Subcommittee recommends laying on the table (6-Y 2-N)",6,2,0,1,9
1799910,1366513,2024-01-18,House,"House: Subcommittee recommends reporting (8-Y 0-N)",8,0,0,0,8
1799910,1366987,2024-01-19,House,"House: Reported from Counties, Cities and Towns (14-Y 8-N)",14,8,0,0,22
1799910,1370010,2024-01-26,House,"House: VOTE: Passage (64-Y 31-N)",64,31,0,5,100
1799910,1394309,2024-02-26,Senate,"Senate: Reported from Local Government with substitute (10-Y 4-N 1-A)",10,4,1,0,15
1799910,1397035,2024-02-27,Senate,"Senate: Constitutional reading dispensed (39-Y 0-N)",39,0,0,1,40
1799910,1398633,2024-02-28,Senate,"Senate: Passed Senate with substitute (29-Y 10-N)",29,10,0,1,40
1799910,1400476,2024-03-01,House,"House: VOTE: Adoption (67-Y 30-N)",67,30,0,3,100
1799915,1367047,2024-01-19,House,"House: Subcommittee recommends reporting with substitute (8-Y 0-N)",8,0,0,1,9
1799915,1370011,2024-01-26,House,"House: Reported from Courts of Justice with substitute (21-Y 0-N)",21,0,0,1,22
1799915,1374260,2024-02-01,House,"House: VOTE: Block Vote Passage (99-Y 0-N)",99,0,0,1,100
1799915,1384314,2024-02-14,Senate,"Senate: Reported from Courts of Justice with amendments (15-Y 0-N)",15,0,0,0,15
1799915,1386757,2024-02-16,Senate,"Senate: Constitutional reading dispensed (38-Y 0-N)",38,0,0,2,40
1799915,1387574,2024-02-19,Senate,"Senate: Passed Senate (39-Y 0-N)",39,0,0,1,40
1799915,1390198,2024-02-21,House,"House: VOTE: Adoption (100-Y 0-N)",100,0,0,0,100
1799919,1371000,2024-01-29,House,"House: Subcommittee recommends reporting (5-Y 3-N)",5,3,0,1,9
1799919,1375880,2024-02-02,House,"House: Reported from Courts of Justice (12-Y 9-N)",12,9,0,1,22
1799919,1380202,2024-02-08,House,"House: VOTE: Passage (50-Y 47-N)",50,47,0,3,100
1799919,1398842,2024-02-28,Senate,"Senate: Reported from Courts of Justice with substitute (14-Y 1-N)",14,1,0,0,15
1799919,1400982,2024-03-01,Senate,"Senate: Constitutional reading dispensed (40-Y 0-N)",40,0,0,0,40
1799919,1402167,2024-03-04,Senate,"Senate: Passed Senate with substitute (31-Y 8-N)",31,8,0,1,40
1799919,1403469,2024-03-05,House,"House: VOTE: Adoption (52-Y 47-N)",52,47,0,1,100
1799924,1373124,2024-01-31,House,"House: Subcommittee recommends reporting (9-Y 1-N)",9,1,0,0,10
1799924,1378461,2024-02-07,House,"House: Reported from Agriculture, Chesapeake and Natural Resources (20-Y 2-N)",20,2,0,0,22
1799924,1382880,2024-02-13,House,"House: VOTE: Passage (95-Y 4-N)",95,4,0,1,100
1799924,1396762,2024-02-27,Senate,"Senate: Reported from Agriculture, Conservation and Natural Resources (14-Y 0-N)",14,0,0,0,14
1799924,1399951,2024-02-29,Senate,"Senate: Continued to 2025 in Finance and Appropriations (13-Y 1-N)",13,1,0,0,14
1799926,1368983,2024-01-25,House,"House: Subcommittee recommends reporting (4-Y 2-N)",4,2,0,0,6
1799926,1369703,2024-01-26,House,"House: Reported from Public Safety (21-Y 1-N)",21,1,0,0,22
1799926,1374614,2024-02-02,House,"House: VOTE: Passage (98-Y 1-N)",98,1,0,1,100
1799926,1385080,2024-02-14,Senate,"Senate: Reported from Courts of Justice (9-Y 0-N)",9,0,0,0,9
1799926,1386687,2024-02-16,Senate,"Senate: Constitutional reading dispensed (38-Y 0-N)",38,0,0,2,40
1799926,1387468,2024-02-19,Senate,"Senate: Passed Senate (39-Y 0-N)",39,0,0,1,40
1799933,1372862,2024-01-31,House,"House: Subcommittee recommends reporting (8-Y 0-N)",8,0,0,0,8
1799933,1374050,2024-02-01,House,"House: Reported from Transportation (22-Y 0-N)",22,0,0,0,22
1799933,1379472,2024-02-08,House,"House: Subcommittee recommends reporting with amendments (7-Y 0-N)",7,0,0,1,8
1799933,1380751,2024-02-09,House,"House: Reported from Counties, Cities and Towns with substitute (21-Y 0-N)",21,0,0,1,22
1799933,1382962,2024-02-13,House,"House: VOTE: Block Vote Passage (99-Y 0-N)",99,0,0,1,100
1799933,1392613,2024-02-22,Senate,"Senate: Reported from Transportation (13-Y 0-N)",13,0,0,0,13
1799933,1394833,2024-02-26,Senate,"Senate: Constitutional reading dispensed (40-Y 0-N)",40,0,0,0,40
1799933,1396324,2024-02-27,Senate,"Senate: Passed Senate (39-Y 0-N)",39,0,0,1,40
1799940,1367111,2024-01-19,House,"House: Subcommittee recommends reporting with amendments (8-Y 0-N)",8,0,0,1,9
1799940,1370024,2024-01-26,House,"House: Reported from Courts of Justice with amendment(s) (21-Y 0-N)",21,0,0,1,22
1799940,1373654,2024-02-01,House,"House: VOTE: Block Vote Passage (99-Y 0-N)",99,0,0,1,100
1799940,1384313,2024-02-14,Senate,"Senate: Reported from Courts of Justice (15-Y 0-N)",15,0,0,0,15
1799940,1386769,2024-02-16,Senate,"Senate: Constitutional reading dispensed (38-Y 0-N)",38,0,0,2,40
1799940,1387606,2024-02-19,Senate,"Senate: Passed Senate (39-Y 0-N)",39,0,0,1,40
1799940,1429933,2024-04-17,House,"House: VOTE: (100-Y 0-N)",100,0,0,0,100
1799940,1429934,2024-04-17,Senate,"Senate: Senate concurred in Governor's recommendation (40-Y 0-N)",40,0,0,0,40
1799944,1368012,2024-01-23,House,"House: Subcommittee recommends striking from docket (7-Y 0-N)",7,0,0,1,8
1799944,1369196,2024-01-25,House,"House: Stricken from docket by Labor and Commerce (18-Y 1-N)",18,1,0,3,22
1799948,1368566,2024-01-24,House,"House: Subcommittee recommends reporting (6-Y 2-N)",6,2,0,0,8
1799948,1371029,2024-01-29,House,"House: Reported from Education (17-Y 5-N)",17,5,0,0,22
1799948,1376188,2024-02-05,House,"House: Subcommittee recommends reporting with substitute (7-Y 0-N)",7,0,0,2,9
1799948,1378878,2024-02-07,House,"House: Reported from Appropriations with substitute (22-Y 0-N)",22,0,0,0,22
1799948,1383504,2024-02-13,House,"House: VOTE: Passage (85-Y 13-N)",85,13,0,2,100
1799948,1399875,2024-02-29,Senate,"Senate: Reported from Education and Health with substitute (15-Y 0-N)",15,0,0,0,15
1799948,1401442,2024-03-04,Senate,"Senate: Reported from Finance and Appropriations (15-Y 0-N)",15,0,0,0,15
1799948,1403694,2024-03-05,Senate,"Senate: Constitutional reading dispensed (39-Y 0-N)",39,0,0,1,40
1799948,1404761,2024-03-06,Senate,"Senate: Passed Senate with substitute (40-Y 0-N)",40,0,0,0,40
1799948,1405897,2024-03-07,House,"House: VOTE: REJECTED (1-Y 97-N)",1,97,0,2,100
1799948,1405898,2024-03-07,Senate,"Senate: Senate insisted on substitute (40-Y 0-N)",40,0,0,0,40
1799948,1406558,2024-03-08,House,"House: VOTE: Adoption (90-Y 4-N)",90,4,0,6,100
1799948,1406760,2024-03-09,Senate,"Senate: Conference report agreed to by Senate (39-Y 1-N)",39,1,0,0,40
1799954,1374024,2024-02-01,House,"House: Subcommittee recommends reporting with amendments (5-Y 3-N)",5,3,0,0,8
1799954,1377566,2024-02-06,House,"House: Reported from General Laws with amendment(s) (10-Y 9-N)",10,9,0,3,22
1799954,1382465,2024-02-12,House,"House: VOTE: Passage (51-Y 49-N)",51,49,0,0,100
1799954,1398721,2024-02-28,Senate,"Senate: Reported from General Laws and Technology (9-Y 6-N)",9,6,0,0,15
1799954,1400608,2024-03-01,Senate,"Senate: Constitutional reading dispensed (40-Y 0-N)",40,0,0,0,40
1799954,1401641,2024-03-04,Senate,"Senate: Passed Senate (22-Y 18-N)",22,18,0,0,40
1799960,1373847,2024-02-01,House,"House: Subcommittee recommends reporting with substitute (5-Y 3-N)",5,3,0,0,8
1799960,1377443,2024-02-06,House,"House: Reported from Health and Human Services with substitute (13-Y 9-N)",13,9,0,0,22
1799960,1381595,2024-02-12,House,"House: VOTE: Passage (54-Y 46-N)",54,46,0,0,100
1799960,1399151,2024-02-29,Senate,"Senate: Reported from Education and Health with substitute (14-Y 0-N 1-A)",14,0,1,0,15
1799960,1400996,2024-03-01,Senate,"Senate: Constitutional reading dispensed (40-Y 0-N)",40,0,0,0,40
1799960,1401684,2024-03-04,Senate,"Senate: Passed Senate with substitute (24-Y 16-N)",24,16,0,0,40
1799960,1402793,2024-03-05,House,"House: VOTE: Adoption (71-Y 28-N)",71,28,0,1,100
1799963,1367732,2024-01-23,House,"House: Subcommittee recommends reporting (7-Y 1-N)",7,1,0,0,8
1799963,1376782,2024-02-06,House,"House: Subcommittee recommends reporting with amendments (8-Y 0-N)",8,0,0,0,8
1799963,1379124,2024-02-08,House,"House: Reported from Transportation with amendment(s) (22-Y 0-N)",22,0,0,0,22
1799963,1383728,2024-02-13,House,"House: VOTE: Block Vote Passage (99-Y 0-N)",99,0,0,1,100
1799963,1392908,2024-02-22,Senate,"Senate: Reported from Transportation (15-Y 0-N)",15,0,0,0,15
1799963,1394399,2024-02-26,Senate,"Senate: Constitutional reading dispensed (40-Y 0-N)",40,0,0,0,40
1799963,1395928,2024-02-27,Senate,"Senate: Passed Senate (39-Y 0-N)",39,0,0,1,40
1799970,1374924,2024-02-02,House,"House: Subcommittee recommends striking from docket (8-Y 0-N)",8,0,0,0,8
1799974,1370803,2024-01-29,House,"House: Subcommittee recommends reporting with amendments (8-Y 0-N)",8,0,0,1,9
1799974,1375580,2024-02-02,House,"House: Reported from Courts of Justice with amendment(s) (21-Y 0-N)",21,0,0,1,22
1799974,1379589,2024-02-08,House,"House: VOTE: Block Vote Passage (98-Y 0-N)",98,0,0,2,100
1799974,1390885,2024-02-21,Senate,"Senate: Reported from Courts of Justice with substitute (10-Y 0-N)",10,0,0,0,10
1799974,1393834,2024-02-23,Senate,"Senate: Constitutional reading dispensed (38-Y 0-N)",38,0,0,2,40
1799974,1394589,2024-02-26,Senate,"Senate: Passed Senate with substitute (40-Y 0-N)",40,0,0,0,40
1799974,1398368,2024-02-28,House,"House: VOTE: Adoption (55-Y 44-N)",55,44,0,1,100
1799974,1430282,2024-04-17,House,"House: VOTE: (100-Y 0-N)",100,0,0,0,100
1799974,1430283,2024-04-17,Senate,"Senate: Senate concurred in Governor's recommendation (40-Y 0-N)",40,0,0,0,40
1799977,1380652,2024-02-09,House,"House: Stricken from docket by Counties, Cities and Towns (21-Y 0-N)",21,0,0,1,22
1799981,1367686,2024-01-23,House,"House: Subcommittee recommends laying on the table (6-Y 1-N)",6,1,0,1,8
1799988,1366500,2024-01-18,House,"House: Subcommittee recommends reporting with amendments (7-Y 1-N)",7,1,0,0,8
1799988,1366874,2024-01-19,House,"House: Reported from Counties, Cities and Towns with amendment(s) (15-Y 7-N)",15,7,0,0,22
1799988,1369933,2024-01-26,House,"House: VOTE: Passage (53-Y 42-N)",53,42,0,5,100
1799988,1387268,2024-02-19,Senate,"Senate: Reported from Local Government (13-Y 1-N)",13,1,0,0,14
1799988,1389132,2024-02-20,Senate,"Senate: Constitutional reading dispensed (39-Y 0-N)",39,0,0,1,40
1799988,1390006,2024-02-21,Senate,"Senate: Passed Senate (31-Y 9-N)",31,9,0,0,40
1799991,1369200,2024-01-25,House,"House: Subcommittee recommends reporting with amendments (8-Y 0-N)",8,0,0,0,8
1799991,1376994,2024-02-06,House,"House: Reported from Health and Human Services with amendment(s) (21-Y 0-N)",21,0,0,1,22
1799991,1382365,2024-02-12,House,"House: VOTE: Block Vote Passage (100-Y 0-N)",100,0,0,0,100
1799991,1392452,2024-02-22,Senate,"Senate: Reported from Education and Health (15-Y 0-N)",15,0,0,0,15
1799991,1393935,2024-02-23,Senate,"Senate: Constitutional reading dispensed (38-Y 0-N)",38,0,0,2,40
1799991,1395096,2024-02-26,Senate,"Senate: Passed Senate (40-Y 0-N)",40,0,0,0,40
1799991,1429699,2024-04-17,Senate,"Senate: Senate concurred in Governor's recommendation (40-Y 0-N)",40,0,0,0,40
1799991,1430866,2024-04-17,House,"House: BLOCK VOTE: (100-Y 0-N)",100,0,0,0,100
1799995,1371488,2024-01-30,House,"House: Subcommittee recommends reporting (8-Y 0-N)",8,0,0,0,8
1799995,1373580,2024-02-01,House,"House: Reported from Health and Human Services (22-Y 0-N)",22,0,0,0,22
1799995,1374792,2024-02-02,House,"House: Subcommittee recommends reporting (7-Y 1-N)",7,1,0,1,9
1799995,1380970,2024-02-09,House,"House: Reported from Courts of Justice (22-Y 0-N)",22,0,0,0,22
1799995,1383566,2024-02-13,House,"House: VOTE: Block Vote Passage (99-Y 0-N)",99,0,0,1,100
1799995,1398725,2024-02-28,Senate,"Senate: Reported from Courts of Justice (15-Y 0-N)",15,0,0,0,15
1799995,1401057,2024-03-01,Senate,"Senate: Constitutional reading dispensed (40-Y 0-N)",40,0,0,0,40
1799995,1401789,2024-03-04,Senate,"Senate: Passed Senate (39-Y 0-N)",39,0,0,1,40
1800000,1375844,2024-02-05,House,"House: Subcommittee recommends reporting with amendments (6-Y 2-N)",6,2,0,1,9
1800000,1381107,2024-02-09,House,"House: Reported from Courts of Justice with amendment(s) (22-Y 0-N)",22,0,0,0,22
1800000,1383349,2024-02-13,House,"House: VOTE: Block Vote Passage (99-Y 0-N)",99,0,0,1,100
1800000,1395013,2024-02-26,Senate,"Senate: Reported from Courts of Justice (15-Y 0-N)",15,0,0,0,15
1800000,1396818,2024-02-27,Senate,"Senate: Constitutional reading dispensed (39-Y 0-N)",39,0,0,1,40
1800000,1398431,2024-02-28,Senate,"Senate: Passed Senate (39-Y 0-N)",39,0,0,1,40
1800002,1366692,2024-01-18,House,"House: Subcommittee recommends reporting with substitute (7-Y 3-N)",7,3,0,0,10
1800002,1366937,2024-01-19,House,"House: Reported from Public Safety with substitute (12-Y 9-N)",12,9,0,1,22
1800002,1368864,2024-01-24,House,"House: Subcommittee recommends reporting (5-Y 3-N)",5,3,0,1,9
1800002,1370895,2024-01-29,House,"House: Reported from Appropriations (11-Y 10-N)",11,10,0,1,22
1800002,1374636,2024-02-02,House,"House: VOTE: Passage (51-Y 48-N)",51,48,0,1,100
1800002,1384489,2024-02-14,Senate,"Senate: Reported from Courts of Justice (6-Y 5-N)",6,5,0,0,11
1800002,1397363,2024-02-28,Senate,"Senate: Reported from Finance and Appropriations (10-Y 5-N)",10,5,0,0,15
1800002,1399713,2024-02-29,Senate,"Senate: Constitutional reading dispensed (39-Y 0-N)",39,0,0,1,40
1800002,1400924,2024-03-01,Senate,"Senate: Passed Senate (21-Y 19-N)",21,19,0,0,40
1800008,1368817,2024-01-24,House,"House: Subcommittee recommends reporting (7-Y 0-N)",7,0,0,2,9
1800008,1369889,2024-01-26,House,"House: Reported from Courts of Justice (21-Y 0-N)",21,0,0,1,22
1800008,1373641,2024-02-01,House,"House: VOTE: Block Vote Passage (99-Y 0-N)",99,0,0,1,100
1800008,1384520,2024-02-14,Senate,"Senate: Reported from Courts of Justice with substitute (15-Y 0-N)",15,0,0,0,15
1800008,1386711,2024-02-16,Senate,"Senate: Constitutional reading dispensed (38-Y 0-N)",38,0,0,2,40
1800008,1387416,2024-02-19,Senate,"Senate: Passed Senate (39-Y 0-N)",39,0,0,1,40
1800008,1390763,2024-02-21,House,"House: VOTE: Adoption (99-Y 0-N)",99,0,0,1,100
1800017,1371465,2024-01-30,House,"House: Subcommittee recommends reporting with amendments (8-Y 0-N)",8,0,0,0,8
1800017,1373817,2024-02-01,House,"House: Reported from Transportation with amendment(s) (22-Y 0-N)",22,0,0,0,22
1800017,1378365,2024-02-07,House,"House: VOTE: Block Vote Passage (100-Y 0-N)",100,0,0,0,100
1800017,1386428,2024-02-15,Senate,"Senate: Reported from Transportation with amendments (13-Y 2-N)",13,2,0,0,15
1800017,1387998,2024-02-19,Senate,"Senate: Constitutional reading dispensed (38-Y 0-N)",38,0,0,2,40
1800017,1388982,2024-02-20,Senate,"Senate: Defeated by Senate (18-Y 22-N)",18,22,0,0,40
1800017,1388983,2024-02-20,Senate,"Senate: Reconsideration of defeated action agreed to by Senate (40-Y 0-N)",40,0,0,0,40
1800017,1390554,2024-02-21,Senate,"Senate: Passed Senate with amendments (29-Y 11-N)",29,11,0,0,40
1800017,1393743,2024-02-23,House,"House: VOTE: Adoption (97-Y 0-N)",97,0,0,3,100
1800017,1430636,2024-04-17,House,"House: BLOCK VOTE: (100-Y 0-N)",100,0,0,0,100
1800017,1430637,2024-04-17,Senate,"Senate: Senate concurred in Governor's recommendation (40-Y 0-N)",40,0,0,0,40
1800027,1374329,2024-02-01,House,"House: Reported from Rules (17-Y 0-N)",17,0,0,1,18
1800027,1377641,2024-02-06,House,"House: VOTE: Block Vote Adoption (98-Y 0-N)",98,0,0,2,100
1800027,1394576,2024-02-26,Senate,"Senate: Reading waived (40-Y 0-N)",40,0,0,0,40
1800031,1374301,2024-02-01,House,"House: Subcommittee recommends reporting (8-Y 0-N)",8,0,0,0,8
1800031,1377700,2024-02-06,House,"House: Reported from Health and Human Services (22-Y 0-N)",22,0,0,0,22
1800031,1382171,2024-02-12,House,"House: VOTE: Block Vote Passage (100-Y 0-N)",100,0,0,0,100
1800031,1393183,2024-02-23,Senate,"Senate: Reported from Rehabilitation and Social Services with amendments (11-Y 1-N 3-A)",11,1,3,0,15
1800031,1394484,2024-02-26,Senate,"Senate: Constitutional reading dispensed (40-Y 0-N)",40,0,0,0,40
1800031,1395844,2024-02-27,Senate,"Senate: Passed Senate with amendments (34-Y 5-N)",34,5,0,1,40
1800031,1399078,2024-02-29,House,"House: VOTE: Adoption (97-Y 2-N)",97,2,0,1,100
1800036,1368114,2024-01-23,House,"House: Subcommittee recommends reporting (7-Y 0-N)",7,0,0,1,8
1800036,1369636,2024-01-25,House,"House: Reported from General Laws (22-Y 0-N)",22,0,0,0,22
1800036,1372706,2024-01-31,House,"House: VOTE: Block Vote Passage (100-Y 0-N)",100,0,0,0,100
1800036,1384443,2024-02-14,Senate,"Senate: Reported from General Laws and Technology (15-Y 0-N)",15,0,0,0,15
1800036,1386895,2024-02-16,Senate,"Senate: Constitutional reading dispensed (38-Y 0-N)",38,0,0,2,40
1800036,1387578,2024-02-19,Senate,"Senate: Passed Senate (39-Y 0-N)",39,0,0,1,40
1800053,1368657,2024-01-24,House,"House: Subcommittee recommends reporting with amendments (7-Y 0-N)",7,0,0,2,9
1800053,1370025,2024-01-26,House,"House: Reported from Courts of Justice with amendment(s) (21-Y 0-N)",21,0,0,1,22
1800053,1374114,2024-02-01,House,"House: VOTE: Block Vote Passage (99-Y 0-N)",99,0,0,1,100
1800053,1384551,2024-02-14,Senate,"Senate: Reported from Courts of Justice (15-Y 0-N)",15,0,0,0,15
1800053,1386728,2024-02-16,Senate,"Senate: Constitutional reading dispensed (38-Y 0-N)",38,0,0,2,40
1800053,1387446,2024-02-19,Senate,"Senate: Passed Senate (39-Y 0-N)",39,0,0,1,40
1800057,1367599,2024-01-22,House,"House: Subcommittee recommends laying on the table (5-Y 3-N)",5,3,0,0,8
1800063,1373409,2024-01-31,House,"House: Subcommittee recommends reporting with substitute (7-Y 1-N)",7,1,0,1,9
1800063,1375553,2024-02-02,House,"House: Reported from Courts of Justice with substitute (15-Y 6-N)",15,6,0,1,22
1800063,1378144,2024-02-07,House,"House: Subcommittee recommends reporting (5-Y 3-N)",5,3,0,1,9
1800063,1378821,2024-02-07,House,"House: Reported from Appropriations (13-Y 9-N)",13,9,0,0,22
1800063,1383557,2024-02-13,House,"House: VOTE: Passage (54-Y 45-N)",54,45,0,1,100
1800063,1390887,2024-02-21,Senate,"Senate: Rereferred from Courts of Justice (9-Y 0-N)",9,0,0,0,9
1800063,1393168,2024-02-23,Senate,"Senate: Reported from Rehabilitation and Social Services (15-Y 0-N)",15,0,0,0,15
1800063,1397357,2024-02-28,Senate,"Senate: Reported from Finance and Appropriations with substitute (10-Y 5-N)",10,5,0,0,15
1800063,1399672,2024-02-29,Senate,"Senate: Constitutional reading dispensed (39-Y 0-N)",39,0,0,1,40
1800063,1402169,2024-03-04,Senate,"Senate: Passed Senate with substitute (21-Y 18-N)",21,18,0,1,40
1800063,1403312,2024-03-05,House,"House: VOTE: REJECTED (1-Y 97-N)",1,97,0,2,100
1800063,1404451,2024-03-06,Senate,"Senate: Senate insisted on substitute (40-Y 0-N)",40,0,0,0,40
1800063,1406127,2024-03-08,Senate,"Senate: Conference report agreed to by Senate (23-Y 17-N)",23,17,0,0,40
1800063,1406470,2024-03-08,House,"House: VOTE: Adoption (53-Y 43-N)",53,43,0,4,100
1800065,1371137,2024-01-29,House,"House: Subcommittee recommends reporting with substitute (8-Y 0-N)",8,0,0,0,8
1800065,1374643,2024-02-02,House,"House: Reported from Privileges and Elections with substitute (22-Y 0-N)",22,0,0,0,22
1800065,1379870,2024-02-08,House,"House: VOTE: Block Vote Passage (98-Y 0-N)",98,0,0,2,100
1800065,1388836,2024-02-20,Senate,"Senate: Reported from Privileges and Elections (15-Y 0-N)",15,0,0,0,15
1800065,1392222,2024-02-22,Senate,"Senate: Constitutional reading dispensed (40-Y 0-N)",40,0,0,0,40
1800065,1393755,2024-02-23,Senate,"Senate: Passed Senate (39-Y 0-N)",39,0,0,1,40
1800069,1367028,2024-01-19,House,"House: Subcommittee recommends laying on the table (5-Y 3-N)",5,3,0,1,9
1800081,1379503,2024-02-08,Senate,"Senate: Reported from Education and Health with substitute (14-Y 0-N 1-A)",14,0,1,0,15
1800081,1379504,2024-02-08,Senate,"Senate: Constitutional reading dispensed (40-Y 0-N)",40,0,0,0,40
1800088,1366691,2024-01-18,House,"House: Subcommittee recommends reporting (7-Y 3-N)",7,3,0,0,10
1800088,1366951,2024-01-19,House,"House: Reported from Public Safety (12-Y 9-N)",12,9,0,1,22
1800088,1369943,2024-01-26,House,"House: VOTE: Passage (50-Y 45-N)",50,45,0,5,100
1800088,1394858,2024-02-26,Senate,"Senate: Reported from Courts of Justice with amendment (9-Y 5-N)",9,5,0,0,14
1800088,1398189,2024-02-28,Senate,"Senate: Reported from Finance and Appropriations (10-Y 5-N)",10,5,0,0,15
1800088,1399382,2024-02-29,Senate,"Senate: Constitutional reading dispensed (39-Y 0-N)",39,0,0,1,40
1800088,1402291,2024-03-04,Senate,"Senate: Passed Senate with amendment (20-Y 19-N)",20,19,0,1,40
1800088,1403601,2024-03-05,House,"House: VOTE: Adoption (50-Y 49-N)",50,49,0,1,100
1800095,1370847,2024-01-29,Senate,"Senate: Continued to 2025 in Commerce and Labor (15-Y 0-N)",15,0,0,0,15
1800100,1381094,2024-02-09,Senate,"Senate: Reading waived (39-Y 0-N)",39,0,0,1,40
1800100,1381849,2024-02-12,Senate,"Senate: Reading waived (39-Y 0-N)",39,0,0,1,40
1800100,1393197,2024-02-23,House,"House: Subcommittee recommends reporting (6-Y 0-N)",6,0,0,0,6
1800100,1393198,2024-02-23,House,"House: Reported from Rules (16-Y 0-N)",16,0,0,2,18
1800100,1397563,2024-02-28,House,"House: Reported from Appropriations (22-Y 0-N)",22,0,0,0,22
1800100,1401846,2024-03-04,House,"House: VOTE: Block Vote Adoption (97-Y 0-N)",97,0,0,3,100
1800107,1372023,2024-01-30,Senate,"Senate: Rereferred from Privileges and Elections (15-Y 0-N)",15,0,0,0,15
1800107,1374661,2024-02-02,Senate,"Senate: Failed to report (defeated) in Rules (7-Y 7-N)",7,7,0,0,14
1800123,1366576,2024-01-18,Senate,"Senate: Reported from Education and Health (15-Y 0-N)",15,0,0,0,15
1800123,1368536,2024-01-19,Senate,"Senate: Constitutional reading dispensed (37-Y 0-N)",37,0,0,3,40
1800123,1368537,2024-01-23,Senate,"Senate: Read third time and passed Senate (39-Y 0-N)",39,0,0,1,40
1800123,1385245,2024-02-15,House,"House: Subcommittee recommends reporting (8-Y 0-N)",8,0,0,0,8
1800123,1388499,2024-02-20,House,"House: Reported from Health and Human Services (21-Y 1-N)",21,1,0,0,22
1800123,1393358,2024-02-23,House,"House: VOTE: Passage (97-Y 1-N)",97,1,0,2,100
1800129,1378929,2024-02-07,Senate,"Senate: Reported from General Laws and Technology with substitute (15-Y 0-N)",15,0,0,0,15
1800129,1381409,2024-02-12,Senate,"Senate: Passed by indefinitely in Finance and Appropriations (13-Y 1-N)",13,1,0,0,14
1800136,1369921,2024-01-26,Senate,"Senate: Reported from Rules (14-Y 0-N)",14,0,0,0,14
1800136,1370919,2024-01-29,Senate,"Senate: Constitutional reading dispensed (39-Y 0-N)",39,0,0,1,40
1800136,1373182,2024-01-31,Senate,"Senate: Read third time and passed Senate (40-Y 0-N)",40,0,0,0,40
1800136,1393269,2024-02-23,House,"House: Reported from Rules (17-Y 0-N)",17,0,0,1,18
1800136,1398502,2024-02-28,House,"House: VOTE: Block Vote Passage (97-Y 0-N)",97,0,0,3,100
1800142,1377651,2024-02-06,Senate,"Senate: Continued to 2025 in Finance and Appropriations (15-Y 0-N)",15,0,0,0,15
1800150,1371236,2024-01-29,Senate,"Senate: Reported from Commerce and Labor with substitute (9-Y 6-N)",9,6,0,0,15
1800150,1372480,2024-01-31,Senate,"Senate: Constitutional reading dispensed (40-Y 0-N)",40,0,0,0,40
1800150,1376020,2024-02-05,Senate,"Senate: Read third time and passed Senate (21-Y 19-N)",21,19,0,0,40
1800150,1386141,2024-02-15,House,"House: Reported from Labor and Commerce (10-Y 9-N)",10,9,0,3,22
1800150,1388578,2024-02-20,House,"House: VOTE: Passage (51-Y 48-N)",51,48,0,1,100
1800164,1367203,2024-01-22,Senate,"Senate: Reported from Local Government (14-Y 0-N 1-A)",14,0,1,0,15
1800164,1368685,2024-01-23,Senate,"Senate: Constitutional reading dispensed (39-Y 0-N)",39,0,0,1,40
1800164,1369499,2024-01-25,Senate,"Senate: Read third time and passed Senate (39-Y 0-N 1-A)",39,0,1,0,40
1800164,1387060,2024-02-16,House,"House: Subcommittee recommends reporting (8-Y 0-N)",8,0,0,0,8
1800164,1387061,2024-02-16,House,"House: Reported from Counties, Cities and Towns (22-Y 0-N)",22,0,0,0,22
1800164,1390327,2024-02-21,House,"House: VOTE: Block Vote Passage (100-Y 0-N)",100,0,0,0,100
1800172,1366704,2024-01-18,Senate,"Senate: Reported from Transportation (15-Y 0-N)",15,0,0,0,15
1800172,1368350,2024-01-22,Senate,"Senate: Constitutional reading dispensed (40-Y 0-N)",40,0,0,0,40
1800172,1368351,2024-01-24,Senate,"Senate: Read third time and passed Senate (40-Y 0-N)",40,0,0,0,40
1800172,1391529,2024-02-22,House,"House: Reported from Transportation (22-Y 0-N)",22,0,0,0,22
1800172,1395868,2024-02-27,House,"House: VOTE: Block Vote Passage (97-Y 0-N)",97,0,0,3,100
1800178,1377411,2024-02-06,House,"House: Subcommittee recommends reporting with amendments (8-Y 0-N)",8,0,0,1,9
1800178,1378961,2024-02-07,House,"House: Reported from Finance with amendment(s) (17-Y 1-N)",17,1,0,4,22
1800178,1378962,2024-02-07,House,"House: Reported from Finance with amendment(s) (18-Y 1-N)",18,1,0,3,22
1800178,1382964,2024-02-13,House,"House: VOTE: Passage (94-Y 5-N)",94,5,0,1,100
1800178,1395913,2024-02-27,Senate,"Senate: Constitutional reading dispensed (39-Y 0-N)",39,0,0,1,40
1800178,1395914,2024-02-27,Senate,"Senate: Reported from Finance and Appropriations with amendment (15-Y 0-N)",15,0,0,0,15
1800178,1398734,2024-02-28,Senate,"Senate: Passed Senate with amendment (39-Y 0-N)",39,0,0,1,40
1800178,1400635,2024-03-01,House,"House: VOTE: Adoption (95-Y 1-N)",95,1,0,4,100
1800185,1368375,2024-01-24,Senate,"Senate: Reported from Finance and Appropriations (13-Y 0-N)",13,0,0,0,13
1800185,1369073,2024-01-25,Senate,"Senate: Constitutional reading dispensed (40-Y 0-N)",40,0,0,0,40
1800185,1371031,2024-01-29,Senate,"Senate: Read third time and passed Senate (40-Y 0-N)",40,0,0,0,40
1800185,1390256,2024-02-21,House,"House: Reported from Appropriations (22-Y 0-N)",22,0,0,0,22
1800185,1394359,2024-02-26,House,"House: VOTE: Block Vote Passage (96-Y 0-N)",96,0,0,4,100
1800192,1373542,2024-02-01,Senate,"Senate: Incorporated by Education and Health ",15,0,0,0,15
1800201,1364319,2024-01-15,Senate,"Senate: Continued to 2025in Courts of Justice (15-Y 0-N)",15,0,0,0,15
1800206,1369766,2024-01-26,Senate,"Senate: Reported from Rules (13-Y 1-N)",13,1,0,0,14
1800206,1370436,2024-01-29,Senate,"Senate: Constitutional reading dispensed (39-Y 0-N)",39,0,0,1,40
1800206,1372474,2024-01-31,Senate,"Senate: Read third time and passed Senate (39-Y 1-N)",39,1,0,0,40
1800206,1385504,2024-02-15,House,"House: Reported from Labor and Commerce (19-Y 0-N)",19,0,0,3,22
1800206,1389172,2024-02-20,House,"House: VOTE: Block Vote Passage (98-Y 0-N)",98,0,0,2,100
1800213,1379622,2024-02-08,Senate,"Senate: Reported from Education and Health with amendment (15-Y 0-N)",15,0,0,0,15
1800213,1379623,2024-02-08,Senate,"Senate: Constitutional reading dispensed (40-Y 0-N)",40,0,0,0,40
1800213,1383126,2024-02-13,Senate,"Senate: Read third time and passed Senate (38-Y 0-N)",38,0,0,2,40
1800213,1395627,2024-02-27,House,"House: Subcommittee recommends reporting with amendments (8-Y 0-N)",8,0,0,0,8
1800213,1397286,2024-02-28,House,"House: Reported from Education with amendment(s) (22-Y 0-N)",22,0,0,0,22
1800213,1402045,2024-03-04,House,"House: VOTE: Block Vote Passage (97-Y 0-N)",97,0,0,3,100
1800213,1403156,2024-03-05,Senate,"Senate: House amendments agreed to by Senate (40-Y 0-N)",40,0,0,0,40
1800213,1429760,2024-04-17,Senate,"Senate: Senate rejected Governor's recommendation (19-Y 21-N)",19,21,0,0,40
1800221,1366577,2024-01-18,Senate,"Senate: Reported from Education and Health (15-Y 0-N)",15,0,0,0,15
1800221,1379755,2024-02-08,Senate,"Senate: Incorporated by Finance and Appropriations ",15,0,0,0,15
1800228,1366499,2024-01-18,Senate,"Senate: Reported from Education and Health with substitute (14-Y 0-N 1-A)",14,0,1,0,15
1800228,1379774,2024-02-08,Senate,"Senate: Incorporated by Finance and Appropriations ",15,0,0,0,15
1800233,1370230,2024-01-29,Senate,"Senate: Reported from Local Government with amendment (15-Y 0-N)",15,0,0,0,15
1800233,1371940,2024-01-30,Senate,"Senate: Constitutional reading dispensed (40-Y 0-N)",40,0,0,0,40
1800233,1374253,2024-02-01,Senate,"Senate: Read third time and passed Senate (40-Y 0-N)",40,0,0,0,40
1800233,1386582,2024-02-16,House,"House: Reported from Counties, Cities and Towns (12-Y 10-N)",12,10,0,0,22
1800233,1390400,2024-02-21,House,"House: VOTE: Passage (51-Y 49-N)",51,49,0,0,100
1800242,1371043,2024-01-29,Senate,"Senate: Continued to 2025 in Commerce and Labor (15-Y 0-N)",15,0,0,0,15
1800256,1371432,2024-01-30,House,"House: Subcommittee recommends reporting with substitute (8-Y 0-N)",8,0,0,0,8
1800256,1372436,2024-01-31,House,"House: Reported from Education with substitute (21-Y 0-N)",21,0,0,1,22
1800256,1377703,2024-02-06,House,"House: VOTE: Block Vote Passage (99-Y 0-N)",99,0,0,1,100
1800256,1385353,2024-02-15,Senate,"Senate: Reported from Education and Health with substitute (15-Y 0-N)",15,0,0,0,15
1800256,1389841,2024-02-21,Senate,"Senate: Reported from Finance and Appropriations (14-Y 0-N)",14,0,0,0,14
1800256,1391954,2024-02-22,Senate,"Senate: Constitutional reading dispensed (40-Y 0-N)",40,0,0,0,40
1800256,1393967,2024-02-23,Senate,"Senate: Passed Senate with substitute (39-Y 0-N)",39,0,0,1,40
1800256,1396358,2024-02-27,House,"House: VOTE: Adoption (97-Y 0-N)",97,0,0,3,100
1800262,1369155,2024-01-25,House,"House: Subcommittee recommends reporting (8-Y 0-N)",8,0,0,1,9
1800262,1369818,2024-01-26,House,"House: Reported from Counties, Cities and Towns (19-Y 1-N)",19,1,0,2,22
1800262,1373629,2024-02-01,House,"House: VOTE: Passage (95-Y 4-N)",95,4,0,1,100
1800262,1387983,2024-02-19,Senate,"Senate: Rereferred from Local Government (13-Y 0-N)",13,0,0,0,13
1800262,1397978,2024-02-28,Senate,"Senate: Reported from General Laws and Technology (11-Y 3-N 1-A)",11,3,1,0,15
1800262,1400940,2024-03-01,Senate,"Senate: Constitutional reading dispensed (40-Y 0-N)",40,0,0,0,40
1800262,1402071,2024-03-04,Senate,"Senate: Passed Senate (29-Y 10-N 1-A)",29,10,1,0,40
1800262,1402072,2024-03-04,Senate,"Senate: Reconsideration of Senate passage agreed to by Senate (40-Y 0-N)",40,0,0,0,40
1800262,1402073,2024-03-04,Senate,"Senate: Passed Senate (30-Y 9-N 1-A)",30,9,1,0,40
1800270,1368980,2024-01-25,Senate,"Senate: Passed by indefinitely in Education and Health (13-Y 2-N)",13,2,0,0,15
1800276,1370621,2024-01-29,House,"House: Subcommittee recommends striking from docket (7-Y 0-N)",7,0,0,1,8
1800284,1377320,2024-02-06,Senate,"Senate: Passed by indefinitely in Finance and Appropriations (15-Y 0-N)",15,0,0,0,15
1800292,1382710,2024-02-12,Senate,"Senate: Reported from Courts of Justice with substitute (8-Y 6-N)",8,6,0,0,14
1800292,1383519,2024-02-13,Senate,"Senate: Constitutional reading dispensed (40-Y 0-N)",40,0,0,0,40
1800292,1383520,2024-02-13,Senate,"Senate: Passed Senate (23-Y 17-N)",23,17,0,0,40
1800292,1383521,2024-02-13,Senate,"Senate: Constitutional reading dispensed (40-Y 0-N)",40,0,0,0,40
1800292,1390827,2024-02-21,House,"House: Subcommittee recommends reporting with substitute (5-Y 3-N)",5,3,0,1,9
1800292,1393926,2024-02-23,House,"House: Reported from Courts of Justice with substitute (12-Y 9-N)",12,9,0,1,22
1800292,1398445,2024-02-28,House,"House: VOTE: Passage (52-Y 48-N)",52,48,0,0,100
1800292,1400587,2024-03-01,Senate,"Senate: House substitute agreed to by Senate (23-Y 17-N)",23,17,0,0,40
1800298,1367656,2024-01-23,Senate,"Senate: Reported from Finance and Appropriations (11-Y 3-N)",11,3,0,0,14
1800298,1368747,2024-01-24,Senate,"Senate: Constitutional reading dispensed (40-Y 0-N)",40,0,0,0,40
1800298,1369914,2024-01-26,Senate,"Senate: Read third time and passed Senate (27-Y 11-N)",27,11,0,2,40
1800305,1368633,2024-01-24,Senate,"Senate: Reported from General Laws and Technology (12-Y 2-N 1-A)",12,2,1,0,15
1800305,1376980,2024-02-06,Senate,"Senate: Continued to 2025 in Finance and Appropriations (14-Y 0-N)",14,0,0,0,14
1800311,1366845,2024-01-18,Senate,"Senate: Reported from Transportation (14-Y 0-N)",14,0,0,0,14
1800311,1367631,2024-01-23,Senate,"Senate: Reported from Finance and Appropriations with substitute (14-Y 0-N)",14,0,0,0,14
1800311,1368603,2024-01-24,Senate,"Senate: Constitutional reading dispensed (40-Y 0-N)",40,0,0,0,40
1800311,1374418,2024-02-01,Senate,"Senate: Engrossment reconsidered by Senate (40-Y 0-N)",40,0,0,0,40
1800311,1374419,2024-02-01,Senate,"Senate: Constitutional reading dispensed (40-Y 0-N)",40,0,0,0,40
1800311,1374420,2024-02-01,Senate,"Senate: Passed Senate (40-Y 0-N)",40,0,0,0,40
1800311,1391555,2024-02-22,House,"House: Reported from Transportation with substitute (22-Y 0-N)",22,0,0,0,22
1800311,1395316,2024-02-26,House,"House: Reported from Appropriations (22-Y 0-N)",22,0,0,0,22
1800311,1398527,2024-02-28,House,"House: VOTE: Block Vote Passage (97-Y 0-N)",97,0,0,3,100
1800311,1401214,2024-03-01,Senate,"Senate: House substitute agreed to by Senate (39-Y 0-N)",39,0,0,1,40
1800316,1373650,2024-02-01,Senate,"Senate: Reported from Education and Health with substitute (15-Y 0-N)",15,0,0,0,15
1800316,1379683,2024-02-08,Senate,"Senate: Continued to 2025 in Finance and Appropriations (15-Y 0-N)",15,0,0,0,15
1800326,1375603,2024-02-05,Senate,"Senate: Reported from Courts of Justice (15-Y 0-N)",15,0,0,0,15
1800326,1376852,2024-02-06,Senate,"Senate: Constitutional reading dispensed (39-Y 0-N)",39,0,0,1,40
1800326,1378644,2024-02-07,Senate,"Senate: Constitutional reading dispensed (40-Y 0-N)",40,0,0,0,40
1800326,1378645,2024-02-07,Senate,"Senate: Passed Senate (40-Y 0-N)",40,0,0,0,40
1800326,1386818,2024-02-16,House,"House: Reported from Courts of Justice (22-Y 0-N)",22,0,0,0,22
1800326,1389984,2024-02-21,House,"House: VOTE: Block Vote Passage (100-Y 0-N)",100,0,0,0,100
1800333,1367349,2024-01-22,Senate,"Senate: Continued to 2025 in Local Government (12-Y 3-N)",12,3,0,0,15
1800338,1367240,2024-01-22,Senate,"Senate: Reported from Local Government with substitute (15-Y 0-N)",15,0,0,0,15
1800338,1371530,2024-01-30,Senate,"Senate: Reported from Finance and Appropriations (14-Y 0-N)",14,0,0,0,14
1800338,1372926,2024-01-31,Senate,"Senate: Constitutional reading dispensed (40-Y 0-N)",40,0,0,0,40
1800338,1432085,2024-02-21,House,"House: Reported from Appropriations with substitute (22-Y 0-N)",22,0,0,0,22
1800338,1432086,2024-02-26,House,"House: VOTE: Block Vote Passage (96-Y 0-N)",96,0,0,4,100
1800338,1432087,2024-02-28,Senate,"Senate: House substitute rejected by Senate (0-Y 39-N)",0,39,0,1,40
1800338,1432088,2024-03-04,Senate,"Senate: Senate acceded to request (38-Y 0-N)",38,0,0,2,40
1800338,1432089,2024-03-07,House,"House: VOTE: Adoption (97-Y 0-N)",97,0,0,3,100
1800338,1432090,2024-03-08,Senate,"Senate: Conference report agreed to by Senate (40-Y 0-N)",40,0,0,0,40
1800345,1376103,2024-02-05,Senate,"Senate: Incorporated by Commerce and Labor ",15,0,0,0,15
1800352,1367748,2024-01-23,Senate,"Senate: Reported from Privileges and Elections (14-Y 0-N)",14,0,0,0,14
1800352,1369228,2024-01-25,Senate,"Senate: Constitutional reading dispensed (40-Y 0-N)",40,0,0,0,40
1800352,1370815,2024-01-29,Senate,"Senate: Read third time and passed Senate (40-Y 0-N)",40,0,0,0,40
1800352,1386613,2024-02-16,House,"House: Reported from Privileges and Elections with substitute (21-Y 0-N)",21,0,0,1,22
1800352,1400962,2024-03-01,House,"House: Reported from Privileges and Elections (21-Y 0-N)",21,0,0,1,22
1800352,1404653,2024-03-06,House,"House: VOTE: Passage (97-Y 1-N)",97,1,0,2,100
1800352,1405781,2024-03-07,Senate,"Senate: House substitute agreed to by Senate (40-Y 0-N)",40,0,0,0,40
1800357,1364313,2024-01-15,Senate,"Senate: Reported from Courts of Justice (15-Y 0-N)",15,0,0,0,15
1800357,1372971,2024-01-31,Senate,"Senate: Reported from Finance and Appropriations with substitute (15-Y 0-N)",15,0,0,0,15
1800357,1373985,2024-02-01,Senate,"Senate: Constitutional reading dispensed (40-Y 0-N)",40,0,0,0,40
1800357,1376235,2024-02-05,Senate,"Senate: Read third time and passed Senate (40-Y 0-N)",40,0,0,0,40
1800357,1393313,2024-02-23,House,"House: Reported from Public Safety (20-Y 1-N)",20,1,0,1,22
1800357,1398703,2024-02-28,House,"House: VOTE: Passage (99-Y 0-N)",99,0,0,1,100
1800529,1377128,2024-02-06,House,"House: Subcommittee recommends reporting (5-Y 2-N)",5,2,0,1,8
1800529,1379559,2024-02-08,House,"House: Reported from Health and Human Services (13-Y 8-N)",13,8,0,1,22
1800529,1383341,2024-02-13,House,"House: VOTE: Passage (54-Y 45-N)",54,45,0,1,100
1800529,1391505,2024-02-22,Senate,"Senate: Reported from Education and Health (9-Y 5-N)",9,5,0,0,14
1800529,1393784,2024-02-23,Senate,"Senate: Constitutional reading dispensed (38-Y 0-N)",38,0,0,2,40
1800529,1394496,2024-02-26,Senate,"Senate: Passed Senate (21-Y 19-N)",21,19,0,0,40
1800530,1379864,2024-02-08,House,"House: Reported from Labor and Commerce with substitute (21-Y 1-N)",21,1,0,0,22
1800530,1383510,2024-02-13,House,"House: VOTE: Defeated (48-Y 50-N)",48,50,0,2,100
1800531,1373546,2024-02-01,House,"House: Subcommittee recommends reporting with substitute (8-Y 0-N)",8,0,0,0,8
1800531,1377444,2024-02-06,House,"House: Reported from Health and Human Services with substitute (22-Y 0-N)",22,0,0,0,22
1800531,1378370,2024-02-07,House,"House: Subcommittee recommends reporting (7-Y 0-N)",7,0,0,2,9
1800531,1380627,2024-02-09,House,"House: Reported from Appropriations (20-Y 0-N)",20,0,0,2,22
1800531,1383664,2024-02-13,House,"House: VOTE: Block Vote Passage (99-Y 0-N)",99,0,0,1,100
1800531,1391483,2024-02-22,Senate,"Senate: Reported from Education and Health (15-Y 0-N)",15,0,0,0,15
1800531,1393950,2024-02-23,Senate,"Senate: Constitutional reading dispensed (38-Y 0-N)",38,0,0,2,40
1800531,1394610,2024-02-26,Senate,"Senate: Passed Senate (40-Y 0-N)",40,0,0,0,40
1800533,1366636,2024-01-18,House,"House: Subcommittee recommends reporting (8-Y 0-N)",8,0,0,0,8
1800533,1367786,2024-01-23,House,"House: Reported from Health and Human Services (21-Y 1-N)",21,1,0,0,22
1800533,1371009,2024-01-29,House,"House: VOTE: Passage (94-Y 5-N)",94,5,0,1,100
1800533,1386679,2024-02-16,Senate,"Senate: Reported from Rehabilitation and Social Services (14-Y 0-N)",14,0,0,0,14
1800533,1388079,2024-02-19,Senate,"Senate: Constitutional reading dispensed (38-Y 0-N)",38,0,0,2,40
1800533,1388600,2024-02-20,Senate,"Senate: Passed Senate (40-Y 0-N)",40,0,0,0,40
1800535,1367862,2024-01-23,House,"House: Stricken from docket by Health and Human Services (22-Y 0-N)",22,0,0,0,22
1800536,1366836,2024-01-18,House,"House: Subcommittee recommends reporting with amendments (8-Y 0-N)",8,0,0,0,8
1800536,1367927,2024-01-23,House,"House: Reported from Health and Human Services with amendment(s) (16-Y 6-N)",16,6,0,0,22
1800536,1371249,2024-01-29,House,"House: VOTE: Passage (66-Y 32-N)",66,32,0,2,100
1800536,1385523,2024-02-15,Senate,"Senate: Rereferred from Education and Health (11-Y 0-N 1-A)",11,0,1,0,12
1800536,1400694,2024-03-01,Senate,"Senate: Continued to 2025 in Rehabilitation and Social Services (8-Y 6-N)",8,6,0,0,14
1800537,1369480,2024-01-25,House,"House: Subcommittee failed to recommend reporting (2-Y 6-N)",2,6,0,0,8
1800541,1370786,2024-01-29,House,"House: Subcommittee recommends laying on the table (5-Y 2-N)",5,2,0,2,9
1800542,1367628,2024-01-23,House,"House: Subcommittee recommends reporting with amendments (5-Y 2-N)",5,2,0,1,8
1800542,1368481,2024-01-24,House,"House: Reported from Education with amendment(s) (13-Y 8-N)",13,8,0,1,22
1800542,1371754,2024-01-30,House,"House: VOTE: Passage (54-Y 45-N)",54,45,0,1,100
1800542,1385477,2024-02-15,Senate,"Senate: Reported from Education and Health (9-Y 6-N)",9,6,0,0,15
1800542,1386935,2024-02-16,Senate,"Senate: Constitutional reading dispensed (38-Y 0-N)",38,0,0,2,40
1800542,1387663,2024-02-19,Senate,"Senate: Passed Senate (22-Y 17-N)",22,17,0,1,40
1800542,1430131,2024-04-17,House,"House: VOTE: Adoption (0-Y 100-N)",0,100,0,0,100
1800544,1366906,2024-01-19,House,"House: Subcommittee recommends laying on the table (5-Y 3-N)",5,3,0,1,9
1800545,1372520,2024-01-31,House,"House: Subcommittee recommends reporting with amendments (5-Y 3-N)",5,3,0,0,8
1800545,1375820,2024-02-05,House,"House: Reported from Education with amendment(s) (12-Y 10-N)",12,10,0,0,22
1800545,1380839,2024-02-09,House,"House: VOTE: Passage (53-Y 43-N)",53,43,0,4,100
1800545,1399183,2024-02-29,Senate,"Senate: Reported from Education and Health (9-Y 6-N)",9,6,0,0,15
1800545,1401010,2024-03-01,Senate,"Senate: Constitutional reading dispensed (40-Y 0-N)",40,0,0,0,40
1800545,1401844,2024-03-04,Senate,"Senate: Passed Senate (21-Y 19-N)",21,19,0,0,40
1800545,1430280,2024-04-17,House,"House: VOTE: Adoption (0-Y 100-N)",0,100,0,0,100
1800546,1371018,2024-01-29,House,"House: Subcommittee recommends reporting (6-Y 0-N)",6,0,0,0,6
1800546,1374326,2024-02-01,House,"House: Reported from Rules (18-Y 0-N)",18,0,0,0,18
1800547,1377571,2024-02-06,House,"House: Subcommittee recommends laying on the table (7-Y 0-N)",7,0,0,0,7
1800548,1367825,2024-01-23,House,"House: Subcommittee recommends striking from docket (8-Y 0-N)",8,0,0,0,8
1800548,1369162,2024-01-25,House,"House: Stricken from docket by Transportation (21-Y 0-N)",21,0,0,1,22
1800550,1366639,2024-01-18,House,"House: Subcommittee recommends reporting with amendments (8-Y 0-N)",8,0,0,0,8
1800550,1369203,2024-01-25,House,"House: Reported from Health and Human Services with substitute (22-Y 0-N)",22,0,0,0,22
1800550,1374771,2024-02-02,House,"House: Subcommittee recommends laying on the table (8-Y 0-N)",8,0,0,1,9
1800551,1371916,2024-01-30,House,"House: Subcommittee recommends reporting (8-Y 0-N)",8,0,0,0,8
1800551,1372722,2024-01-31,House,"House: Reported from Education (21-Y 0-N)",21,0,0,1,22
1800551,1377543,2024-02-06,House,"House: VOTE: Block Vote Passage (99-Y 0-N)",99,0,0,1,100
1800551,1391509,2024-02-22,Senate,"Senate: Reported from Education and Health (15-Y 0-N)",15,0,0,0,15
1800551,1393953,2024-02-23,Senate,"Senate: Constitutional reading dispensed (38-Y 0-N)",38,0,0,2,40
1800551,1394709,2024-02-26,Senate,"Senate: Passed Senate (40-Y 0-N)",40,0,0,0,40
1800552,1367192,2024-01-22,House,"House: Subcommittee recommends reporting with substitute (7-Y 3-N)",7,3,0,0,10
1800552,1371053,2024-01-29,House,"House: Reported from Education with substitute (14-Y 8-N)",14,8,0,0,22
1800552,1374889,2024-02-02,House,"House: VOTE: Passage (91-Y 9-N)",91,9,0,0,100
1800552,1385512,2024-02-15,Senate,"Senate: Reported from Education and Health with substitute (15-Y 0-N)",15,0,0,0,15
1800552,1386513,2024-02-16,Senate,"Senate: Constitutional reading dispensed (38-Y 0-N)",38,0,0,2,40
1800552,1387701,2024-02-19,Senate,"Senate: Passed Senate (39-Y 0-N)",39,0,0,1,40
1800552,1390076,2024-02-21,House,"House: VOTE: REJECTED (0-Y 100-N)",0,100,0,0,100
1800552,1393802,2024-02-23,Senate,"Senate: Senate insisted on amendment (39-Y 0-N)",39,0,0,1,40
1800552,1402827,2024-03-05,House,"House: VOTE: Adoption (92-Y 6-N)",92,6,0,2,100
1800552,1404693,2024-03-06,Senate,"Senate: Conference report agreed to by Senate (39-Y 1-N)",39,1,0,0,40
1800553,1368400,2024-01-24,House,"House: Subcommittee recommends reporting (8-Y 0-N)",8,0,0,1,9
1800553,1371208,2024-01-29,House,"House: Reported from Appropriations (21-Y 0-N)",21,0,0,1,22
1800553,1374575,2024-02-02,House,"House: VOTE: Block Vote Passage (92-Y 0-N)",92,0,0,8,100
1800553,1390742,2024-02-21,Senate,"Senate: Reported from Finance and Appropriations (14-Y 0-N)",14,0,0,0,14
1800553,1392508,2024-02-22,Senate,"Senate: Constitutional reading dispensed (40-Y 0-N)",40,0,0,0,40
1800553,1393968,2024-02-23,Senate,"Senate: Passed Senate (39-Y 0-N)",39,0,0,1,40
1800556,1368182,2024-01-24,House,"House: Subcommittee recommends reporting (10-Y 0-N)",10,0,0,0,10
1800556,1370457,2024-01-29,House,"House: Reported from Communications, Technology and Innovation (22-Y 0-N)",22,0,0,0,22
1800556,1376807,2024-02-06,House,"House: Subcommittee recommends reporting (8-Y 0-N)",8,0,0,0,8
1800556,1378478,2024-02-07,House,"House: Reported from Education with substitute (19-Y 0-N)",19,0,2,1,22
1800556,1382138,2024-02-12,House,"House: VOTE: Adoption (51-Y 48-N)",51,48,0,1,100
1800556,1383651,2024-02-13,House,"House: VOTE: Defeated (47-Y 51-N)",47,51,0,2,100
1800558,1378469,2024-02-07,House,"House: Subcommittee recommends reporting (8-Y 0-N)",8,0,0,0,8
1800558,1379925,2024-02-08,House,"House: Reported from Health and Human Services (22-Y 0-N)",22,0,0,0,22
1800558,1383769,2024-02-13,House,"House: VOTE: Passage (96-Y 3-N)",96,3,0,1,100
1800558,1399853,2024-02-29,Senate,"Senate: Reported from Education and Health (15-Y 0-N)",15,0,0,0,15
1800558,1401040,2024-03-01,Senate,"Senate: Constitutional reading dispensed (40-Y 0-N)",40,0,0,0,40
1800558,1402301,2024-03-04,Senate,"Senate: Passed Senate (39-Y 0-N)",39,0,0,1,40
1800559,1367757,2024-01-23,House,"House: Subcommittee recommends reporting (7-Y 1-N)",7,1,0,1,9
1800559,1369395,2024-01-25,House,"House: Reported from General Laws (21-Y 1-N)",21,1,0,0,22
1800559,1373181,2024-01-31,House,"House: VOTE: Passage (93-Y 5-N)",93,5,0,2,100
1800559,1386677,2024-02-16,Senate,"Senate: Reported from Rehabilitation and Social Services (12-Y 0-N)",12,0,0,0,12
1800559,1387380,2024-02-19,Senate,"Senate: Constitutional reading dispensed (38-Y 0-N)",38,0,0,2,40
1800559,1388657,2024-02-20,Senate,"Senate: Passed Senate (40-Y 0-N)",40,0,0,0,40
1800560,1369278,2024-01-25,House,"House: Subcommittee recommends reporting (5-Y 3-N)",5,3,0,0,8
1800560,1371998,2024-01-30,House,"House: Reported from Labor and Commerce (12-Y 10-N)",12,10,0,0,22
1800561,1367799,2024-01-23,House,"House: Subcommittee recommends laying on the table (7-Y 0-N)",7,0,0,1,8
1800562,1368247,2024-01-24,House,"House: Subcommittee recommends reporting with substitute (6-Y 4-N)",6,4,0,0,10
1800562,1372442,2024-01-31,House,"House: Reported from Agriculture, Chesapeake and Natural Resources with substitute (15-Y 7-N)",15,7,0,0,22
1800562,1378327,2024-02-07,House,"House: Subcommittee recommends reporting with substitute (7-Y 0-N)",7,0,1,1,9
1800562,1378328,2024-02-07,House,"House: Reported from Appropriations with substitute (21-Y 0-N)",21,0,1,0,22
1800562,1382937,2024-02-13,House,"House: VOTE: Passage (79-Y 19-N 1-A)",79,19,1,1,100
1800562,1394510,2024-02-26,Senate,"Senate: Rereferred from Agriculture, Conservation and Natural Resources (13-Y 0-N)",13,0,0,0,13
1800562,1395942,2024-02-27,Senate,"Senate: Passed by indefinitely in Finance and Appropriations (12-Y 3-N)",12,3,0,0,15
1800563,1367115,2024-01-19,House,"House: Subcommittee recommends laying on the table (5-Y 3-N)",5,3,0,1,9
1800564,1371444,2024-01-30,House,"House: Subcommittee recommends reporting with amendments (7-Y 1-N)",7,1,0,0,8
1800564,1372668,2024-01-31,House,"House: Reported from Education (16-Y 6-N)",16,6,0,0,22
1800564,1376277,2024-02-05,House,"House: Subcommittee recommends laying on the table (8-Y 0-N)",8,0,0,1,9
1800566,1370957,2024-01-29,House,"House: Subcommittee recommends reporting with substitute (5-Y 3-N)",5,3,0,1,9
1800566,1375854,2024-02-02,House,"House: Reported from Courts of Justice with substitute (13-Y 8-N)",13,8,0,1,22
1800567,1367328,2024-01-22,House,"House: Subcommittee recommends laying on the table (5-Y 3-N)",5,3,0,1,9
1800569,1373969,2024-02-01,House,"House: Subcommittee recommends reporting with substitute (8-Y 0-N)",8,0,0,1,9
1800570,1368221,2024-01-24,House,"House: Subcommittee recommends reporting (8-Y 0-N)",8,0,0,0,8
1800570,1370418,2024-01-29,House,"House: Reported from Education (21-Y 0-N)",21,0,1,0,22
1800570,1374742,2024-02-02,House,"House: VOTE: Passage (100-Y 0-N)",100,0,0,0,100
1800570,1391548,2024-02-22,Senate,"Senate: Reported from Education and Health (15-Y 0-N)",15,0,0,0,15
1800570,1394005,2024-02-23,Senate,"Senate: Constitutional reading dispensed (38-Y 0-N)",38,0,0,2,40
1800570,1394766,2024-02-26,Senate,"Senate: Passed Senate (40-Y 0-N)",40,0,0,0,40
1800571,1372102,2024-01-30,House,"House: Stricken from docket by Labor and Commerce (22-Y 0-N)",22,0,0,0,22
1800572,1375698,2024-02-05,House,"House: Subcommittee recommends laying on the table (5-Y 3-N)",5,3,0,1,9
1800573,1371494,2024-01-30,House,"House: Subcommittee recommends laying on the table (5-Y 3-N)",5,3,0,0,8
1800575,1373548,2024-02-01,House,"House: Subcommittee recommends reporting with substitute (6-Y 2-N)",6,2,0,0,8
1800575,1374733,2024-02-02,House,"House: Reported from Counties, Cities and Towns with substitute (13-Y 9-N)",13,9,0,0,22
1800575,1380181,2024-02-08,House,"House: VOTE: Passage (53-Y 44-N)",53,44,0,3,100
1800575,1394337,2024-02-26,Senate,"Senate: Reported from Local Government (9-Y 5-N)",9,5,0,0,14
1800575,1396367,2024-02-27,Senate,"Senate: Constitutional reading dispensed (39-Y 0-N)",39,0,0,1,40
1800575,1397849,2024-02-28,Senate,"Senate: Passed Senate (22-Y 17-N)",22,17,0,1,40
1800576,1374341,2024-02-01,House,"House: Subcommittee recommends reporting with substitute (3-Y 2-N)",3,2,0,3,8
1800576,1377305,2024-02-06,House,"House: Reported from General Laws with substitute (10-Y 9-N)",10,9,0,3,22
1800576,1380656,2024-02-09,House,"House: Subcommittee recommends reporting with amendments (4-Y 3-N)",4,3,0,2,9
1800577,1367180,2024-01-22,House,"House: Subcommittee recommends laying on the table (5-Y 3-N)",5,3,0,1,9
1800578,1373380,2024-01-31,House,"House: Subcommittee recommends reporting with substitute (7-Y 1-N)",7,1,0,1,9
1800578,1375876,2024-02-02,House,"House: Reported from Courts of Justice with substitute (17-Y 4-N)",17,4,0,1,22
1800578,1379549,2024-02-08,House,"House: VOTE: Passage (75-Y 23-N)",75,23,0,2,100
1800578,1387326,2024-02-19,Senate,"Senate: Reported from Courts of Justice (14-Y 0-N)",14,0,0,0,14
1800578,1389557,2024-02-20,Senate,"Senate: Constitutional reading dispensed (39-Y 0-N)",39,0,0,1,40
1800578,1390994,2024-02-21,Senate,"Senate: Passed Senate with substitute (26-Y 14-N)",26,14,0,0,40
1800578,1394029,2024-02-23,House,"House: VOTE: REJECTED (2-Y 95-N)",2,95,0,3,100
1800578,1396683,2024-02-27,Senate,"Senate: Senate insisted on substitute (39-Y 0-N)",39,0,0,1,40
1800579,1371792,2024-01-30,House,"House: Subcommittee recommends reporting with substitute (7-Y 1-N)",7,1,0,1,9
1800579,1374287,2024-02-01,House,"House: Reported from General Laws with substitute (22-Y 0-N)",22,0,0,0,22
1800579,1378763,2024-02-07,House,"House: VOTE: Passage (97-Y 3-N)",97,3,0,0,100
1800579,1384964,2024-02-14,Senate,"Senate: Reported from General Laws and Technology (13-Y 0-N)",13,0,0,0,13
1800579,1395890,2024-02-27,Senate,"Senate: Constitutional reading dispensed (39-Y 0-N)",39,0,0,1,40
1800579,1395891,2024-02-27,Senate,"Senate: Reported from Finance and Appropriations with substitute (15-Y 0-N)",15,0,0,0,15
1800579,1398279,2024-02-28,Senate,"Senate: Passed Senate with substitute (39-Y 0-N)",39,0,0,1,40
1800579,1400479,2024-03-01,House,"House: VOTE: Adoption (90-Y 5-N)",90,5,0,5,100
1800580,1366554,2024-01-18,House,"House: Subcommittee recommends reporting with amendments (8-Y 0-N)",8,0,0,0,8
1800580,1367769,2024-01-23,House,"House: Reported from Health and Human Services with amendment(s) (22-Y 0-N)",22,0,0,0,22
1800580,1371075,2024-01-29,House,"House: VOTE: Block Vote Passage (98-Y 0-N)",98,0,0,2,100
1800580,1393218,2024-02-23,Senate,"Senate: Reported from Rehabilitation and Social Services with amendment (15-Y 0-N)",15,0,0,0,15
1800580,1394634,2024-02-26,Senate,"Senate: Constitutional reading dispensed (40-Y 0-N)",40,0,0,0,40
1800580,1395974,2024-02-27,Senate,"Senate: Passed Senate with amendment (39-Y 0-N)",39,0,0,1,40
1800580,1399177,2024-02-29,House,"House: VOTE: Adoption (100-Y 0-N)",100,0,0,0,100
1800581,1367798,2024-01-23,House,"House: Reported from Health and Human Services (22-Y 0-N)",22,0,0,0,22
1800581,1370938,2024-01-29,House,"House: VOTE: Block Vote Passage (98-Y 0-N)",98,0,0,2,100
1800581,1391476,2024-02-22,Senate,"Senate: Reported from Education and Health (15-Y 0-N)",15,0,0,0,15
1800581,1393921,2024-02-23,Senate,"Senate: Constitutional reading dispensed (38-Y 0-N)",38,0,0,2,40
1800581,1394697,2024-02-26,Senate,"Senate: Passed Senate (40-Y 0-N)",40,0,0,0,40
1800582,1372255,2024-01-30,House,"House: Subcommittee recommends reporting with amendments (8-Y 0-N)",8,0,0,1,9
1800582,1374306,2024-02-01,House,"House: Reported from General Laws with amendment(s) (22-Y 0-N)",22,0,0,0,22
1800582,1378544,2024-02-07,House,"House: VOTE: Passage (99-Y 1-N)",99,1,0,0,100
1800582,1384987,2024-02-14,Senate,"Senate: Reported from General Laws and Technology (14-Y 1-N)",14,1,0,0,15
1800582,1390235,2024-02-21,Senate,"Senate: Reported from Finance and Appropriations with amendment (12-Y 2-N)",12,2,0,0,14
1800582,1391888,2024-02-22,Senate,"Senate: Constitutional reading dispensed (40-Y 0-N)",40,0,0,0,40
1800582,1393625,2024-02-23,Senate,"Senate: Passed Senate with amendment (38-Y 1-N)",38,1,0,1,40
1800582,1393626,2024-02-23,Senate,"Senate: Reconsideration of Senate passage agreed to by Senate (39-Y 0-N)",39,0,0,1,40
1800582,1393627,2024-02-23,Senate,"Senate: Passed Senate with amendment (38-Y 1-N)",38,1,0,1,40
1800582,1396503,2024-02-27,House,"House: VOTE: Adoption (96-Y 0-N)",96,0,0,4,100
1800583,1368136,2024-01-23,House,"House: Subcommittee recommends reporting (7-Y 0-N)",7,0,0,0,7
1800583,1369312,2024-01-25,House,"House: Reported from Labor and Commerce (21-Y 0-N)",21,0,0,1,22
1800583,1373198,2024-01-31,House,"House: VOTE: Block Vote Passage (100-Y 0-N)",100,0,0,0,100
1800583,1388051,2024-02-19,Senate,"Senate: Reported from Commerce and Labor with amendments (13-Y 1-N)",13,1,0,0,14
1800583,1390260,2024-02-21,Senate,"Senate: Continued to 2025 in Finance and Appropriations (13-Y 1-N)",13,1,0,0,14
1800584,1373588,2024-02-01,House,"House: Subcommittee recommends reporting (8-Y 0-N)",8,0,0,0,8
1800584,1374879,2024-02-02,House,"House: Reported from Counties, Cities and Towns (21-Y 0-N)",21,0,0,1,22
1800584,1380386,2024-02-08,House,"House: VOTE: Passage (88-Y 10-N)",88,10,0,2,100
1800584,1387602,2024-02-19,Senate,"Senate: Reported from Local Government (13-Y 1-N)",13,1,0,0,14
1800584,1389017,2024-02-20,Senate,"Senate: Constitutional reading dispensed (39-Y 0-N)",39,0,0,1,40
1800584,1390614,2024-02-21,Senate,"Senate: Passed Senate (39-Y 1-N)",39,1,0,0,40
1800585,1366532,2024-01-18,House,"House: Subcommittee recommends reporting with substitute (7-Y 1-N)",7,1,0,0,8
1800585,1371526,2024-01-30,House,"House: Tabled in Health and Human Services (12-Y 10-N)",12,10,0,0,22
1800586,1377190,2024-02-06,House,"House: Subcommittee recommends reporting (5-Y 2-N)",5,2,0,1,8
1800586,1379621,2024-02-08,House,"House: Reported from Health and Human Services (17-Y 5-N)",17,5,0,0,22
1800586,1382787,2024-02-13,House,"House: VOTE: Passage (61-Y 37-N)",61,37,0,2,100
1800586,1399225,2024-02-29,Senate,"Senate: Reported from Education and Health with substitute (13-Y 0-N 2-A)",13,0,2,0,15
1800586,1400988,2024-03-01,Senate,"Senate: Constitutional reading dispensed (40-Y 0-N)",40,0,0,0,40
1800586,1401661,2024-03-04,Senate,"Senate: Passed Senate with substitute (39-Y 0-N)",39,0,0,1,40
1800586,1402819,2024-03-05,House,"House: VOTE: Adoption (74-Y 26-N)",74,26,0,0,100
1800587,1367077,2024-01-19,House,"House: Subcommittee recommends striking from docket (8-Y 0-N)",8,0,0,1,9
1800588,1367994,2024-01-23,House,"House: Subcommittee recommends reporting (8-Y 0-N)",8,0,0,1,9
1800588,1369268,2024-01-25,House,"House: Reported from General Laws (22-Y 0-N)",22,0,0,0,22
1800588,1373116,2024-01-31,House,"House: VOTE: Block Vote Passage (100-Y 0-N)",100,0,0,0,100
1800588,1384453,2024-02-14,Senate,"Senate: Reported from General Laws and Technology (8-Y 4-N 1-A)",8,4,1,0,13
1800588,1396185,2024-02-27,Senate,"Senate: Passed by indefinitely in Finance and Appropriations (15-Y 0-N)",15,0,0,0,15
1800589,1373603,2024-02-01,House,"House: Subcommittee recommends laying on the table (5-Y 3-N)",5,3,0,0,8
1800590,1374923,2024-02-02,House,"House: Subcommittee recommends striking from docket (6-Y 0-N)",6,0,0,3,9
1800591,1369360,2024-01-25,House,"House: Subcommittee recommends reporting with amendments (7-Y 0-N)",7,0,1,0,8
1800591,1372092,2024-01-30,House,"House: Reported from Labor and Commerce with amendment(s) (18-Y 4-N)",18,4,0,0,22
1800591,1375791,2024-02-05,House,"House: Subcommittee recommends reporting with substitute (6-Y 2-N)",6,2,0,1,9
1800591,1381014,2024-02-09,House,"House: Reported from Courts of Justice with substitute (12-Y 10-N)",12,10,0,0,22
1800591,1383212,2024-02-13,House,"House: VOTE: Passage (64-Y 35-N)",64,35,0,1,100
1800591,1391490,2024-02-22,Senate,"Senate: Rereferred from Education and Health (12-Y 0-N)",12,0,0,0,12
1800591,1401963,2024-03-04,Senate,"Senate: Reported from Commerce and Labor (9-Y 3-N 2-A)",9,3,2,0,14
1800591,1403061,2024-03-05,Senate,"Senate: Constitutional reading dispensed (40-Y 0-N)",40,0,0,0,40
1800591,1404335,2024-03-06,Senate,"Senate: Defeated by Senate (19-Y 21-N)",19,21,0,0,40
1800591,1404336,2024-03-06,Senate,"Senate: Reconsideration of defeated action agreed to by Senate (40-Y 0-N)",40,0,0,0,40
1800591,1405193,2024-03-07,Senate,"Senate: Passed Senate (24-Y 16-N)",24,16,0,0,40
1800592,1376336,2024-02-05,House,"House: Subcommittee recommends laying on the table (7-Y 1-N)",7,1,0,1,9
1800593,1371438,2024-01-30,House,"House: Subcommittee recommends reporting with substitute (5-Y 3-N)",5,3,0,0,8
1800593,1373004,2024-01-31,House,"House: Reported from Education with substitute (12-Y 10-N)",12,10,0,0,22
1800593,1376507,2024-02-05,House,"House: Subcommittee recommends laying on the table (8-Y 0-N)",8,0,0,1,9
1800595,1369167,2024-01-25,House,"House: Subcommittee recommends reporting (8-Y 0-N)",8,0,0,0,8
1800595,1372083,2024-01-30,House,"House: Reported from General Laws (22-Y 0-N)",22,0,0,0,22
1800595,1375811,2024-02-05,House,"House: VOTE: Block Vote Passage (98-Y 0-N)",98,0,0,2,100
1800595,1384966,2024-02-14,Senate,"Senate: Reported from General Laws and Technology (15-Y 0-N)",15,0,0,0,15
1800595,1386570,2024-02-16,Senate,"Senate: Constitutional reading dispensed (38-Y 0-N)",38,0,0,2,40
1800595,1387494,2024-02-19,Senate,"Senate: Passed Senate (39-Y 0-N)",39,0,0,1,40
1800596,1367636,2024-01-23,House,"House: Subcommittee recommends laying on the table (4-Y 3-N)",4,3,0,1,8
1800597,1366559,2024-01-18,House,"House: Stricken from docket by General Laws (22-Y 0-N)",22,0,0,0,22
1800598,1369464,2024-01-25,House,"House: Subcommittee recommends reporting (8-Y 0-N)",8,0,0,0,8
1800598,1372226,2024-01-30,House,"House: Reported from General Laws (22-Y 0-N)",22,0,0,0,22
1800598,1376312,2024-02-05,House,"House: VOTE: Block Vote Passage (98-Y 0-N)",98,0,0,2,100
1800598,1384557,2024-02-14,Senate,"Senate: Reported from General Laws and Technology (14-Y 0-N)",14,0,0,0,14
1800598,1386680,2024-02-16,Senate,"Senate: Constitutional reading dispensed (38-Y 0-N)",38,0,0,2,40
1800598,1387436,2024-02-19,Senate,"Senate: Passed Senate (39-Y 0-N)",39,0,0,1,40
1800599,1377542,2024-02-06,House,"House: Subcommittee recommends reporting with substitute (7-Y 0-N)",7,0,0,0,7
1800599,1380241,2024-02-08,House,"House: Reported from Labor and Commerce with substitute (22-Y 0-N)",22,0,0,0,22
1800599,1380690,2024-02-09,House,"House: Subcommittee recommends reporting (7-Y 0-N)",7,0,0,2,9
1800599,1380691,2024-02-09,House,"House: Reported from Appropriations (20-Y 0-N)",20,0,0,2,22
1800599,1383000,2024-02-13,House,"House: VOTE: Block Vote Passage (99-Y 0-N)",99,0,0,1,100
1800599,1395090,2024-02-26,Senate,"Senate: Reported from Commerce and Labor (15-Y 0-N)",15,0,0,0,15
1800599,1399415,2024-02-29,Senate,"Senate: Continued to 2025 in Finance and Appropriations (10-Y 4-N)",10,4,0,0,14
1800611,1368183,2024-01-24,House,"House: Subcommittee recommends laying on the table (6-Y 4-N)",6,4,0,0,10
1800619,1367616,2024-01-23,House,"House: Subcommittee recommends laying on the table (7-Y 0-N)",7,0,0,1,8
1800627,1366857,2024-01-19,Senate,"Senate: Reported from Rehabilitation and Social Services (15-Y 0-N)",15,0,0,0,15
1800627,1368671,2024-01-22,Senate,"Senate: Constitutional reading dispensed (40-Y 0-N)",40,0,0,0,40
1800627,1368672,2024-01-24,Senate,"Senate: Read third time and passed Senate (40-Y 0-N)",40,0,0,0,40
1800627,1385470,2024-02-15,House,"House: Reported from General Laws (21-Y 1-N)",21,1,0,0,22
1800627,1388867,2024-02-20,House,"House: VOTE: Passage (90-Y 7-N)",90,7,0,3,100
1800632,1366609,2024-01-18,Senate,"Senate: Reported from Education and Health (15-Y 0-N)",15,0,0,0,15
1800632,1372655,2024-01-31,Senate,"Senate: Reported from Finance and Appropriations (15-Y 0-N)",15,0,0,0,15
1800632,1374164,2024-02-01,Senate,"Senate: Constitutional reading dispensed (40-Y 0-N)",40,0,0,0,40
1800632,1375733,2024-02-05,Senate,"Senate: Read third time and passed Senate (40-Y 0-N)",40,0,0,0,40
1800632,1395625,2024-02-27,House,"House: Subcommittee recommends reporting (8-Y 0-N)",8,0,0,0,8
1800632,1397289,2024-02-28,House,"House: Reported from Education (22-Y 0-N)",22,0,0,0,22
1800636,1367477,2024-01-22,House,"House: Subcommittee recommends laying on the table (5-Y 3-N)",5,3,0,1,9
1800641,1368915,2024-01-24,Senate,"Senate: Reported from General Laws and Technology (13-Y 0-N 2-A)",13,0,2,0,15
1800641,1372472,2024-01-31,Senate,"Senate: Reported from Finance and Appropriations (15-Y 0-N)",15,0,0,0,15
1800641,1374272,2024-02-01,Senate,"Senate: Constitutional reading dispensed (40-Y 0-N)",40,0,0,0,40
1800641,1376083,2024-02-05,Senate,"Senate: Read third time and passed Senate (40-Y 0-N)",40,0,0,0,40
1800641,1389542,2024-02-20,House,"House: Subcommittee recommends reporting (8-Y 0-N)",8,0,0,0,8
1800641,1392861,2024-02-22,House,"House: Reported from General Laws (22-Y 0-N)",22,0,0,0,22
1800641,1396212,2024-02-27,House,"House: VOTE: Block Vote Passage (97-Y 0-N)",97,0,0,3,100
1800647,1373699,2024-02-01,Senate,"Senate: Reported from Education and Health with substitute (15-Y 0-N)",15,0,0,0,15
1800647,1377052,2024-02-06,Senate,"Senate: Read third time and passed Senate (39-Y 0-N)",39,0,0,1,40
1800647,1432176,2024-02-26,House,"House: Reported from Education (21-Y 0-N)",21,0,0,1,22
1800647,1432177,2024-02-29,House,"House: VOTE: Block Vote Passage (99-Y 0-N)",99,0,0,1,100
1800650,1366683,2024-01-18,Senate,"Senate: Reported from Transportation (15-Y 0-N)",15,0,0,0,15
1800650,1368560,2024-01-22,Senate,"Senate: Constitutional reading dispensed (40-Y 0-N)",40,0,0,0,40
1800650,1368561,2024-01-24,Senate,"Senate: Read third time and passed Senate (40-Y 0-N)",40,0,0,0,40
1800650,1388356,2024-02-20,House,"House: Subcommittee recommends reporting (8-Y 0-N)",8,0,0,0,8
1800650,1388357,2024-02-20,House,"House: Subcommittee recommends reporting (8-Y 0-N)",8,0,0,0,8
1800650,1391343,2024-02-22,House,"House: Reported from Transportation (22-Y 0-N)",22,0,0,0,22
1800650,1395908,2024-02-27,House,"House: VOTE: Block Vote Passage (97-Y 0-N)",97,0,0,3,100
1800655,1373714,2024-02-01,Senate,"Senate: Reported from Education and Health with substitute (15-Y 0-N)",15,0,0,0,15
1800655,1379743,2024-02-08,Senate,"Senate: Reported from Finance and Appropriations with substitute (15-Y 0-N)",15,0,0,0,15
1800655,1380809,2024-02-09,Senate,"Senate: Constitutional reading dispensed (39-Y 0-N)",39,0,0,1,40
1800655,1381480,2024-02-12,Senate,"Senate: Constitutional reading dispensed (40-Y 0-N)",40,0,0,0,40
1800655,1381481,2024-02-12,Senate,"Senate: Passed Senate (40-Y 0-N)",40,0,0,0,40
1800655,1393210,2024-02-23,House,"House: Subcommittee recommends reporting (6-Y 0-N)",6,0,0,0,6
1800655,1393211,2024-02-23,House,"House: Reported from Rules (16-Y 0-N)",16,0,0,2,18
1800655,1397560,2024-02-28,House,"House: Reported from Appropriations (22-Y 0-N)",22,0,0,0,22
1800655,1401776,2024-03-04,House,"House: VOTE: Block Vote Passage (97-Y 0-N)",97,0,0,3,100
1800659,1364291,2024-01-15,Senate,"Senate: Reported from Local Government (13-Y 0-N)",13,0,0,0,13
1800659,1432171,2024-01-16,Senate,"Senate: Constitutional reading dispensed (38-Y 0-N)",38,0,0,1,39
1800659,1432172,2024-01-18,Senate,"Senate: Read third time and passed Senate (40-Y 0-N)",40,0,0,0,40
1800659,1432173,2024-02-16,House,"House: Reported from Counties, Cities and Towns (16-Y 5-N)",16,5,0,1,22
1800659,1432174,2024-02-21,House,"House: VOTE: Passage (68-Y 31-N 1-A)",68,31,1,0,100
1800659,1432175,2024-04-17,Senate,"Senate: Senate rejected Governor's recommendation (18-Y 21-N)",18,21,0,1,40
1800664,1366525,2024-01-18,House,"House: Subcommittee recommends reporting with substitute (6-Y 1-N)",6,1,0,0,7
1800664,1366895,2024-01-19,House,"House: Reported from Public Safety with substitute (13-Y 8-N)",13,8,0,1,22
1800664,1370308,2024-01-29,House,"House: Reported from Education (14-Y 8-N)",14,8,0,0,22
1800664,1376509,2024-02-05,House,"House: Subcommittee recommends laying on the table (8-Y 0-N)",8,0,0,1,9
1800668,1371524,2024-01-30,House,"House: Subcommittee recommends laying on the table (5-Y 3-N)",5,3,0,0,8
1800673,1364203,2024-01-12,Senate,"Senate: Reported from Rehabilitation and Social Services (14-Y 0-N)",14,0,0,0,14
1800673,1432167,2024-01-15,Senate,"Senate: Constitutional reading dispensed (39-Y 0-N)",39,0,0,0,39
1800673,1432168,2024-01-17,Senate,"Senate: Read third time and passed Senate (39-Y 0-N)",39,0,0,0,39
1800673,1432169,2024-02-15,House,"House: Reported from Health and Human Services (22-Y 0-N)",22,0,0,0,22
1800673,1432170,2024-02-20,House,"House: VOTE: Block Vote Passage (98-Y 0-N)",98,0,0,2,100
1800677,1368781,2024-01-24,Senate,"Senate: Passed by indefinitely in Courts of Justice (9-Y 6-N)",9,6,0,0,15
1800691,1369765,2024-01-26,Senate,"Senate: Rereferred from Rules (15-Y 0-N)",15,0,0,0,15
1800691,1376366,2024-02-05,Senate,"Senate: Continued to 2025 in Commerce and Labor (15-Y 0-N)",15,0,0,0,15
1800695,1368901,2024-01-24,Senate,"Senate: Stricken at request of Patron in Courts of Justice (9-Y 0-N)",9,0,0,0,9
1800701,1368899,2024-01-24,Senate,"Senate: Reported from General Laws and Technology with amendments (15-Y 0-N)",15,0,0,0,15
1800701,1377049,2024-02-06,Senate,"Senate: Reported from Finance and Appropriations with amendment (15-Y 0-N)",15,0,0,0,15
1800701,1378136,2024-02-07,Senate,"Senate: Constitutional reading dispensed (40-Y 0-N)",40,0,0,0,40
1800701,1379240,2024-02-08,Senate,"Senate: Constitutional reading dispensed (40-Y 0-N)",40,0,0,0,40
1800701,1379241,2024-02-08,Senate,"Senate: Read third time and passed Senate (40-Y 0-N)",40,0,0,0,40
1800701,1391332,2024-02-22,House,"House: Subcommittee recommends reporting with substitute (8-Y 0-N)",8,0,0,0,8
1800701,1396537,2024-02-27,House,"House: Reported from Health and Human Services with substitute (21-Y 0-N)",21,0,0,1,22
1800701,1400644,2024-03-01,House,"House: VOTE: Block Vote Passage (97-Y 0-N)",97,0,0,3,100
1800701,1402891,2024-03-05,Senate,"Senate: House substitute agreed to by Senate (39-Y 1-N)",39,1,0,0,40
1800709,1368181,2024-01-24,House,"House: Subcommittee recommends reporting (10-Y 0-N)",10,0,0,0,10
1800709,1370559,2024-01-29,House,"House: Reported from Communications, Technology and Innovation (22-Y 0-N)",22,0,0,0,22
1800709,1376813,2024-02-06,House,"House: Subcommittee recommends reporting with substitute (8-Y 0-N)",8,0,0,0,8
1800709,1378438,2024-02-07,House,"House: Reported from Education with substitute (22-Y 0-N)",22,0,0,0,22
1800709,1383714,2024-02-13,House,"House: VOTE: Block Vote Passage (99-Y 0-N)",99,0,0,1,100
1800709,1399136,2024-02-29,Senate,"Senate: Reported from Education and Health (15-Y 0-N)",15,0,0,0,15
1800709,1400972,2024-03-01,Senate,"Senate: Constitutional reading dispensed (40-Y 0-N)",40,0,0,0,40
1800709,1401694,2024-03-04,Senate,"Senate: Passed Senate (39-Y 0-N)",39,0,0,1,40
1800715,1368773,2024-01-24,Senate,"Senate: Reported from Courts of Justice with substitute (15-Y 0-N)",15,0,0,0,15
1800715,1369904,2024-01-26,Senate,"Senate: Constitutional reading dispensed (37-Y 0-N)",37,0,0,3,40
1800715,1372013,2024-01-30,Senate,"Senate: Committee substitute reconsidered (40-Y 0-N)",40,0,0,0,40
1800715,1372852,2024-01-31,Senate,"Senate: Read third time and passed Senate (40-Y 0-N)",40,0,0,0,40
1800715,1393202,2024-02-23,House,"House: Reported from Public Safety with substitute (21-Y 0-N)",21,0,0,1,22
1800715,1398094,2024-02-28,House,"House: VOTE: Block Vote Passage (97-Y 0-N)",97,0,0,3,100
1800715,1400893,2024-03-01,Senate,"Senate: House substitute rejected by Senate (0-Y 40-N)",0,40,0,0,40
1800715,1403350,2024-03-05,Senate,"Senate: Senate acceded to request (40-Y 0-N)",40,0,0,0,40
1800715,1406643,2024-03-09,Senate,"Senate: Conference report agreed to by Senate (40-Y 0-N)",40,0,0,0,40
1800715,1406644,2024-03-09,House,"House: VOTE: Adoption (99-Y 0-N)",99,0,0,1,100
1800719,1373723,2024-02-01,House,"House: Reported from Rules (18-Y 0-N)",18,0,0,0,18
1800719,1377058,2024-02-06,House,"House: VOTE: Block Vote Adoption (98-Y 0-N)",98,0,0,2,100
1800719,1394926,2024-02-26,Senate,"Senate: Reading waived (40-Y 0-N)",40,0,0,0,40
1800729,1364483,2024-01-16,Senate,"Senate: Reported from Privileges and Elections (14-Y 0-N)",14,0,0,0,14
1800729,1368346,2024-01-22,Senate,"Senate: Read third time and passed Senate (40-Y 0-N)",40,0,0,0,40
1800729,1368951,2024-01-18,Senate,"Senate: Constitutional reading dispensed (40-Y 0-N)",40,0,0,0,40
1800729,1387631,2024-02-19,House,"House: Subcommittee recommends reporting (8-Y 0-N)",8,0,0,0,8
1800729,1393946,2024-02-23,House,"House: Reported from Privileges and Elections (22-Y 0-N)",22,0,0,0,22
1800729,1398273,2024-02-28,House,"House: VOTE: Block Vote Passage (97-Y 0-N)",97,0,0,3,100
1800732,1367174,2024-01-22,Senate,"Senate: Continued to 2025 in Local Government (13-Y 2-N)",13,2,0,0,15
1800737,1368981,2024-01-25,Senate,"Senate: Passed by indefinitely in Education and Health (13-Y 2-N)",13,2,0,0,15
1800743,1369179,2024-01-25,House,"House: Subcommittee recommends reporting with substitute (7-Y 1-N)",7,1,0,0,8
1800743,1371795,2024-01-30,House,"House: Reported from General Laws with substitute (21-Y 1-N)",21,1,0,0,22
1800743,1376256,2024-02-05,House,"House: VOTE: Passage (69-Y 29-N)",69,29,0,2,100
1800743,1384490,2024-02-14,Senate,"Senate: Reported from General Laws and Technology (12-Y 3-N)",12,3,0,0,15
1800743,1386910,2024-02-16,Senate,"Senate: Constitutional reading dispensed (38-Y 0-N)",38,0,0,2,40
1800743,1387968,2024-02-19,Senate,"Senate: Passed Senate (30-Y 9-N)",30,9,0,1,40
1800743,1430315,2024-04-17,House,"House: VOTE: Adoption (0-Y 100-N)",0,100,0,0,100
1800746,1366524,2024-01-18,House,"House: Subcommittee recommends reporting (6-Y 0-N)",6,0,0,0,6
1800746,1366927,2024-01-19,House,"House: Reported from Public Safety (21-Y 0-N)",21,0,0,1,22
1800746,1373361,2024-01-31,House,"House: Subcommittee recommends reporting with amendments (8-Y 0-N)",8,0,0,1,9
1800746,1374610,2024-02-02,House,"House: Reported from Appropriations with amendment(s) (22-Y 0-N)",22,0,0,0,22
1800746,1380159,2024-02-08,House,"House: VOTE: Block Vote Passage (98-Y 0-N)",98,0,0,2,100
1800746,1386675,2024-02-16,Senate,"Senate: Reported from Rehabilitation and Social Services with substitute (12-Y 0-N)",12,0,0,0,12
1800746,1397361,2024-02-28,Senate,"Senate: Reported from Finance and Appropriations with substitute (15-Y 0-N)",15,0,0,0,15
1800746,1399730,2024-02-29,Senate,"Senate: Constitutional reading dispensed (39-Y 0-N)",39,0,0,1,40
1800746,1400907,2024-03-01,Senate,"Senate: Passed Senate with substitute (40-Y 0-N)",40,0,0,0,40
1800746,1401531,2024-03-04,House,"House: VOTE: REJECTED (6-Y 92-N)",6,92,0,2,100
1800746,1403473,2024-03-05,Senate,"Senate: Senate insisted on substitute (40-Y 0-N)",40,0,0,0,40
1800746,1406176,2024-03-08,Senate,"Senate: Conference report agreed to by Senate (40-Y 0-N)",40,0,0,0,40
1800746,1406177,2024-03-08,House,"House: VOTE: Adoption (97-Y 0-N)",97,0,0,3,100
1800754,1364288,2024-01-15,Senate,"Senate: Reported from Commerce and Labor with substitute (10-Y 5-N)",10,5,0,0,15
1800754,1379998,2024-02-08,Senate,"Senate: Reported from Finance and Appropriations with substitute (11-Y 4-N)",11,4,0,0,15
1800754,1380617,2024-02-09,Senate,"Senate: Constitutional reading dispensed (39-Y 0-N)",39,0,0,1,40
1800754,1383742,2024-02-13,Senate,"Senate: Engrossment reconsidered by Senate (40-Y 0-N)",40,0,0,0,40
1800754,1383743,2024-02-13,Senate,"Senate: Committee substitute reconsidered (40-Y 0-N)",40,0,0,0,40
1800754,1383744,2024-02-13,Senate,"Senate: Constitutional reading dispensed (40-Y 0-N)",40,0,0,0,40
1800754,1383745,2024-02-13,Senate,"Senate: Passed Senate (32-Y 8-N)",32,8,0,0,40
1800754,1389024,2024-02-20,House,"House: Reported from General Laws with substitute (15-Y 6-N)",15,6,0,1,22
1800754,1393636,2024-02-23,House,"House: VOTE: Passage (57-Y 38-N)",57,38,0,5,100
1800754,1395762,2024-02-27,Senate,"Senate: House substitute rejected by Senate (2-Y 37-N)",2,37,0,1,40
1800754,1398126,2024-02-28,Senate,"Senate: Senate acceded to request (39-Y 0-N)",39,0,0,1,40
1800754,1400453,2024-03-01,House,"House: VOTE: Adoption (49-Y 43-N)",49,43,0,8,100
1800754,1400906,2024-03-01,Senate,"Senate: Conference report agreed to by Senate (31-Y 9-N)",31,9,0,0,40
1800754,1401523,2024-03-04,House,"House: VOTE: Adoption #2 (51-Y 45-N)",51,45,0,4,100
1800754,1430269,2024-04-17,Senate,"Senate: Senate rejected Governor's recommendation (6-Y 34-N)",6,34,0,0,40
1800760,1373375,2024-01-31,House,"House: Subcommittee recommends laying on the table (7-Y 1-N)",7,1,0,1,9
1800764,1366208,2024-01-17,Senate,"Senate: Reported from General Laws and Technology with amendment (15-Y 0-N)",15,0,0,0,15
1800764,1368687,2024-01-19,Senate,"Senate: Constitutional reading dispensed (37-Y 0-N)",37,0,0,3,40
1800764,1368688,2024-01-23,Senate,"Senate: Read third time and passed Senate (39-Y 0-N)",39,0,0,1,40
1800764,1385469,2024-02-15,House,"House: Reported from General Laws (22-Y 0-N)",22,0,0,0,22
1800764,1388992,2024-02-20,House,"House: VOTE: Block Vote Passage (98-Y 0-N)",98,0,0,2,100
1800768,1374573,2024-02-02,Senate,"Senate: Reported from Rules (14-Y 0-N)",14,0,0,0,14
1800768,1379742,2024-02-08,Senate,"Senate: Incorporated by Finance and Appropriations ",15,0,0,0,15
1800778,1366870,2024-01-19,Senate,"Senate: Reported from Rehabilitation and Social Services (15-Y 0-N)",15,0,0,0,15
1800778,1368743,2024-01-22,Senate,"Senate: Constitutional reading dispensed (40-Y 0-N)",40,0,0,0,40
1800778,1368744,2024-01-24,Senate,"Senate: Read third time and passed Senate (40-Y 0-N)",40,0,0,0,40
1800778,1396069,2024-02-27,House,"House: Subcommittee recommends reporting with amendments (6-Y 1-N)",6,1,1,0,8
1800778,1396881,2024-02-27,House,"House: Reported from General Laws with amendment(s) (17-Y 5-N)",17,5,0,0,22
1800783,1364318,2024-01-15,Senate,"Senate: Reported from Courts of Justice with amendment (14-Y 0-N 1-A)",14,0,1,0,15
1800783,1432094,2024-01-16,Senate,"Senate: Constitutional reading dispensed (38-Y 0-N)",38,0,0,1,39
1800783,1432095,2024-01-18,Senate,"Senate: Read third time and passed Senate (40-Y 0-N)",40,0,0,0,40
1800783,1432096,2024-01-18,Senate,"Senate: Reconsideration of passage agreed to by Senate (37-Y 3-N)",37,3,0,0,40
1800783,1432097,2024-01-18,Senate,"Senate: Passed Senate (40-Y 0-N)",40,0,0,0,40
1800783,1432098,2024-02-23,House,"House: Reported from Public Safety (21-Y 0-N)",21,0,0,1,22
1800783,1432099,2024-02-28,House,"House: VOTE: Block Vote Passage (97-Y 0-N)",97,0,0,3,100
1800787,1367972,2024-01-23,House,"House: Subcommittee recommends laying on the table (8-Y 0-N)",8,0,0,1,9
1800790,1371512,2024-01-30,House,"House: Subcommittee recommends reporting (8-Y 0-N)",8,0,0,0,8
1800790,1374645,2024-02-02,House,"House: Reported from Privileges and Elections (22-Y 0-N)",22,0,0,0,22
1800790,1379420,2024-02-08,House,"House: VOTE: Block Vote Passage (98-Y 0-N)",98,0,0,2,100
1800790,1388809,2024-02-20,Senate,"Senate: Reported from Privileges and Elections (14-Y 0-N)",14,0,0,0,14
1800790,1395817,2024-02-27,Senate,"Senate: Constitutional reading dispensed (39-Y 0-N)",39,0,0,1,40
1800790,1395818,2024-02-27,Senate,"Senate: Reported from Finance and Appropriations (15-Y 0-N)",15,0,0,0,15
1800790,1398215,2024-02-28,Senate,"Senate: Passed Senate (39-Y 0-N)",39,0,0,1,40
1800796,1374361,2024-02-01,House,"House: Subcommittee recommends reporting with substitute (6-Y 2-N)",6,2,0,0,8
1800796,1377723,2024-02-06,House,"House: Reported from General Laws with substitute (13-Y 7-N)",13,7,0,2,22
1800796,1382423,2024-02-12,House,"House: VOTE: Passage (57-Y 43-N)",57,43,0,0,100
1800796,1391098,2024-02-21,Senate,"Senate: Reported from General Laws and Technology (8-Y 0-N)",8,0,0,0,8
1800796,1394102,2024-02-23,Senate,"Senate: Constitutional reading dispensed (38-Y 0-N)",38,0,0,2,40
1800796,1395112,2024-02-26,Senate,"Senate: Passed Senate (32-Y 8-N)",32,8,0,0,40
1800801,1379034,2024-02-08,House,"House: Subcommittee recommends reporting with substitute (4-Y 2-N)",4,2,0,0,6
1800801,1380504,2024-02-09,House,"House: Reported from Public Safety with substitute (14-Y 7-N)",14,7,0,1,22
1800804,1378683,2024-02-07,Senate,"Senate: Reported from Courts of Justice (15-Y 0-N)",15,0,0,0,15
1800804,1379709,2024-02-08,Senate,"Senate: Constitutional reading dispensed (40-Y 0-N)",40,0,0,0,40
1800804,1380857,2024-02-09,Senate,"Senate: Constitutional reading dispensed (40-Y 0-N)",40,0,0,0,40
1800804,1380858,2024-02-09,Senate,"Senate: Passed Senate (40-Y 0-N)",40,0,0,0,40
1800804,1386827,2024-02-16,House,"House: Reported from Courts of Justice with amendment(s) (22-Y 0-N)",22,0,0,0,22
1800804,1390922,2024-02-21,House,"House: VOTE: Block Vote Passage (100-Y 0-N)",100,0,0,0,100
1800804,1394039,2024-02-23,Senate,"Senate: House amendments agreed to by Senate (39-Y 0-N)",39,0,0,1,40
1800811,1371010,2024-01-29,House,"House: Subcommittee recommends laying on the table (6-Y 0-N)",6,0,0,0,6
1800815,1371241,2024-01-29,House,"House: Subcommittee recommends laying on the table (10-Y 0-N)",10,0,0,0,10
1800820,1368887,2024-01-24,Senate,"Senate: Reported from General Laws and Technology with amendment (14-Y 0-N 1-A)",14,0,1,0,15
1800820,1369958,2024-01-26,Senate,"Senate: Constitutional reading dispensed (37-Y 0-N)",37,0,0,3,40
1800820,1372210,2024-01-30,Senate,"Senate: Read third time and passed Senate (39-Y 0-N 1-A)",39,0,1,0,40
1800820,1393230,2024-02-23,House,"House: Subcommittee recommends reporting with amendments (6-Y 0-N)",6,0,0,0,6
1800820,1393231,2024-02-23,House,"House: Reported from Rules with amendment(s) (16-Y 0-N)",16,0,0,2,18
1800820,1398075,2024-02-28,House,"House: Reported from Appropriations with substitute (19-Y 3-N)",19,3,0,0,22
1800820,1401612,2024-03-04,House,"House: VOTE: Passage (96-Y 2-N)",96,2,0,2,100
1800820,1403686,2024-03-05,Senate,"Senate: House amendments agreed to by Senate (40-Y 0-N)",40,0,0,0,40
1800825,1372242,2024-01-30,House,"House: Subcommittee recommends striking from docket (8-Y 0-N)",8,0,0,1,9
1800828,1368393,2024-01-24,Senate,"Senate: Reported from Finance and Appropriations (13-Y 0-N)",13,0,0,0,13
1800828,1369199,2024-01-25,Senate,"Senate: Constitutional reading dispensed (40-Y 0-N)",40,0,0,0,40
1800828,1370720,2024-01-29,Senate,"Senate: Read third time and passed Senate (40-Y 0-N)",40,0,0,0,40
1800828,1390247,2024-02-21,House,"House: Reported from Appropriations (22-Y 0-N)",22,0,0,0,22
1800828,1394431,2024-02-26,House,"House: VOTE: Passage (91-Y 4-N)",91,4,0,5,100
1800833,1364401,2024-01-16,Senate,"Senate: Reported from Privileges and Elections (14-Y 0-N)",14,0,0,0,14
1800833,1368430,2024-01-18,Senate,"Senate: Constitutional reading dispensed (40-Y 0-N)",40,0,0,0,40
1800833,1368431,2024-01-22,Senate,"Senate: Read third time and passed Senate (40-Y 0-N)",40,0,0,0,40
1800833,1400503,2024-03-01,House,"House: Reported from Privileges and Elections (11-Y 9-N)",11,9,0,2,22
1800833,1404641,2024-03-06,House,"House: VOTE: Passage (50-Y 47-N)",50,47,0,3,100
1800833,1430260,2024-04-17,Senate,"Senate: Senate rejected Governor's recommendation (18-Y 21-N)",18,21,0,1,40
1800836,1366354,2024-01-17,Senate,"Senate: Reported from General Laws and Technology with amendment (13-Y 2-N)",13,2,0,0,15
1800836,1368606,2024-01-19,Senate,"Senate: Constitutional reading dispensed (37-Y 0-N)",37,0,0,3,40
1800836,1368607,2024-01-23,Senate,"Senate: Read third time and passed Senate (39-Y 0-N)",39,0,0,1,40
1800836,1389561,2024-02-20,House,"House: Subcommittee recommends reporting (8-Y 0-N)",8,0,0,0,8
1800836,1392877,2024-02-22,House,"House: Reported from General Laws (22-Y 0-N)",22,0,0,0,22
1800836,1396898,2024-02-27,House,"House: VOTE: Block Vote Passage (97-Y 0-N)",97,0,0,3,100
1800842,1366487,2024-01-18,Senate,"Senate: Reported from Education and Health with substitute (15-Y 0-N)",15,0,0,0,15
1800842,1373065,2024-01-31,Senate,"Senate: Reported from Finance and Appropriations with substitute (14-Y 0-N)",14,0,0,0,14
1800842,1374061,2024-02-01,Senate,"Senate: Constitutional reading dispensed (40-Y 0-N)",40,0,0,0,40
1800842,1376363,2024-02-05,Senate,"Senate: Read third time and passed Senate (40-Y 0-N)",40,0,0,0,40
1800842,1391273,2024-02-22,House,"House: Subcommittee recommends reporting with substitute (8-Y 0-N)",8,0,0,0,8
1800842,1396075,2024-02-27,House,"House: Reported from Health and Human Services with substitute (21-Y 0-N)",21,0,0,1,22
1800842,1397878,2024-02-28,House,"House: Reported from Appropriations (22-Y 0-N)",22,0,0,0,22
1800842,1401952,2024-03-04,House,"House: VOTE: Passage (94-Y 2-N)",94,2,0,4,100
1800842,1403277,2024-03-05,Senate,"Senate: House substitute agreed to by Senate (40-Y 0-N)",40,0,0,0,40
1800847,1371841,2024-01-30,House,"House: Subcommittee recommends laying on the table (8-Y 0-N)",8,0,0,0,8
1800853,1374735,2024-02-01,Senate,"Senate: Incorporated by Transportation ",15,0,0,0,15
1800857,1367634,2024-01-23,Senate,"Senate: Reported from Finance and Appropriations with amendments (14-Y 0-N)",14,0,0,0,14
1800857,1368894,2024-01-24,Senate,"Senate: Constitutional reading dispensed (40-Y 0-N)",40,0,0,0,40
1800857,1369731,2024-01-26,Senate,"Senate: Read third time and passed Senate (38-Y 0-N)",38,0,0,2,40
1800857,1384462,2024-02-14,House,"House: Reported from Finance with substitute (22-Y 0-N)",22,0,0,0,22
1800857,1387972,2024-02-19,House,"House: VOTE: Block Vote Passage (99-Y 0-N)",99,0,0,1,100
1800857,1390901,2024-02-21,Senate,"Senate: House substitute rejected by Senate (0-Y 40-N)",0,40,0,0,40
1800857,1394488,2024-02-26,Senate,"Senate: Senate acceded to request (40-Y 0-N)",40,0,0,0,40
1800857,1403261,2024-03-05,House,"House: VOTE: Adoption (100-Y 0-N)",100,0,0,0,100
1800857,1403262,2024-03-05,Senate,"Senate: Conference report agreed to by Senate (39-Y 0-N)",39,0,0,1,40
1800861,1366212,2024-01-17,Senate,"Senate: Reported from Courts of Justice (15-Y 0-N)",15,0,0,0,15
1800861,1368613,2024-01-19,Senate,"Senate: Constitutional reading dispensed (37-Y 0-N)",37,0,0,3,40
1800861,1368614,2024-01-23,Senate,"Senate: Read third time and passed Senate (36-Y 3-N)",36,3,0,1,40
1800861,1386970,2024-02-16,House,"House: Reported from Courts of Justice (22-Y 0-N)",22,0,0,0,22
1800861,1390276,2024-02-21,House,"House: VOTE: Block Vote Passage (100-Y 0-N)",100,0,0,0,100
1800865,1369040,2024-01-25,House,"House: Subcommittee recommends reporting (4-Y 2-N)",4,2,0,0,6
1800865,1369709,2024-01-26,House,"House: Reported from Public Safety (12-Y 10-N)",12,10,0,0,22
1800865,1373359,2024-01-31,House,"House: Subcommittee recommends reporting with amendments (4-Y 3-N)",4,3,0,2,9
1800865,1374685,2024-02-02,House,"House: Reported from Appropriations with amendment(s) (13-Y 9-N)",13,9,0,0,22
1800865,1379714,2024-02-08,House,"House: VOTE: Passage (52-Y 46-N)",52,46,0,2,100
1800865,1387360,2024-02-19,Senate,"Senate: Reported from Courts of Justice (14-Y 0-N)",14,0,0,0,14
1800865,1388430,2024-02-20,Senate,"Senate: Constitutional reading dispensed (39-Y 0-N)",39,0,0,1,40
1800865,1389871,2024-02-21,Senate,"Senate: Passed Senate (40-Y 0-N)",40,0,0,0,40
1800870,1371439,2024-01-30,House,"House: Subcommittee recommends reporting with amendments (9-Y 0-N)",9,0,0,0,9
1800870,1372824,2024-01-31,House,"House: Reported from Education with amendment(s) (18-Y 4-N)",18,4,0,0,22
1800873,1379203,2024-02-08,Senate,"Senate: Stricken at request of patron in Education and Health (15-Y 0-N)",15,0,0,0,15
1800879,1364289,2024-01-15,Senate,"Senate: Reported from Courts of Justice with substitute (15-Y 0-N)",15,0,0,0,15
1800879,1432100,2024-01-16,Senate,"Senate: Constitutional reading dispensed (38-Y 0-N)",38,0,0,1,39
1800879,1433237,2024-01-17,Senate,"Senate: Committee substitute agreed to 24105484D-S1 (39-Y 0-N)",39,0,0,0,39
1800879,1433238,2024-01-18,Senate,"Senate: Read third time and passed Senate (40-Y 0-N)",40,0,0,0,40
1800879,1433239,2024-02-16,House,"House: Reported from Courts of Justice with substitute (22-Y 0-N)",22,0,0,0,22
1800879,1433240,2024-02-21,House,"House: VOTE: Block Vote Passage (100-Y 0-N)",100,0,0,0,100
1800879,1433241,2024-02-23,Senate,"Senate: House substitute agreed to by Senate (39-Y 0-N)",39,0,0,1,40
1800883,1367395,2024-01-22,Senate,"Senate: Reported from Commerce and Labor with amendment (13-Y 0-N 1-A)",13,0,1,0,14
1800883,1368575,2024-01-24,Senate,"Senate: Constitutional reading dispensed (40-Y 0-N)",40,0,0,0,40
1800883,1369955,2024-01-26,Senate,"Senate: Read third time and passed Senate (37-Y 0-N)",37,0,0,3,40
1800883,1389546,2024-02-20,House,"House: Subcommittee recommends reporting (7-Y 0-N)",7,0,0,1,8
1800883,1392871,2024-02-22,House,"House: Reported from Labor and Commerce (22-Y 0-N)",22,0,0,0,22
1800883,1395812,2024-02-27,House,"House: VOTE: Block Vote Passage (97-Y 0-N)",97,0,0,3,100
1800886,1370762,2024-01-29,House,"House: Subcommittee recommends reporting with amendments (11-Y 0-N)",11,0,0,0,11
1800886,1372806,2024-01-31,House,"House: Reported from Education with amendment(s) (22-Y 0-N)",22,0,0,0,22
1800886,1377086,2024-02-06,House,"House: VOTE: Block Vote Passage (99-Y 0-N)",99,0,0,1,100
1800886,1391435,2024-02-22,Senate,"Senate: Reported from Education and Health (15-Y 0-N)",15,0,0,0,15
1800886,1393906,2024-02-23,Senate,"Senate: Constitutional reading dispensed (38-Y 0-N)",38,0,0,2,40
1800886,1394609,2024-02-26,Senate,"Senate: Passed Senate (40-Y 0-N)",40,0,0,0,40
1800892,1371536,2024-01-30,Senate,"Senate: Continued to 2025 in Finance and Appropriations (14-Y 1-N)",14,1,0,0,15
1800895,1370560,2024-01-29,Senate,"Senate: Reading waived (40-Y 0-N)",40,0,0,0,40
1800895,1393224,2024-02-23,House,"House: Subcommittee recommends reporting (5-Y 1-N)",5,1,0,0,6
1800895,1393225,2024-02-23,House,"House: Reported from Rules (13-Y 4-N)",13,4,0,1,18
1800895,1397629,2024-02-28,House,"House: Reported from Appropriations (22-Y 0-N)",22,0,0,0,22
1800895,1401940,2024-03-04,House,"House: VOTE: Adoption (65-Y 27-N)",65,27,0,8,100
1800900,1366544,2024-01-18,Senate,"Senate: Reported from Education and Health (15-Y 0-N)",15,0,0,0,15
1800900,1368694,2024-01-19,Senate,"Senate: Constitutional reading dispensed (37-Y 0-N)",37,0,0,3,40
1800900,1368695,2024-01-23,Senate,"Senate: Read third time and passed Senate (39-Y 0-N)",39,0,0,1,40
1800900,1388501,2024-02-20,House,"House: Subcommittee recommends reporting (8-Y 0-N)",8,0,0,0,8
1800900,1391424,2024-02-22,House,"House: Reported from Health and Human Services (21-Y 0-N)",21,0,0,1,22
1800900,1396607,2024-02-27,House,"House: VOTE: Block Vote Passage (97-Y 0-N)",97,0,0,3,100
1800905,1373197,2024-01-31,Senate,"Senate: Reported from General Laws and Technology with amendment (15-Y 0-N)",15,0,0,0,15
1800905,1377609,2024-02-06,Senate,"Senate: Read third time and passed Senate (39-Y 0-N)",39,0,0,1,40
1800905,1432178,2024-02-15,House,"House: Reported from General Laws (22-Y 0-N)",22,0,0,0,22
1800905,1432179,2024-02-20,House,"House: VOTE: Block Vote Passage (98-Y 0-N)",98,0,0,2,100
1800909,1367735,2024-01-23,House,"House: Subcommittee recommends reporting (5-Y 3-N)",5,3,0,0,8
1800909,1368692,2024-01-24,House,"House: Reported from Finance (12-Y 10-N)",12,10,0,0,22
1800909,1371678,2024-01-30,House,"House: VOTE: Passage (54-Y 45-N)",54,45,0,1,100
1800909,1385775,2024-02-15,Senate,"Senate: Reported from Finance and Appropriations with substitute (11-Y 4-N)",11,4,0,0,15
1800909,1387747,2024-02-19,Senate,"Senate: Constitutional reading dispensed (38-Y 0-N)",38,0,0,2,40
1800909,1388428,2024-02-20,Senate,"Senate: Passed Senate with substitute (23-Y 17-N)",23,17,0,0,40
1800909,1392376,2024-02-22,House,"House: VOTE: Adoption (54-Y 45-N)",54,45,0,1,100
1800909,1430186,2024-04-17,House,"House: VOTE: Adoption (54-Y 45-N)",54,45,0,1,100
1800909,1430187,2024-04-17,House,"House: VOTE: Adoption (0-Y 100-N)",0,100,0,0,100
1800909,1430188,2024-04-17,Senate,"Senate: Senate concurred in Governor's recommendation #3 (20-Y 20-N)",20,20,0,0,40
1800909,1430189,2024-04-17,Senate,"Senate: Reconsideration of Governor's recommendation agreed to (40-Y 0-N)",40,0,0,0,40
1800909,1430190,2024-04-17,Senate,"Senate: Senate rejected Governor's recommendation #3 (19-Y 21-N)",19,21,0,0,40
1800914,1366277,2024-01-17,Senate,"Senate: Rereferred from General Laws and Technology (15-Y 0-N)",15,0,0,0,15
1800914,1371040,2024-01-29,Senate,"Senate: Passed by indefinitely in Commerce and Labor (9-Y 6-N)",9,6,0,0,15
1800920,1369269,2024-01-25,House,"House: Subcommittee recommends reporting with amendments (5-Y 3-N)",5,3,0,0,8
1800920,1372117,2024-01-30,House,"House: Reported from Labor and Commerce with amendment(s) (12-Y 10-N)",12,10,0,0,22
1800920,1376213,2024-02-05,House,"House: VOTE: Passage (49-Y 48-N)",49,48,0,3,100
1800920,1387584,2024-02-19,Senate,"Senate: Reported from Commerce and Labor with substitute (9-Y 6-N)",9,6,0,0,15
1800920,1389965,2024-02-21,Senate,"Senate: Constitutional reading dispensed (40-Y 0-N)",40,0,0,0,40
1800920,1392369,2024-02-22,Senate,"Senate: Passed Senate with substitute (21-Y 19-N)",21,19,0,0,40
1800920,1394391,2024-02-26,House,"House: VOTE: Adoption (50-Y 46-N)",50,46,0,4,100
1800923,1371666,2024-01-30,Senate,"Senate: Reported from Privileges and Elections with substitute (13-Y 1-N 1-A)",13,1,1,0,15
1800923,1377894,2024-02-07,Senate,"Senate: Reported from Finance and Appropriations (15-Y 0-N)",15,0,0,0,15
1800923,1379944,2024-02-08,Senate,"Senate: Constitutional reading dispensed (40-Y 0-N)",40,0,0,0,40
1800923,1381623,2024-02-12,Senate,"Senate: Read third time and passed Senate (32-Y 4-N)",32,4,0,4,40
1800923,1381624,2024-02-12,Senate,"Senate: Reconsideration of passage agreed to by Senate (40-Y 0-N)",40,0,0,0,40
1800923,1381625,2024-02-12,Senate,"Senate: Passed Senate (37-Y 3-N)",37,3,0,0,40
1800923,1386758,2024-02-16,House,"House: Reported from Privileges and Elections (13-Y 8-N)",13,8,0,1,22
1800923,1390772,2024-02-21,House,"House: VOTE: Passage (52-Y 46-N)",52,46,0,2,100
1800923,1430155,2024-04-17,Senate,"Senate: Senate rejected Governor's recommendation (19-Y 21-N)",19,21,0,0,40
1800928,1368985,2024-01-25,Senate,"Senate: Continued to 2025 in Education and Health (15-Y 0-N)",15,0,0,0,15
1800933,1364170,2024-01-12,Senate,"Senate: Incorporated by Rehabilitation and Social Services (13-Y 0-N) ",13,0,0,0,13
1800937,1366994,2024-01-19,Senate,"Senate: Reported from Rehabilitation and Social Services (15-Y 0-N)",15,0,0,0,15
1800937,1368895,2024-01-22,Senate,"Senate: Constitutional reading dispensed (40-Y 0-N)",40,0,0,0,40
1800937,1368896,2024-01-24,Senate,"Senate: Read third time and passed Senate (40-Y 0-N)",40,0,0,0,40
1800937,1389547,2024-02-20,House,"House: Subcommittee recommends reporting with substitute (7-Y 0-N)",7,0,0,1,8
1800937,1392850,2024-02-22,House,"House: Reported from General Laws with substitute (22-Y 0-N)",22,0,0,0,22
1800937,1398796,2024-02-28,House,"House: VOTE: Passage (95-Y 5-N)",95,5,0,0,100
1800937,1400830,2024-03-01,Senate,"Senate: House substitute agreed to by Senate (40-Y 0-N)",40,0,0,0,40
1800941,1369231,2024-01-25,House,"House: Subcommittee recommends reporting (6-Y 4-N)",6,4,0,0,10
1800941,1369771,2024-01-26,House,"House: Reported from Public Safety (12-Y 10-N)",12,10,0,0,22
1800941,1374721,2024-02-02,House,"House: Subcommittee recommends reporting (5-Y 3-N)",5,3,0,0,8
1800941,1374722,2024-02-02,House,"House: Reported from Counties, Cities and Towns (12-Y 10-N)",12,10,0,0,22
1800941,1379393,2024-02-08,House,"House: VOTE: Passage (51-Y 47-N)",51,47,0,2,100
1800941,1394489,2024-02-26,Senate,"Senate: Reported from Courts of Justice (9-Y 6-N)",9,6,0,0,15
1800941,1395777,2024-02-27,Senate,"Senate: Constitutional reading dispensed (39-Y 0-N)",39,0,0,1,40
1800941,1398117,2024-02-28,Senate,"Senate: Passed Senate (20-Y 19-N)",20,19,0,1,40
1800947,1366419,2024-01-17,Senate,"Senate: Reported from General Laws and Technology (15-Y 0-N)",15,0,0,0,15
1800947,1372649,2024-01-31,Senate,"Senate: Passed by indefinitely in Finance and Appropriations (10-Y 5-N)",10,5,0,0,15
1800951,1378687,2024-02-07,Senate,"Senate: Continued to 2025 in General Laws and Technology (15-Y 0-N)",15,0,0,0,15
1800955,1367247,2024-01-22,Senate,"Senate: Failed to report (defeated) in Commerce and Labor (7-Y 8-N)",7,8,0,0,15
1800959,1378353,2024-02-07,Senate,"Senate: Continued to 2025 in Finance and Appropriations (15-Y 0-N)",15,0,0,0,15
1800964,1368432,2024-01-24,House,"House: Subcommittee recommends reporting (7-Y 3-N)",7,3,0,1,11
1800964,1372410,2024-01-31,House,"House: Reported from Agriculture, Chesapeake and Natural Resources (14-Y 8-N)",14,8,0,0,22
1800964,1377949,2024-02-07,House,"House: Subcommittee recommends reporting with substitute (8-Y 0-N)",8,0,0,1,9
1800964,1378374,2024-02-07,House,"House: Reported from Appropriations with substitute (14-Y 8-N)",14,8,0,0,22
1800964,1382963,2024-02-13,House,"House: VOTE: Passage (56-Y 43-N)",56,43,0,1,100
1800964,1389196,2024-02-20,Senate,"Senate: Reported from Agriculture, Conservation and Natural Resources (11-Y 2-N)",11,2,0,0,13
1800964,1392145,2024-02-22,Senate,"Senate: Constitutional reading dispensed (40-Y 0-N)",40,0,0,0,40
1800964,1393552,2024-02-23,Senate,"Senate: Passed Senate (38-Y 1-N)",38,1,0,1,40
1800968,1369838,2024-01-26,House,"House: Subcommittee recommends reporting with amendments (8-Y 0-N)",8,0,0,0,8
1800968,1369839,2024-01-26,House,"House: Reported from Counties, Cities and Towns with amendment(s) (20-Y 0-N)",20,0,0,2,22
1800968,1375154,2024-02-02,House,"House: Subcommittee recommends reporting with amendments (8-Y 0-N)",8,0,0,1,9
1800968,1378844,2024-02-07,House,"House: Reported from Courts of Justice with amendment(s) (22-Y 0-N)",22,0,0,0,22
1800968,1383529,2024-02-13,House,"House: VOTE: Block Vote Passage (99-Y 0-N)",99,0,0,1,100
1800968,1394548,2024-02-26,Senate,"Senate: Reported from Courts of Justice with amendment (14-Y 0-N)",14,0,0,0,14
1800968,1395875,2024-02-27,Senate,"Senate: Constitutional reading dispensed (39-Y 0-N)",39,0,0,1,40
1800968,1398280,2024-02-28,Senate,"Senate: Passed Senate with amendment (39-Y 0-N)",39,0,0,1,40
1800968,1400487,2024-03-01,House,"House: VOTE: Adoption (96-Y 0-N)",96,0,0,4,100
1800973,1366478,2024-01-18,Senate,"Senate: Reported from Education and Health (15-Y 0-N)",15,0,0,0,15
1800973,1368765,2024-01-19,Senate,"Senate: Constitutional reading dispensed (37-Y 0-N)",37,0,0,3,40
1800973,1368766,2024-01-23,Senate,"Senate: Read third time and passed Senate (39-Y 0-N)",39,0,0,1,40
1800973,1384200,2024-02-14,House,"House: Reported from Education (21-Y 0-N)",21,0,0,1,22
1800973,1387695,2024-02-19,House,"House: VOTE: Block Vote Passage (99-Y 0-N)",99,0,0,1,100
1800977,1367188,2024-01-22,Senate,"Senate: Reported from Local Government (15-Y 0-N)",15,0,0,0,15
1800977,1378010,2024-02-07,Senate,"Senate: Continued to 2025 in Finance and Appropriations (10-Y 5-N)",10,5,0,0,15
1800981,1367229,2024-01-22,Senate,"Senate: Reported from Local Government with amendments (9-Y 4-N 2-A)",9,4,2,0,15
1800981,1368918,2024-01-23,Senate,"Senate: Constitutional reading dispensed (39-Y 0-N)",39,0,0,1,40
1800981,1369979,2024-01-26,Senate,"Senate: Read third time and passed Senate (30-Y 7-N)",30,7,0,3,40
1800987,1379443,2024-02-08,House,"House: Subcommittee recommends reporting (7-Y 1-N)",7,1,0,0,8
1800987,1380421,2024-02-08,House,"House: Reported from General Laws (17-Y 3-N)",17,3,0,2,22
1800987,1383263,2024-02-13,House,"House: VOTE: Passage (69-Y 30-N)",69,30,0,1,100
1800987,1390421,2024-02-21,Senate,"Senate: Reported from General Laws and Technology (15-Y 0-N)",15,0,0,0,15
1800987,1393634,2024-02-23,Senate,"Senate: Constitutional reading dispensed (38-Y 0-N)",38,0,0,2,40
1800987,1394899,2024-02-26,Senate,"Senate: Passed Senate (27-Y 13-N)",27,13,0,0,40
1800999,1370386,2024-01-29,Senate,"Senate: Reading waived (40-Y 0-N)",40,0,0,0,40
1800999,1393190,2024-02-23,House,"House: Reported from Rules (17-Y 0-N)",17,0,0,1,18
1800999,1398324,2024-02-28,House,"House: VOTE: Block Vote Adoption (99-Y 0-N)",99,0,0,1,100
1800999,1398325,2024-02-28,House,"House: VOTE: Block Vote Adoption #2 (99-Y 0-N)",99,0,0,1,100
1801006,1371993,2024-01-30,House,"House: Subcommittee recommends reporting with substitute (5-Y 2-N)",5,2,0,1,8
1801006,1374191,2024-02-01,House,"House: Reported from Labor and Commerce with substitute (12-Y 10-N)",12,10,0,0,22
1801006,1378650,2024-02-07,House,"House: Subcommittee recommends laying on the table (7-Y 0-N)",7,0,0,2,9
1801012,1367761,2024-01-23,House,"House: Stricken from docket by Health and Human Services (22-Y 0-N)",22,0,0,0,22
1801020,1379751,2024-02-08,House,"House: Subcommittee recommends reporting with substitute (5-Y 2-N)",5,2,0,1,8
1801020,1379752,2024-02-08,House,"House: Reported from General Laws with substitute (12-Y 8-N)",12,8,0,2,22
1801020,1383049,2024-02-13,House,"House: VOTE: Passage (51-Y 48-N)",51,48,0,1,100
1801020,1391173,2024-02-21,Senate,"Senate: Reported from General Laws and Technology with substitute (11-Y 4-N)",11,4,0,0,15
1801020,1393495,2024-02-23,Senate,"Senate: Constitutional reading dispensed (38-Y 0-N)",38,0,0,2,40
1801020,1394603,2024-02-26,Senate,"Senate: Passed Senate with substitute (37-Y 3-N)",37,3,0,0,40
1801020,1398673,2024-02-28,House,"House: VOTE: Adoption (2-Y 97-N)",2,97,0,1,100
1801020,1401266,2024-03-01,Senate,"Senate: Senate insisted on substitute (40-Y 0-N)",40,0,0,0,40
1801020,1405936,2024-03-07,House,"House: VOTE: Adoption (51-Y 47-N)",51,47,0,2,100
1801020,1406546,2024-03-08,Senate,"Senate: Conference report agreed to by Senate (39-Y 1-N)",39,1,0,0,40
1801020,1430855,2024-04-17,House,"House: VOTE: REJECTED (0-Y 100-N)",0,100,0,0,100
1801029,1374882,2024-02-02,House,"House: Subcommittee recommends striking from docket (8-Y 0-N)",8,0,0,0,8
1801032,1366144,2024-01-16,Senate,"Senate: Incorporated by Agriculture, Conservation and Natural Resources ",14,0,0,0,14
1801047,1366655,2024-01-18,Senate,"Senate: Reported from Transportation (15-Y 0-N)",15,0,0,0,15
1801047,1377878,2024-02-07,Senate,"Senate: Reported from Finance and Appropriations (15-Y 0-N)",15,0,0,0,15
1801047,1379816,2024-02-08,Senate,"Senate: Constitutional reading dispensed (40-Y 0-N)",40,0,0,0,40
1801047,1380831,2024-02-09,Senate,"Senate: Constitutional reading dispensed (40-Y 0-N)",40,0,0,0,40
1801047,1380832,2024-02-09,Senate,"Senate: Passed Senate (40-Y 0-N)",40,0,0,0,40
1801047,1391340,2024-02-22,House,"House: Reported from Transportation (22-Y 0-N)",22,0,0,0,22
1801047,1395888,2024-02-27,House,"House: VOTE: Block Vote Passage (97-Y 0-N)",97,0,0,3,100
1801052,1373787,2024-02-01,House,"House: Subcommittee recommends reporting (8-Y 0-N)",8,0,0,0,8
1801052,1377349,2024-02-06,House,"House: Reported from Health and Human Services (22-Y 0-N)",22,0,0,0,22
1801052,1382322,2024-02-12,House,"House: VOTE: Block Vote Passage (100-Y 0-N)",100,0,0,0,100
1801052,1399554,2024-02-29,Senate,"Senate: Reported from Education and Health (15-Y 0-N)",15,0,0,0,15
1801052,1400885,2024-03-01,Senate,"Senate: Constitutional reading dispensed (40-Y 0-N)",40,0,0,0,40
1801052,1402304,2024-03-04,Senate,"Senate: Passed Senate (39-Y 0-N)",39,0,0,1,40
1801057,1364361,2024-01-16,Senate,"Senate: Passed by indefinitely in Privileges and Elections (8-Y 6-N)",8,6,0,0,14
1801060,1378347,2024-02-07,House,"House: Reported from Education with substitute (17-Y 5-N)",17,5,0,0,22
1801060,1382945,2024-02-13,House,"House: VOTE: Passage (97-Y 1-N)",97,1,0,2,100
1801060,1399137,2024-02-29,Senate,"Senate: Reported from Education and Health (14-Y 1-N)",14,1,0,0,15
1801060,1400987,2024-03-01,Senate,"Senate: Constitutional reading dispensed (40-Y 0-N)",40,0,0,0,40
1801060,1402800,2024-03-05,Senate,"Senate: Passed Senate (34-Y 6-N)",34,6,0,0,40
1801060,1402801,2024-03-05,Senate,"Senate: Reconsideration of Senate passage agreed to by Senate (40-Y 0-N)",40,0,0,0,40
1801060,1402802,2024-03-05,Senate,"Senate: Passed Senate (34-Y 6-N)",34,6,0,0,40
1801065,1372073,2024-01-30,House,"House: Subcommittee recommends laying on the table (6-Y 2-N)",6,2,0,1,9
1801070,1378733,2024-02-07,Senate,"Senate: Reported from Courts of Justice with substitute (12-Y 1-N 1-A)",12,1,1,0,14
1801070,1379324,2024-02-08,Senate,"Senate: Constitutional reading dispensed (40-Y 0-N)",40,0,0,0,40
1801070,1382053,2024-02-12,Senate,"Senate: Read third time and passed Senate (38-Y 2-N)",38,2,0,0,40
1801070,1386982,2024-02-16,House,"House: Subcommittee recommends reporting with amendments (8-Y 0-N)",8,0,0,1,9
1801070,1393793,2024-02-23,House,"House: Reported from Courts of Justice with amendment(s) (20-Y 0-N)",20,0,0,2,22
1801070,1398245,2024-02-28,House,"House: VOTE: Block Vote Passage (97-Y 0-N)",97,0,0,3,100
1801070,1400937,2024-03-01,Senate,"Senate: House amendments agreed to by Senate (40-Y 0-N)",40,0,0,0,40
1801074,1366887,2024-01-19,Senate,"Senate: Rereferred from Rehabilitation and Social Services (10-Y 0-N)",10,0,0,0,10
1801074,1379046,2024-02-08,Senate,"Senate: Reported from Education and Health with substitute (15-Y 0-N)",15,0,0,0,15
1801074,1381282,2024-02-12,Senate,"Senate: Reported from Finance and Appropriations (15-Y 0-N)",15,0,0,0,15
1801074,1381673,2024-02-12,Senate,"Senate: Constitutional reading dispensed (40-Y 0-N)",40,0,0,0,40
1801074,1383079,2024-02-13,Senate,"Senate: Constitutional reading dispensed (39-Y 0-N)",39,0,0,1,40
1801074,1383080,2024-02-13,Senate,"Senate: Passed Senate (40-Y 0-N)",40,0,0,0,40
1801074,1395563,2024-02-27,House,"House: Reported from Health and Human Services with substitute (21-Y 0-N)",21,0,0,1,22
1801074,1400562,2024-03-01,House,"House: VOTE: Block Vote Passage (97-Y 0-N)",97,0,0,3,100
1801074,1402779,2024-03-05,Senate,"Senate: House substitute agreed to by Senate (39-Y 0-N)",39,0,0,1,40
1801080,1370497,2024-01-29,Senate,"Senate: Passed by indefinitely in Courts of Justice (9-Y 6-N)",9,6,0,0,15
1801083,1368991,2024-01-25,Senate,"Senate: Reported from Education and Health with substitute (15-Y 0-N)",15,0,0,0,15
1801083,1376958,2024-02-06,Senate,"Senate: Reported from Finance and Appropriations (15-Y 0-N)",15,0,0,0,15
1801083,1377990,2024-02-07,Senate,"Senate: Constitutional reading dispensed (40-Y 0-N)",40,0,0,0,40
1801083,1379220,2024-02-08,Senate,"Senate: Constitutional reading dispensed (40-Y 0-N)",40,0,0,0,40
1801083,1379221,2024-02-08,Senate,"Senate: Read third time and passed Senate (40-Y 0-N)",40,0,0,0,40
1801083,1388456,2024-02-20,House,"House: Reported from Health and Human Services (22-Y 0-N)",22,0,0,0,22
1801083,1393353,2024-02-23,House,"House: VOTE: Block Vote Passage (98-Y 0-N)",98,0,0,2,100
1801089,1374184,2024-02-01,House,"House: Subcommittee recommends reporting with amendments (8-Y 0-N)",8,0,0,1,9
1801089,1377708,2024-02-06,House,"House: Reported from Health and Human Services with amendment(s) (22-Y 0-N)",22,0,0,0,22
1801089,1382426,2024-02-12,House,"House: VOTE: Block Vote Passage (100-Y 0-N)",100,0,0,0,100
1801089,1392295,2024-02-22,Senate,"Senate: Reported from Education and Health (13-Y 0-N 1-A)",13,0,1,0,14
1801089,1393792,2024-02-23,Senate,"Senate: Constitutional reading dispensed (38-Y 0-N)",38,0,0,2,40
1801089,1395310,2024-02-26,Senate,"Senate: Passed Senate (40-Y 0-N)",40,0,0,0,40
1801094,1367925,2024-01-23,House,"House: Subcommittee recommends reporting (8-Y 0-N)",8,0,0,0,8
1801094,1368652,2024-01-24,House,"House: Reported from Finance (22-Y 0-N)",22,0,0,0,22
1801094,1378901,2024-02-07,House,"House: Reported from Appropriations (22-Y 0-N)",22,0,0,0,22
1801094,1383946,2024-02-13,House,"House: VOTE: Block Vote Passage (99-Y 0-N)",99,0,0,1,100
1801094,1386252,2024-02-15,Senate,"Senate: Reported from Finance and Appropriations with amendments (15-Y 0-N)",15,0,0,0,15
1801094,1387384,2024-02-19,Senate,"Senate: Constitutional reading dispensed (38-Y 0-N)",38,0,0,2,40
1801094,1389535,2024-02-20,Senate,"Senate: Passed Senate with amendments (40-Y 0-N)",40,0,0,0,40
1801094,1392866,2024-02-22,House,"House: VOTE: Adoption (99-Y 0-N)",99,0,0,1,100
1801102,1366880,2024-01-19,Senate,"Senate: Rereferred from Rehabilitation and Social Services (10-Y 0-N)",10,0,0,0,10
1801102,1379405,2024-02-08,Senate,"Senate: Reported from Education and Health with amendment (15-Y 0-N)",15,0,0,0,15
1801102,1379406,2024-02-08,Senate,"Senate: Constitutional reading dispensed (40-Y 0-N)",40,0,0,0,40
1801102,1380606,2024-02-09,Senate,"Senate: Constitutional reading dispensed (40-Y 0-N)",40,0,0,0,40
1801102,1380607,2024-02-09,Senate,"Senate: Read third time and passed Senate (40-Y 0-N)",40,0,0,0,40
1801102,1388602,2024-02-20,House,"House: Reported from Health and Human Services with amendment(s) (22-Y 0-N)",22,0,0,0,22
1801102,1393371,2024-02-23,House,"House: VOTE: Block Vote Passage (98-Y 0-N)",98,0,0,2,100
1801102,1396081,2024-02-27,Senate,"Senate: House amendments agreed to by Senate (39-Y 0-N)",39,0,0,1,40
1801106,1364320,2024-01-15,Senate,"Senate: Reported from Courts of Justice (15-Y 0-N)",15,0,0,0,15
1801106,1368401,2024-01-16,Senate,"Senate: Constitutional reading dispensed (38-Y 0-N)",38,0,0,1,39
1801106,1368402,2024-01-18,Senate,"Senate: Read third time and passed Senate (40-Y 0-N)",40,0,0,0,40
1801106,1386626,2024-02-16,House,"House: Reported from Public Safety (22-Y 0-N)",22,0,0,0,22
1801106,1389945,2024-02-21,House,"House: VOTE: Block Vote Passage (100-Y 0-N)",100,0,0,0,100
1801111,1376794,2024-02-06,House,"House: Subcommittee recommends reporting (6-Y 2-N)",6,2,0,0,8
1801111,1378162,2024-02-07,House,"House: Reported from Education (14-Y 8-N)",14,8,0,0,22
1801111,1383020,2024-02-13,House,"House: VOTE: Passage (55-Y 40-N)",55,40,0,5,100
1801111,1391465,2024-02-22,Senate,"Senate: Reported from Education and Health (9-Y 5-N)",9,5,0,0,14
1801111,1393666,2024-02-23,Senate,"Senate: Constitutional reading dispensed (38-Y 0-N)",38,0,0,2,40
1801111,1394419,2024-02-26,Senate,"Senate: Passed Senate (21-Y 18-N)",21,18,0,1,40
1801116,1367326,2024-01-22,Senate,"Senate: Reported from Commerce and Labor with substitute (15-Y 0-N)",15,0,0,0,15
1801116,1368574,2024-01-24,Senate,"Senate: Constitutional reading dispensed (40-Y 0-N)",40,0,0,0,40
1801116,1369780,2024-01-26,Senate,"Senate: Read third time and passed Senate (38-Y 0-N)",38,0,0,2,40
1801116,1389266,2024-02-20,House,"House: Reported from Labor and Commerce with substitute (22-Y 0-N)",22,0,0,0,22
1801116,1394004,2024-02-23,House,"House: VOTE: Passage (96-Y 0-N)",96,0,0,4,100
1801116,1396192,2024-02-27,Senate,"Senate: House substitute with amendment agreed to by Senate (39-Y 0-N)",39,0,0,1,40
1801121,1378660,2024-02-07,Senate,"Senate: Reported from Courts of Justice with amendments (15-Y 0-N)",15,0,0,0,15
1801121,1379217,2024-02-08,Senate,"Senate: Constitutional reading dispensed (40-Y 0-N)",40,0,0,0,40
1801121,1381070,2024-02-09,Senate,"Senate: Constitutional reading dispensed (40-Y 0-N)",40,0,0,0,40
1801121,1381071,2024-02-09,Senate,"Senate: Passed Senate (34-Y 3-N)",34,3,0,3,40
1801121,1386952,2024-02-16,House,"House: Subcommittee recommends reporting with amendments (8-Y 0-N)",8,0,0,1,9
1801121,1393940,2024-02-23,House,"House: Reported from Courts of Justice with amendment(s) (20-Y 0-N)",20,0,0,2,22
1801121,1398468,2024-02-28,House,"House: VOTE: Passage (91-Y 8-N)",91,8,0,1,100
1801121,1401086,2024-03-01,Senate,"Senate: House amendment agreed to by Senate (35-Y 5-N)",35,5,0,0,40
1801125,1375709,2024-02-05,House,"House: Subcommittee recommends laying on the table (7-Y 1-N)",7,1,0,1,9
1801130,1366961,2024-01-19,Senate,"Senate: Incorporated by Rehabilitation and Social Services ",12,0,0,0,12
1801133,1367284,2024-01-22,Senate,"Senate: Reported from Courts of Justice with substitute (11-Y 4-N)",11,4,0,0,15
1801133,1372440,2024-01-31,Senate,"Senate: Reported from Finance and Appropriations (12-Y 3-N)",12,3,0,0,15
1801133,1374087,2024-02-01,Senate,"Senate: Constitutional reading dispensed (40-Y 0-N)",40,0,0,0,40
1801133,1376158,2024-02-05,Senate,"Senate: Read third time and passed Senate (28-Y 12-N)",28,12,0,0,40
1801133,1386616,2024-02-16,House,"House: Reported from Public Safety with substitute (22-Y 0-N)",22,0,0,0,22
1801133,1390771,2024-02-21,House,"House: VOTE: Passage (89-Y 2-N)",89,2,0,9,100
1801133,1393932,2024-02-23,Senate,"Senate: House substitute agreed to by Senate (28-Y 11-N)",28,11,0,1,40
1801137,1369791,2024-01-25,Senate,"Senate: Reported from Transportation with amendments (9-Y 5-N 1-A)",9,5,1,0,15
1801137,1377045,2024-02-06,Senate,"Senate: Continued to 2025 in Finance and Appropriations (11-Y 4-N)",11,4,0,0,15
1801140,1374192,2024-02-01,House,"House: Reported from Labor and Commerce with substitute (12-Y 10-N)",12,10,0,0,22
1801140,1378391,2024-02-07,House,"House: Subcommittee recommends reporting (5-Y 2-N)",5,2,0,2,9
1801140,1381034,2024-02-09,House,"House: Reported from Appropriations (11-Y 9-N)",11,9,0,2,22
1801140,1383523,2024-02-13,House,"House: VOTE: Passage (52-Y 46-N)",52,46,0,2,100
1801140,1391466,2024-02-22,Senate,"Senate: Rereferred from Education and Health (12-Y 0-N)",12,0,0,0,12
1801140,1395145,2024-02-26,Senate,"Senate: Reported from Commerce and Labor (10-Y 5-N)",10,5,0,0,15
1801140,1399962,2024-02-29,Senate,"Senate: Reported from Finance and Appropriations (10-Y 4-N)",10,4,0,0,14
1801140,1401906,2024-03-04,Senate,"Senate: Constitutional reading dispensed (40-Y 0-N)",40,0,0,0,40
1801140,1403019,2024-03-05,Senate,"Senate: Passed Senate (25-Y 15-N)",25,15,0,0,40
1801143,1364272,2024-01-15,Senate,"Senate: Reported from Courts of Justice with amendments (9-Y 6-N)",9,6,0,0,15
1801143,1377898,2024-02-07,Senate,"Senate: Continued to 2025 in Finance and Appropriations (9-Y 6-N)",9,6,0,0,15
1801182,1363993,2024-01-10,Senate,"Senate: Rules suspended (39-Y 0-N)",39,0,0,1,40
1801182,1363994,2024-01-10,Senate,"Senate: Agreed to by Senate (39-Y 0-N)",39,0,0,1,40
1801206,1376801,2024-02-06,House,"House: Subcommittee recommends reporting with substitute (6-Y 2-N)",6,2,0,0,8
1801206,1378285,2024-02-07,House,"House: Reported from Education with substitute (15-Y 6-N)",15,6,1,0,22
1801206,1382832,2024-02-13,House,"House: VOTE: Passage (68-Y 29-N)",68,29,0,3,100
1801206,1391437,2024-02-22,Senate,"Senate: Passed by indefinitely in Education and Health (9-Y 5-N)",9,5,0,0,14
1801230,1372251,2024-01-30,House,"House: Subcommittee recommends reporting (8-Y 0-N)",8,0,0,1,9
1801230,1374312,2024-02-01,House,"House: Reported from General Laws (22-Y 0-N)",22,0,0,0,22
1801230,1378146,2024-02-07,House,"House: VOTE: Passage (92-Y 6-N)",92,6,0,2,100
1801230,1384530,2024-02-14,Senate,"Senate: Reported from General Laws and Technology with substitute (15-Y 0-N)",15,0,0,0,15
1801230,1396142,2024-02-27,Senate,"Senate: Continued to 2025 in Finance and Appropriations (14-Y 1-N)",14,1,0,0,15
1801255,1369432,2024-01-25,House,"House: Subcommittee recommends reporting (8-Y 0-N)",8,0,0,0,8
1801255,1372091,2024-01-30,House,"House: Reported from General Laws (22-Y 0-N)",22,0,0,0,22
1801255,1375978,2024-02-05,House,"House: VOTE: Block Vote Passage (98-Y 0-N)",98,0,0,2,100
1801255,1393528,2024-02-23,Senate,"Senate: Reported from Rules (15-Y 0-N)",15,0,0,0,15
1801255,1394987,2024-02-26,Senate,"Senate: Constitutional reading dispensed (40-Y 0-N)",40,0,0,0,40
1801255,1396465,2024-02-27,Senate,"Senate: Passed Senate (39-Y 0-N)",39,0,0,1,40
1801280,1374335,2024-02-01,House,"House: Reported from Rules (17-Y 0-N)",17,0,0,1,18
1801280,1377480,2024-02-06,House,"House: VOTE: Block Vote Adoption (98-Y 0-N)",98,0,0,2,100
1801280,1395047,2024-02-26,Senate,"Senate: Reading waived (40-Y 0-N)",40,0,0,0,40
1801305,1374899,2024-02-02,House,"House: Subcommittee recommends reporting with amendment (6-Y 2-N)",6,2,0,0,8
1801305,1374900,2024-02-02,House,"House: Reported from Counties, Cities and Towns with amendment(s) (21-Y 1-N)",21,1,0,0,22
1801305,1380308,2024-02-08,House,"House: VOTE: Passage (94-Y 2-N)",94,2,0,4,100
1801305,1390254,2024-02-21,Senate,"Senate: Reported from Finance and Appropriations (14-Y 0-N)",14,0,0,0,14
1801305,1391911,2024-02-22,Senate,"Senate: Constitutional reading dispensed (40-Y 0-N)",40,0,0,0,40
1801305,1393612,2024-02-23,Senate,"Senate: Passed Senate (39-Y 0-N)",39,0,0,1,40
1801331,1377672,2024-02-06,House,"House: Subcommittee recommends reporting with substitute (6-Y 3-N)",6,3,0,1,10
1801331,1379924,2024-02-08,House,"House: Tabled in Labor and Commerce (22-Y 0-N)",22,0,0,0,22
1801356,1371462,2024-01-30,House,"House: Subcommittee recommends reporting with substitute (8-Y 0-N)",8,0,0,0,8
1801356,1374068,2024-02-01,House,"House: Reported from Health and Human Services with substitute (22-Y 0-N)",22,0,0,0,22
1801356,1380008,2024-02-08,House,"House: VOTE: Block Vote Passage (98-Y 0-N)",98,0,0,2,100
1801356,1385343,2024-02-15,Senate,"Senate: Reported from Education and Health (13-Y 0-N)",13,0,0,0,13
1801356,1386612,2024-02-16,Senate,"Senate: Constitutional reading dispensed (38-Y 0-N)",38,0,0,2,40
1801356,1387397,2024-02-19,Senate,"Senate: Passed Senate (39-Y 0-N)",39,0,0,1,40
1801379,1369032,2024-01-25,House,"House: Subcommittee recommends reporting (8-Y 0-N)",8,0,0,0,8
1801379,1371498,2024-01-30,House,"House: Reported from Health and Human Services (22-Y 0-N)",22,0,0,0,22
1801379,1376016,2024-02-05,House,"House: VOTE: Block Vote Passage (98-Y 0-N)",98,0,0,2,100
1801379,1391551,2024-02-22,Senate,"Senate: Reported from Education and Health (14-Y 0-N)",14,0,0,0,14
1801379,1393987,2024-02-23,Senate,"Senate: Constitutional reading dispensed (38-Y 0-N)",38,0,0,2,40
1801379,1394791,2024-02-26,Senate,"Senate: Passed Senate (40-Y 0-N)",40,0,0,0,40
1801406,1377348,2024-02-06,House,"House: Subcommittee recommends reporting (5-Y 2-N)",5,2,0,1,8
1801406,1379613,2024-02-08,House,"House: Reported from Health and Human Services (14-Y 8-N)",14,8,0,0,22
1801406,1383041,2024-02-13,House,"House: VOTE: Passage (56-Y 43-N)",56,43,0,1,100
1801406,1391460,2024-02-22,Senate,"Senate: Reported from Education and Health with substitute (9-Y 6-N)",9,6,0,0,15
1801406,1393523,2024-02-23,Senate,"Senate: Constitutional reading dispensed (38-Y 0-N)",38,0,0,2,40
1801406,1394922,2024-02-26,Senate,"Senate: Passed Senate with substitute (21-Y 19-N)",21,19,0,0,40
1801406,1397885,2024-02-28,House,"House: VOTE: Adoption (55-Y 44-N)",55,44,0,1,100
1801434,1370314,2024-01-29,House,"House: Subcommittee recommends striking from docket (10-Y 0-N)",10,0,0,0,10
1801459,1368976,2024-01-25,House,"House: Subcommittee recommends reporting with amendments (4-Y 2-N)",4,2,0,0,6
1801459,1369916,2024-01-26,House,"House: Reported from Public Safety with amendment(s) (12-Y 10-N)",12,10,0,0,22
1801459,1372954,2024-01-31,House,"House: Subcommittee recommends reporting with substitute (5-Y 3-N)",5,3,0,1,9
1801459,1374666,2024-02-02,House,"House: Reported from Appropriations with substitute (13-Y 9-N)",13,9,0,0,22
1801459,1379379,2024-02-08,House,"House: VOTE: Passage (51-Y 46-N)",51,46,0,3,100
1801459,1394729,2024-02-26,Senate,"Senate: Reported from Courts of Justice (9-Y 6-N)",9,6,0,0,15
1801459,1397504,2024-02-28,Senate,"Senate: Reported from Finance and Appropriations (10-Y 5-N)",10,5,0,0,15
1801459,1399211,2024-02-29,Senate,"Senate: Constitutional reading dispensed (39-Y 0-N)",39,0,0,1,40
1801459,1401613,2024-03-04,Senate,"Senate: Passed Senate (20-Y 19-N)",20,19,0,1,40
1801484,1373581,2024-02-01,House,"House: Subcommittee recommends reporting with substitute (4-Y 2-N)",4,2,0,1,7
1801484,1374500,2024-02-02,House,"House: Reported from Public Safety with substitute (20-Y 2-N)",20,2,0,0,22
1801484,1378154,2024-02-07,House,"House: Subcommittee recommends reporting (5-Y 3-N)",5,3,0,1,9
1801484,1378819,2024-02-07,House,"House: Reported from Appropriations (13-Y 9-N)",13,9,0,0,22
1801484,1383125,2024-02-13,House,"House: VOTE: Passage (94-Y 5-N)",94,5,0,1,100
1801484,1390880,2024-02-21,Senate,"Senate: Reported from Courts of Justice (15-Y 0-N)",15,0,0,0,15
1801484,1399954,2024-02-29,Senate,"Senate: Reported from Finance and Appropriations with substitute (14-Y 0-N)",14,0,0,0,14
1801484,1401806,2024-03-04,Senate,"Senate: Constitutional reading dispensed (40-Y 0-N)",40,0,0,0,40
1801484,1402946,2024-03-05,Senate,"Senate: Passed Senate with substitute (40-Y 0-N)",40,0,0,0,40
1801484,1404194,2024-03-06,House,"House: VOTE: Adoption (94-Y 4-N)",94,4,0,2,100
1801484,1429487,2024-04-17,Senate,"Senate: Senate concurred in Governor's recommendation (40-Y 0-N)",40,0,0,0,40
1801484,1430295,2024-04-17,House,"House: VOTE: Adoption (99-Y 0-N)",99,0,0,1,100
1801586,1372075,2024-01-30,House,"House: Subcommittee recommends laying on the table (6-Y 2-N)",6,2,0,0,8
1801611,1368772,2024-01-24,House,"House: Subcommittee recommends laying on the table (10-Y 0-N)",10,0,0,0,10
1801639,1367481,2024-01-22,House,"House: Subcommittee recommends reporting with amendments (9-Y 0-N)",9,0,0,1,10
1801639,1368271,2024-01-24,House,"House: Reported from Agriculture, Chesapeake and Natural Resources with amendment(s) (22-Y 0-N)",22,0,0,0,22
1801639,1372755,2024-01-31,House,"House: Subcommittee recommends reporting (8-Y 0-N)",8,0,0,1,9
1801639,1374611,2024-02-02,House,"House: Reported from Appropriations (22-Y 0-N)",22,0,0,0,22
1801639,1379481,2024-02-08,House,"House: VOTE: Passage (88-Y 9-N)",88,9,0,3,100
1801639,1389448,2024-02-20,Senate,"Senate: Reported from Agriculture, Conservation and Natural Resources (14-Y 0-N)",14,0,0,0,14
1801639,1397388,2024-02-28,Senate,"Senate: Reported from Finance and Appropriations with substitute (12-Y 0-N)",12,0,0,0,12
1801639,1399726,2024-02-29,Senate,"Senate: Constitutional reading dispensed (39-Y 0-N)",39,0,0,1,40
1801639,1400905,2024-03-01,Senate,"Senate: Passed Senate with substitute (40-Y 0-N)",40,0,0,0,40
1801639,1401514,2024-03-04,House,"House: VOTE: Adoption (1-Y 97-N)",1,97,0,2,100
1801639,1403400,2024-03-05,Senate,"Senate: Senate insisted on substitute (40-Y 0-N)",40,0,0,0,40
1801639,1406179,2024-03-08,Senate,"Senate: Conference report agreed to by Senate (39-Y 1-N)",39,1,0,0,40
1801639,1406180,2024-03-08,House,"House: VOTE: Adoption (91-Y 7-N)",91,7,0,2,100
1801690,1370943,2024-01-29,House,"House: Subcommittee recommends laying on the table (5-Y 3-N)",5,3,0,1,9
1801716,1368670,2024-01-24,House,"House: Subcommittee recommends reporting with amendments (5-Y 3-N)",5,3,0,1,9
1801716,1369879,2024-01-26,House,"House: Reported from Courts of Justice with amendment(s) (11-Y 10-N)",11,10,0,1,22
1801716,1370768,2024-01-29,House,"House: Subcommittee recommends reporting with amendments (4-Y 3-N)",4,3,0,2,9
1801716,1373112,2024-01-31,House,"House: Reported from Appropriations with amendment(s) (13-Y 9-N)",13,9,0,0,22
1801716,1377505,2024-02-06,House,"House: VOTE: Passage (53-Y 46-N)",53,46,0,1,100
1801716,1387325,2024-02-19,Senate,"Senate: Reported from Courts of Justice (8-Y 5-N)",8,5,0,0,13
1801716,1395900,2024-02-27,Senate,"Senate: Constitutional reading dispensed (39-Y 0-N)",39,0,0,1,40
1801716,1395901,2024-02-27,Senate,"Senate: Reported from Finance and Appropriations (10-Y 5-N)",10,5,0,0,15
1801716,1398275,2024-02-28,Senate,"Senate: Passed Senate (20-Y 19-N)",20,19,0,1,40
1801742,1368030,2024-01-23,House,"House: Subcommittee recommends reporting with amendments (7-Y 0-N)",7,0,0,0,7
1801742,1369338,2024-01-25,House,"House: Reported from Labor and Commerce with amendment(s) (21-Y 0-N)",21,0,0,1,22
1801742,1372818,2024-01-31,House,"House: VOTE: Block Vote Passage (100-Y 0-N)",100,0,0,0,100
1801742,1387332,2024-02-19,Senate,"Senate: Reported from Courts of Justice (12-Y 0-N 2-A)",12,0,2,0,14
1801742,1388539,2024-02-20,Senate,"Senate: Constitutional reading dispensed (39-Y 0-N)",39,0,0,1,40
1801742,1390502,2024-02-21,Senate,"Senate: Passed Senate with amendment (30-Y 10-N)",30,10,0,0,40
1801742,1393383,2024-02-23,House,"House: VOTE: Adoption (96-Y 0-N)",96,0,0,4,100
1801767,1374952,2024-02-02,House,"House: Reported from Privileges and Elections (21-Y 0-N)",21,0,1,0,22
1801767,1379704,2024-02-08,House,"House: VOTE: Passage (98-Y 0-N)",98,0,0,2,100
1801767,1394612,2024-02-26,Senate,"Senate: Reported from Local Government (12-Y 0-N)",12,0,0,0,12
1801767,1396811,2024-02-27,Senate,"Senate: Constitutional reading dispensed (39-Y 0-N)",39,0,0,1,40
1801767,1398411,2024-02-28,Senate,"Senate: Passed Senate (39-Y 0-N)",39,0,0,1,40
1801793,1374214,2024-02-01,House,"House: Subcommittee failed to recommend reporting (3-Y 5-N)",3,5,0,0,8
1801818,1370708,2024-01-29,House,"House: Subcommittee recommends reporting with substitute (7-Y 4-N)",7,4,0,0,11
1801818,1372750,2024-01-31,House,"House: Reported from Education with substitute (12-Y 10-N)",12,10,0,0,22
1801818,1377605,2024-02-06,House,"House: VOTE: Passage (51-Y 48-N)",51,48,0,1,100
1801818,1391458,2024-02-22,Senate,"Senate: Reported from Education and Health (9-Y 6-N)",9,6,0,0,15
1801818,1393937,2024-02-23,Senate,"Senate: Constitutional reading dispensed (38-Y 0-N)",38,0,0,2,40
1801818,1394639,2024-02-26,Senate,"Senate: Passed Senate (22-Y 18-N)",22,18,0,0,40
1801818,1430270,2024-04-17,House,"House: VOTE: Adoption (58-Y 42-N)",58,42,0,0,100
1801818,1430271,2024-04-17,Senate,"Senate: Senate concurred in Governor's recommendation (40-Y 0-N)",40,0,0,0,40
1801843,1377392,2024-02-06,House,"House: Subcommittee recommends reporting with substitute (8-Y 0-N)",8,0,0,0,8
1801870,1373802,2024-02-01,House,"House: Subcommittee recommends reporting (5-Y 3-N)",5,3,0,0,8
1801870,1377687,2024-02-06,House,"House: Reported from Health and Human Services (13-Y 9-N)",13,9,0,0,22
1801870,1382298,2024-02-12,House,"House: VOTE: Passage (50-Y 45-N)",50,45,0,5,100
1801870,1400561,2024-03-01,Senate,"Senate: Failed to report (defeated) in Rehabilitation and Social Services (6-Y 8-N)",6,8,0,0,14
1801896,1376328,2024-02-05,House,"House: Subcommittee recommends reporting (5-Y 3-N)",5,3,0,1,9
1801896,1380514,2024-02-09,House,"House: Reported from Privileges and Elections (12-Y 10-N)",12,10,0,0,22
1801896,1382863,2024-02-13,House,"House: VOTE: Passage (50-Y 48-N)",50,48,0,2,100
1801896,1396391,2024-02-27,Senate,"Senate: Reported from Privileges and Elections with substitute (8-Y 7-N)",8,7,0,0,15
1801896,1399584,2024-02-29,Senate,"Senate: Constitutional reading dispensed (39-Y 0-N)",39,0,0,1,40
1801896,1402137,2024-03-04,Senate,"Senate: Passed Senate with substitute (20-Y 19-N)",20,19,0,1,40
1801896,1403304,2024-03-05,House,"House: VOTE: Adoption (51-Y 49-N)",51,49,0,0,100
1801948,1371471,2024-01-30,House,"House: Subcommittee recommends striking from docket (8-Y 0-N)",8,0,0,0,8
1802000,1368226,2024-01-24,House,"House: Subcommittee recommends laying on the table (5-Y 3-N)",5,3,0,0,8
1802025,1371037,2024-01-29,House,"House: Subcommittee recommends reporting with substitute (7-Y 0-N)",7,0,0,2,9
1802025,1372767,2024-01-31,House,"House: Reported from Appropriations with substitute (22-Y 0-N)",22,0,0,0,22
1802025,1377696,2024-02-06,House,"House: VOTE: Block Vote Passage (99-Y 0-N)",99,0,0,1,100
1802025,1398227,2024-02-28,Senate,"Senate: Reported from Finance and Appropriations (15-Y 0-N)",15,0,0,0,15
1802025,1399848,2024-02-29,Senate,"Senate: Constitutional reading dispensed (39-Y 0-N)",39,0,0,1,40
1802025,1400652,2024-03-01,Senate,"Senate: Passed Senate (40-Y 0-N)",40,0,0,0,40
1802074,1367110,2024-01-19,House,"House: Subcommittee recommends reporting with substitute (7-Y 0-N)",7,0,0,2,9
1802074,1369834,2024-01-26,House,"House: Reported from Courts of Justice with substitute (21-Y 0-N)",21,0,0,1,22
1802074,1371218,2024-01-29,House,"House: Subcommittee recommends reporting with substitute (7-Y 0-N)",7,0,0,2,9
1802074,1372791,2024-01-31,House,"House: Reported from Appropriations with substitute (22-Y 0-N)",22,0,0,0,22
1802074,1377062,2024-02-06,House,"House: VOTE: Block Vote Passage (99-Y 0-N)",99,0,0,1,100
1802074,1387375,2024-02-19,Senate,"Senate: Reported from Courts of Justice (14-Y 0-N)",14,0,0,0,14
1802074,1398161,2024-02-28,Senate,"Senate: Reported from Finance and Appropriations (15-Y 0-N)",15,0,0,0,15
1802074,1399827,2024-02-29,Senate,"Senate: Constitutional reading dispensed (39-Y 0-N)",39,0,0,1,40
1802074,1401029,2024-03-01,Senate,"Senate: Passed Senate (40-Y 0-N)",40,0,0,0,40
1802102,1374743,2024-02-02,House,"House: Subcommittee recommends laying on the table (8-Y 0-N)",8,0,0,1,9
1802126,1374372,2024-02-01,House,"House: Subcommittee recommends reporting with substitute (5-Y 3-N)",5,3,0,0,8
1802126,1377573,2024-02-06,House,"House: Reported from General Laws with substitute (10-Y 9-N)",10,9,0,3,22
1802126,1382239,2024-02-12,House,"House: VOTE: Passage (50-Y 49-N)",50,49,0,1,100
1802126,1398611,2024-02-28,Senate,"Senate: Reported from General Laws and Technology (8-Y 5-N 2-A)",8,5,2,0,15
1802126,1400920,2024-03-01,Senate,"Senate: Constitutional reading dispensed (40-Y 0-N)",40,0,0,0,40
1802126,1402918,2024-03-05,Senate,"Senate: Passed Senate with substitute (20-Y 19-N)",20,19,0,1,40
1802126,1404729,2024-03-06,House,"House: VOTE: Adoption (51-Y 48-N)",51,48,0,1,100
1802151,1370380,2024-01-29,House,"House: Subcommittee recommends reporting (6-Y 0-N)",6,0,0,0,6
1802151,1373734,2024-02-01,House,"House: Reported from Rules (18-Y 0-N)",18,0,0,0,18
1802151,1378001,2024-02-07,House,"House: Subcommittee recommends laying on the table (8-Y 0-N)",8,0,0,1,9
1802151,1380998,2024-02-09,House,"House: Reported from Appropriations (20-Y 0-N)",20,0,0,2,22
1802151,1383234,2024-02-13,House,"House: VOTE: Block Vote Passage (99-Y 0-N)",99,0,0,1,100
1802151,1400467,2024-03-01,Senate,"Senate: Reported from Rules (15-Y 0-N)",15,0,0,0,15
1802151,1402238,2024-03-04,Senate,"Senate: Constitutional reading dispensed (40-Y 0-N)",40,0,0,0,40
1802151,1403548,2024-03-05,Senate,"Senate: Passed Senate (40-Y 0-N)",40,0,0,0,40
1802178,1370336,2024-01-29,House,"House: Subcommittee recommends reporting (10-Y 0-N)",10,0,0,0,10
1802178,1375849,2024-02-05,House,"House: Reported from Communications, Technology and Innovation (22-Y 0-N)",22,0,0,0,22
1802178,1380587,2024-02-09,House,"House: VOTE: Block Vote Passage (96-Y 0-N)",96,0,0,4,100
1802178,1391221,2024-02-21,Senate,"Senate: Reported from General Laws and Technology (15-Y 0-N)",15,0,0,0,15
1802178,1393609,2024-02-23,Senate,"Senate: Constitutional reading dispensed (38-Y 0-N)",38,0,0,2,40
1802178,1394718,2024-02-26,Senate,"Senate: Passed Senate (40-Y 0-N)",40,0,0,0,40
1802229,1374906,2024-02-02,House,"House: Subcommittee recommends reporting with substitute (8-Y 0-N)",8,0,0,1,9
1802229,1378473,2024-02-07,House,"House: Reported from Courts of Justice with substitute (22-Y 0-N)",22,0,0,0,22
1802229,1383447,2024-02-13,House,"House: VOTE: Block Vote Passage (99-Y 0-N)",99,0,0,1,100
1802229,1394249,2024-02-26,Senate,"Senate: Reported from Courts of Justice with substitute (14-Y 0-N)",14,0,0,0,14
1802229,1397528,2024-02-28,Senate,"Senate: Reported from Finance and Appropriations (15-Y 0-N)",15,0,0,0,15
1802229,1399224,2024-02-29,Senate,"Senate: Constitutional reading dispensed (39-Y 0-N)",39,0,0,1,40
1802229,1401019,2024-03-01,Senate,"Senate: Passed Senate with substitute (40-Y 0-N)",40,0,0,0,40
1802229,1401625,2024-03-04,House,"House: VOTE: Adoption (98-Y 0-N)",98,0,0,2,100
1802256,1369465,2024-01-25,House,"House: Subcommittee recommends reporting (8-Y 0-N)",8,0,0,0,8
1802256,1372234,2024-01-30,House,"House: Reported from General Laws (15-Y 7-N)",15,7,0,0,22
1802256,1376610,2024-02-05,House,"House: VOTE: Passage (53-Y 45-N)",53,45,0,2,100
1802256,1384474,2024-02-14,Senate,"Senate: Reported from General Laws and Technology (14-Y 0-N)",14,0,0,0,14
1802256,1386708,2024-02-16,Senate,"Senate: Constitutional reading dispensed (38-Y 0-N)",38,0,0,2,40
1802256,1387542,2024-02-19,Senate,"Senate: Passed Senate (39-Y 0-N)",39,0,0,1,40
1802256,1430145,2024-04-17,House,"House: VOTE: Adoption (0-Y 99-N)",0,99,0,1,100
1802282,1370785,2024-01-29,House,"House: Subcommittee recommends reporting with substitute (6-Y 4-N)",6,4,0,0,10
1802282,1372826,2024-01-31,House,"House: Reported from Education with substitute (12-Y 9-N)",12,9,0,1,22
1802282,1376326,2024-02-05,House,"House: Subcommittee recommends reporting with substitute (8-Y 0-N)",8,0,0,1,9
1802282,1378557,2024-02-07,House,"House: Reported from Appropriations with substitute (18-Y 4-N)",18,4,0,0,22
1802282,1382980,2024-02-13,House,"House: VOTE: Passage (66-Y 33-N)",66,33,0,1,100
1802282,1399106,2024-02-29,Senate,"Senate: Reported from Education and Health (10-Y 5-N)",10,5,0,0,15
1802282,1400955,2024-03-01,Senate,"Senate: Constitutional reading dispensed (40-Y 0-N)",40,0,0,0,40
1802282,1403578,2024-03-05,Senate,"Senate: Passed Senate (22-Y 18-N)",22,18,0,0,40
1802305,1373320,2024-01-31,House,"House: Subcommittee recommends reporting with substitute (7-Y 1-N)",7,1,0,0,8
1802305,1377099,2024-02-06,House,"House: Reported from Transportation with substitute (14-Y 7-N)",14,7,0,1,22
1802305,1382441,2024-02-12,House,"House: VOTE: Passage (56-Y 42-N)",56,42,0,2,100
1802305,1400347,2024-02-29,Senate,"Senate: Failed to report (defeated) in Transportation (7-Y 7-N)",7,7,0,0,14
1802330,1374994,2024-02-02,House,"House: Subcommittee recommends reporting with amendments (4-Y 2-N)",4,2,0,3,9
1802330,1378388,2024-02-07,House,"House: Reported from Courts of Justice with amendment(s) (17-Y 5-N)",17,5,0,0,22
1802330,1380635,2024-02-09,House,"House: Subcommittee recommends reporting (6-Y 1-N)",6,1,0,2,9
1802330,1380636,2024-02-09,House,"House: Reported from Appropriations (16-Y 4-N)",16,4,0,2,22
1802330,1383506,2024-02-13,House,"House: VOTE: Passage (64-Y 35-N)",64,35,0,1,100
1802330,1390826,2024-02-21,Senate,"Senate: Reported from Courts of Justice (10-Y 5-N)",10,5,0,0,15
1802330,1395903,2024-02-27,Senate,"Senate: Constitutional reading dispensed (39-Y 0-N)",39,0,0,1,40
1802330,1395904,2024-02-27,Senate,"Senate: Reported from Finance and Appropriations (11-Y 4-N)",11,4,0,0,15
1802330,1398262,2024-02-28,Senate,"Senate: Passed Senate (22-Y 17-N)",22,17,0,1,40
1802356,1370644,2024-01-29,House,"House: Subcommittee recommends laying on the table (6-Y 0-N)",6,0,0,0,6
1802384,1369814,2024-01-26,House,"House: Subcommittee recommends reporting (8-Y 0-N)",8,0,0,0,8
1802384,1369815,2024-01-26,House,"House: Reported from Counties, Cities and Towns (20-Y 0-N)",20,0,0,2,22
1802384,1374131,2024-02-01,House,"House: Subcommittee recommends reporting (7-Y 0-N)",7,0,1,0,8
1802384,1377831,2024-02-06,House,"House: Reported from General Laws (19-Y 1-N)",19,1,0,2,22
1802384,1382405,2024-02-12,House,"House: VOTE: Passage (99-Y 0-N)",99,0,0,1,100
1802384,1390744,2024-02-21,Senate,"Senate: Reported from General Laws and Technology (9-Y 0-N)",9,0,0,0,9
1802384,1393914,2024-02-23,Senate,"Senate: Constitutional reading dispensed (38-Y 0-N)",38,0,0,2,40
1802384,1394965,2024-02-26,Senate,"Senate: Passed Senate (40-Y 0-N)",40,0,0,0,40
1802410,1375823,2024-02-05,House,"House: Subcommittee recommends reporting with amendments (6-Y 4-N)",6,4,0,0,10
1802410,1378541,2024-02-07,House,"House: Reported from Agriculture, Chesapeake and Natural Resources with amendment(s) (14-Y 8-N)",14,8,0,0,22
1802410,1382917,2024-02-13,House,"House: VOTE: Passage (58-Y 41-N)",58,41,0,1,100
1802410,1386070,2024-02-15,Senate,"Senate: Reported from Finance and Appropriations (14-Y 1-N)",14,1,0,0,15
1802410,1387431,2024-02-19,Senate,"Senate: Constitutional reading dispensed (38-Y 0-N)",38,0,0,2,40
1802410,1388576,2024-02-20,Senate,"Senate: Passed Senate (28-Y 11-N)",28,11,0,1,40
1802410,1429571,2024-04-17,Senate,"Senate: Senate concurred in Governor's recommendation (40-Y 0-N)",40,0,0,0,40
1802410,1430311,2024-04-17,House,"House: VOTE: Adoption (62-Y 36-N)",62,36,0,2,100
1802435,1370912,2024-01-29,House,"House: Subcommittee recommends reporting with substitute (7-Y 1-N)",7,1,0,1,9
1802435,1375867,2024-02-02,House,"House: Reported from Courts of Justice with substitute (21-Y 0-N)",21,0,0,1,22
1802435,1380327,2024-02-08,House,"House: VOTE: Block Vote Passage (98-Y 0-N)",98,0,0,2,100
1802435,1387356,2024-02-19,Senate,"Senate: Reported from Courts of Justice with amendments (12-Y 0-N)",12,0,0,0,12
1802435,1388425,2024-02-20,Senate,"Senate: Constitutional reading dispensed (39-Y 0-N)",39,0,0,1,40
1802435,1389946,2024-02-21,Senate,"Senate: Passed Senate with amendments (40-Y 0-N)",40,0,0,0,40
1802435,1394075,2024-02-23,House,"House: VOTE: Adoption (96-Y 0-N)",96,0,0,4,100
1802461,1371434,2024-01-30,House,"House: Subcommittee recommends reporting (9-Y 0-N)",9,0,0,0,9
1802461,1372672,2024-01-31,House,"House: Reported from Education (17-Y 5-N)",17,5,0,0,22
1802461,1375948,2024-02-05,House,"House: Subcommittee recommends reporting with amendments (7-Y 1-N)",7,1,0,1,9
1802461,1378729,2024-02-07,House,"House: Reported from Appropriations with amendment(s) (14-Y 8-N)",14,8,0,0,22
1802461,1383231,2024-02-13,House,"House: VOTE: Passage (63-Y 36-N)",63,36,0,1,100
1802461,1399148,2024-02-29,Senate,"Senate: Reported from Education and Health (15-Y 0-N)",15,0,0,0,15
1802461,1401411,2024-03-04,Senate,"Senate: Continued to 2025 in Finance and Appropriations (15-Y 0-N)",15,0,0,0,15
1802485,1370885,2024-01-29,House,"House: Subcommittee recommends reporting (10-Y 0-N)",10,0,0,0,10
1802485,1372420,2024-01-31,House,"House: Reported from Agriculture, Chesapeake and Natural Resources (22-Y 0-N)",22,0,0,0,22
1802485,1377417,2024-02-06,House,"House: VOTE: Block Vote Passage (99-Y 0-N)",99,0,0,1,100
1802485,1386750,2024-02-16,Senate,"Senate: Reported from Agriculture, Conservation and Natural Resources (11-Y 0-N)",11,0,0,0,11
1802485,1387430,2024-02-19,Senate,"Senate: Constitutional reading dispensed (38-Y 0-N)",38,0,0,2,40
1802485,1388779,2024-02-20,Senate,"Senate: Passed Senate (40-Y 0-N)",40,0,0,0,40
1802512,1371899,2024-01-30,House,"House: Subcommittee recommends reporting (8-Y 0-N)",8,0,0,0,8
1802512,1372738,2024-01-31,House,"House: Reported from Education (21-Y 0-N)",21,0,0,1,22
1802512,1377486,2024-02-06,House,"House: VOTE: Block Vote Passage (99-Y 0-N)",99,0,0,1,100
1802512,1391559,2024-02-22,Senate,"Senate: Reported from Education and Health (15-Y 0-N)",15,0,0,0,15
1802512,1393775,2024-02-23,Senate,"Senate: Constitutional reading dispensed (38-Y 0-N)",38,0,0,2,40
1802512,1394438,2024-02-26,Senate,"Senate: Passed Senate (40-Y 0-N)",40,0,0,0,40
1802536,1374497,2024-02-02,House,"House: Reported from Public Safety with substitute (12-Y 9-N)",12,9,0,1,22
1802590,1366102,2024-01-17,House,"House: Subcommittee recommends passing by indefinitely (8-Y 0-N)",8,0,0,0,8
1802615,1374938,2024-02-02,House,"House: Subcommittee recommends striking from docket (8-Y 0-N)",8,0,0,0,8
1802640,1372119,2024-01-30,House,"House: Subcommittee recommends reporting with substitute (4-Y 3-N)",4,3,0,0,7
1802640,1374211,2024-02-01,House,"House: Reported from Labor and Commerce with substitute (12-Y 10-N)",12,10,0,0,22
1802664,1374452,2024-02-01,House,"House: Subcommittee recommends reporting with substitute (8-Y 0-N)",8,0,0,0,8
1802664,1377496,2024-02-06,House,"House: Reported from Health and Human Services with substitute (22-Y 0-N)",22,0,0,0,22
1802664,1382491,2024-02-12,House,"House: VOTE: Block Vote Passage (100-Y 0-N)",100,0,0,0,100
1802664,1390382,2024-02-21,Senate,"Senate: Reported from General Laws and Technology (15-Y 0-N)",15,0,0,0,15
1802664,1393694,2024-02-23,Senate,"Senate: Constitutional reading dispensed (38-Y 0-N)",38,0,0,2,40
1802664,1394894,2024-02-26,Senate,"Senate: Passed Senate (40-Y 0-N)",40,0,0,0,40
1802716,1376941,2024-02-06,House,"House: Subcommittee recommends passing by indefinitely (5-Y 2-N)",5,2,0,1,8
1802741,1368255,2024-01-24,House,"House: Subcommittee recommends reporting (6-Y 2-N)",6,2,0,0,8
1802741,1370388,2024-01-29,House,"House: Reported from Education (13-Y 9-N)",13,9,0,0,22
1802741,1376262,2024-02-05,House,"House: Subcommittee recommends reporting with substitute (7-Y 1-N)",7,1,0,1,9
1802741,1378558,2024-02-07,House,"House: Reported from Appropriations with substitute (16-Y 6-N)",16,6,0,0,22
1802741,1383545,2024-02-13,House,"House: VOTE: Passage (64-Y 35-N)",64,35,0,1,100
1802741,1399094,2024-02-29,Senate,"Senate: Reported from Education and Health (15-Y 0-N)",15,0,0,0,15
1802741,1401402,2024-03-04,Senate,"Senate: Reported from Finance and Appropriations with substitute (10-Y 5-N)",10,5,0,0,15
1802741,1402889,2024-03-05,Senate,"Senate: Constitutional reading dispensed (39-Y 0-N)",39,0,0,1,40
1802741,1404171,2024-03-06,Senate,"Senate: Passed Senate with substitute (21-Y 19-N)",21,19,0,0,40
1802741,1405660,2024-03-07,House,"House: VOTE: REJECTED (0-Y 97-N)",0,97,0,3,100
1802741,1405661,2024-03-07,Senate,"Senate: Senate receded from substitute (21-Y 19-N)",21,19,0,0,40
1802741,1430120,2024-04-17,House,"House: VOTE: Adoption (63-Y 37-N)",63,37,0,0,100
1802741,1430121,2024-04-17,Senate,"Senate: Senate concurred in Governor's recommendation (40-Y 0-N)",40,0,0,0,40
1802769,1368019,2024-01-23,House,"House: Subcommittee recommends striking from docket (7-Y 0-N)",7,0,0,1,8
1802843,1371892,2024-01-30,House,"House: Subcommittee recommends reporting (8-Y 0-N)",8,0,0,0,8
1802843,1372723,2024-01-31,House,"House: Reported from Education (21-Y 0-N)",21,0,0,1,22
1802843,1376333,2024-02-05,House,"House: Subcommittee recommends reporting with amendments (8-Y 0-N)",8,0,0,1,9
1802843,1378555,2024-02-07,House,"House: Reported from Appropriations with amendment(s) (22-Y 0-N)",22,0,0,0,22
1802843,1383646,2024-02-13,House,"House: VOTE: Block Vote Passage (99-Y 0-N)",99,0,0,1,100
1802843,1400464,2024-03-01,Senate,"Senate: Reported from Rules (13-Y 0-N)",13,0,0,0,13
1802843,1402224,2024-03-04,Senate,"Senate: Constitutional reading dispensed (40-Y 0-N)",40,0,0,0,40
1802843,1403428,2024-03-05,Senate,"Senate: Passed Senate (40-Y 0-N)",40,0,0,0,40
1802869,1367818,2024-01-23,House,"House: Subcommittee recommends reporting (8-Y 0-N)",8,0,0,1,9
1802869,1368290,2024-01-24,House,"House: Reported from Education (21-Y 0-N)",21,0,0,1,22
1802869,1371865,2024-01-30,House,"House: VOTE: Block Vote Passage (100-Y 0-N)",100,0,0,0,100
1802869,1385340,2024-02-15,Senate,"Senate: Reported from Education and Health (13-Y 0-N)",13,0,0,0,13
1802869,1386763,2024-02-16,Senate,"Senate: Constitutional reading dispensed (38-Y 0-N)",38,0,0,2,40
1802869,1387509,2024-02-19,Senate,"Senate: Passed Senate (39-Y 0-N)",39,0,0,1,40
1802924,1371436,2024-01-30,House,"House: Subcommittee recommends reporting with substitute (8-Y 0-N)",8,0,0,0,8
1802924,1372754,2024-01-31,House,"House: Reported from Education with substitute (21-Y 0-N)",21,0,0,1,22
1802924,1376291,2024-02-05,House,"House: Subcommittee recommends reporting with substitute (8-Y 0-N)",8,0,0,1,9
1802924,1378748,2024-02-07,House,"House: Reported from Appropriations with substitute (21-Y 0-N)",21,0,0,1,22
1802924,1383316,2024-02-13,House,"House: VOTE: Passage (85-Y 14-N)",85,14,0,1,100
1802924,1399124,2024-02-29,Senate,"Senate: Reported from Education and Health with substitute (15-Y 0-N)",15,0,0,0,15
1802924,1401407,2024-03-04,Senate,"Senate: Reported from Finance and Appropriations (15-Y 0-N)",15,0,0,0,15
1802924,1402911,2024-03-05,Senate,"Senate: Constitutional reading dispensed (39-Y 0-N)",39,0,0,1,40
1802924,1404159,2024-03-06,Senate,"Senate: Passed Senate with substitute (40-Y 0-N)",40,0,0,0,40
1802924,1405673,2024-03-07,House,"House: VOTE: REJECTED (0-Y 97-N)",0,97,0,3,100
1802924,1405674,2024-03-07,Senate,"Senate: Senate insisted on substitute (40-Y 0-N)",40,0,0,0,40
1802924,1406327,2024-03-08,House,"House: VOTE: Adoption (82-Y 14-N)",82,14,0,4,100
1802924,1406681,2024-03-09,Senate,"Senate: Conference report agreed to by Senate (39-Y 1-N)",39,1,0,0,40
1802924,1430334,2024-04-17,House,"House: VOTE: Adoption (0-Y 100-N)",0,100,0,0,100
1802948,1371898,2024-01-30,House,"House: Subcommittee recommends reporting with substitute (8-Y 0-N)",8,0,0,1,9
1802948,1373093,2024-01-31,House,"House: Reported from Finance with substitute (22-Y 0-N)",22,0,0,0,22
1802948,1377499,2024-02-06,House,"House: VOTE: Block Vote Passage (99-Y 0-N)",99,0,0,1,100
1802948,1386251,2024-02-15,Senate,"Senate: Reported from Finance and Appropriations (15-Y 0-N)",15,0,0,0,15
1802948,1387385,2024-02-19,Senate,"Senate: Constitutional reading dispensed (38-Y 0-N)",38,0,0,2,40
1802948,1388481,2024-02-20,Senate,"Senate: Passed Senate (40-Y 0-N)",40,0,0,0,40
1802973,1373328,2024-01-31,House,"House: Subcommittee recommends reporting (7-Y 1-N)",7,1,0,0,8
1802973,1377039,2024-02-06,House,"House: Reported from Transportation (15-Y 7-N)",15,7,0,0,22
1802973,1382175,2024-02-12,House,"House: VOTE: Passage (59-Y 41-N)",59,41,0,0,100
1802973,1392420,2024-02-22,Senate,"Senate: Reported from Transportation (9-Y 5-N)",9,5,0,0,14
1802973,1394375,2024-02-26,Senate,"Senate: Constitutional reading dispensed (40-Y 0-N)",40,0,0,0,40
1802973,1396563,2024-02-27,Senate,"Senate: Passed Senate (21-Y 18-N)",21,18,0,1,40
1803022,1371569,2024-01-30,House,"House: Subcommittee failed to recommend reporting (3-Y 5-N)",3,5,0,0,8
1803050,1367629,2024-01-23,House,"House: Subcommittee recommends reporting (8-Y 0-N)",8,0,0,1,9
1803050,1368245,2024-01-24,House,"House: Reported from Education (18-Y 3-N)",18,3,0,1,22
1803050,1370948,2024-01-29,House,"House: Subcommittee recommends laying on the table (7-Y 0-N)",7,0,0,2,9
1803099,1370299,2024-01-29,House,"House: Subcommittee recommends reporting (10-Y 0-N)",10,0,0,0,10
1803099,1375623,2024-02-05,House,"House: Reported from Communications, Technology and Innovation (22-Y 0-N)",22,0,0,0,22
1803099,1376797,2024-02-06,House,"House: Subcommittee recommends reporting (8-Y 0-N)",8,0,0,0,8
1803099,1378407,2024-02-07,House,"House: Reported from Education (22-Y 0-N)",22,0,0,0,22
1803099,1380624,2024-02-09,House,"House: Subcommittee recommends laying on the table (4-Y 1-N)",4,1,0,4,9
1803125,1376461,2024-02-05,House,"House: Subcommittee recommends continuing to 2025 with amendment(s) (7-Y 0-N)",7,0,0,1,8
1803149,1373597,2024-02-01,House,"House: Subcommittee recommends laying on the table (6-Y 3-N)",6,3,0,0,9
1803149,1380742,2024-02-09,House,"House: Reported from Counties, Cities and Towns with substitute (18-Y 2-N)",18,2,0,2,22
1803149,1382875,2024-02-13,House,"House: VOTE: Defeated (43-Y 55-N)",43,55,0,2,100
1803176,1367353,2024-01-22,House,"House: Referred from Communications, Technology and Innovation (12-Y 10-N)",12,10,0,0,22
1803176,1370814,2024-01-29,House,"House: Subcommittee recommends reporting with substitute (7-Y 0-N)",7,0,0,2,9
1803176,1373168,2024-01-31,House,"House: Reported from Appropriations with substitute (22-Y 0-N)",22,0,0,0,22
1803176,1377461,2024-02-06,House,"House: VOTE: Passage (61-Y 38-N)",61,38,0,1,100
1803176,1384320,2024-02-14,Senate,"Senate: Reported from General Laws and Technology (15-Y 0-N)",15,0,0,0,15
1803176,1386591,2024-02-16,Senate,"Senate: Constitutional reading dispensed (38-Y 0-N)",38,0,0,2,40
1803176,1387867,2024-02-19,Senate,"Senate: Passed Senate (39-Y 0-N)",39,0,0,1,40
1803203,1367361,2024-01-22,House,"House: Subcommittee recommends laying on the table (5-Y 3-N)",5,3,0,0,8
1803227,1376810,2024-02-06,House,"House: Subcommittee recommends reporting with substitute (8-Y 0-N)",8,0,0,0,8
1803227,1378482,2024-02-07,House,"House: Reported from Education with substitute (22-Y 0-N)",22,0,0,0,22
1803227,1383223,2024-02-13,House,"House: VOTE: Block Vote Passage (99-Y 0-N)",99,0,0,1,100
1803227,1399167,2024-02-29,Senate,"Senate: Reported from Education and Health with substitute (15-Y 0-N)",15,0,0,0,15
1803227,1400978,2024-03-01,Senate,"Senate: Constitutional reading dispensed (40-Y 0-N)",40,0,0,0,40
1803227,1401682,2024-03-04,Senate,"Senate: Passed Senate with substitute (39-Y 0-N)",39,0,0,1,40
1803227,1402816,2024-03-05,House,"House: VOTE: REJECTED (2-Y 97-N)",2,97,0,1,100
1803227,1404074,2024-03-06,Senate,"Senate: Senate insisted on substitute (40-Y 0-N)",40,0,0,0,40
1803227,1406668,2024-03-09,Senate,"Senate: Conference report agreed to by Senate (40-Y 0-N)",40,0,0,0,40
1803227,1406669,2024-03-09,House,"House: VOTE: Adoption (97-Y 0-N)",97,0,0,3,100
1803252,1375616,2024-02-05,House,"House: Subcommittee recommends laying on the table (7-Y 1-N)",7,1,0,1,9
1803279,1375826,2024-02-05,House,"House: Subcommittee recommends laying on the table (6-Y 4-N)",6,4,0,0,10
1803328,1378978,2024-02-07,House,"House: Reported from Courts of Justice (22-Y 0-N)",22,0,0,0,22
1803328,1382921,2024-02-13,House,"House: VOTE: Block Vote Passage (99-Y 0-N)",99,0,0,1,100
1803328,1391056,2024-02-21,Senate,"Senate: Reported from Courts of Justice (9-Y 0-N)",9,0,0,0,9
1803328,1394093,2024-02-23,Senate,"Senate: Constitutional reading dispensed (38-Y 0-N)",38,0,0,2,40
1803328,1395404,2024-02-26,Senate,"Senate: Passed Senate (40-Y 0-N)",40,0,0,0,40
1803405,1369318,2024-01-25,House,"House: Subcommittee recommends reporting (7-Y 0-N)",7,0,0,1,8
1803405,1372224,2024-01-30,House,"House: Reported from General Laws (22-Y 0-N)",22,0,0,0,22
1803405,1376403,2024-02-05,House,"House: VOTE: Block Vote Passage (98-Y 0-N)",98,0,0,2,100
1803405,1384441,2024-02-14,Senate,"Senate: Reported from General Laws and Technology (15-Y 0-N)",15,0,0,0,15
1803405,1395580,2024-02-27,Senate,"Senate: Passed by indefinitely in Finance and Appropriations (10-Y 5-N)",10,5,0,0,15
1803431,1373362,2024-01-31,House,"House: Subcommittee recommends reporting (7-Y 1-N)",7,1,0,1,9
1803431,1375934,2024-02-02,House,"House: Reported from Courts of Justice (17-Y 4-N)",17,4,0,1,22
1803431,1380299,2024-02-08,House,"House: VOTE: Passage (64-Y 33-N)",64,33,0,3,100
1803431,1398665,2024-02-28,Senate,"Senate: Reported from Courts of Justice (9-Y 6-N)",9,6,0,0,15
1803431,1401260,2024-03-01,Senate,"Senate: Constitutional reading dispensed (40-Y 0-N)",40,0,0,0,40
1803431,1402813,2024-03-05,Senate,"Senate: Passed Senate (21-Y 19-N)",21,19,0,0,40
1803431,1430332,2024-04-17,House,"House: VOTE: Adoption (0-Y 99-N)",0,99,0,1,100
1803455,1369301,2024-01-25,House,"House: Subcommittee recommends laying on the table (5-Y 3-N)",5,3,0,1,9
1803480,1367999,2024-01-23,House,"House: Subcommittee recommends reporting with amendments (7-Y 0-N)",7,0,0,0,7
1803480,1369403,2024-01-25,House,"House: Reported from Labor and Commerce with amendment(s) (21-Y 0-N)",21,0,0,1,22
1803480,1373247,2024-01-31,House,"House: VOTE: Block Vote Passage (100-Y 0-N)",100,0,0,0,100
1803480,1387587,2024-02-19,Senate,"Senate: Reported from Commerce and Labor with substitute (15-Y 0-N)",15,0,0,0,15
1803480,1389931,2024-02-21,Senate,"Senate: Constitutional reading dispensed (40-Y 0-N)",40,0,0,0,40
1803480,1392258,2024-02-22,Senate,"Senate: Passed Senate with substitute (40-Y 0-N)",40,0,0,0,40
1803480,1394536,2024-02-26,House,"House: VOTE: Adoption (96-Y 0-N)",96,0,0,4,100
1803508,1374907,2024-02-02,House,"House: Stricken from docket by Appropriations (22-Y 0-N)",22,0,0,0,22
1803534,1370307,2024-01-29,House,"House: Subcommittee recommends reporting with substitute (6-Y 0-N)",6,0,0,0,6
1803534,1373677,2024-02-01,House,"House: Reported from Rules with substitute (18-Y 0-N)",18,0,0,0,18
1803534,1378342,2024-02-07,House,"House: Subcommittee recommends reporting (8-Y 0-N)",8,0,0,1,9
1803534,1378343,2024-02-07,House,"House: Reported from Appropriations (22-Y 0-N)",22,0,0,0,22
1803534,1381777,2024-02-12,House,"House: VOTE: Block vote adoption (97-Y 0-N)",97,0,0,3,100
1803534,1402232,2024-03-04,Senate,"Senate: Reading waived (40-Y 0-N)",40,0,0,0,40
1803534,1404586,2024-03-06,House,"House: VOTE: Adoption (99-Y 0-N)",99,0,0,1,100
1803557,1373538,2024-02-01,House,"House: Subcommittee recommends reporting with substitute (8-Y 0-N)",8,0,0,0,8
1803557,1374766,2024-02-02,House,"House: Reported from Counties, Cities and Towns with substitute (21-Y 0-N)",21,0,1,0,22
1803557,1379888,2024-02-08,House,"House: VOTE: Passage (86-Y 10-N)",86,10,0,4,100
1803557,1394369,2024-02-26,Senate,"Senate: Reported from Local Government (14-Y 0-N 1-A)",14,0,1,0,15
1803557,1396532,2024-02-27,Senate,"Senate: Constitutional reading dispensed (39-Y 0-N)",39,0,0,1,40
1803557,1397980,2024-02-28,Senate,"Senate: Passed Senate (37-Y 2-N)",37,2,0,1,40
1803610,1374344,2024-02-01,House,"House: Subcommittee recommends reporting with substitute (5-Y 0-N)",5,0,0,3,8
1803610,1377729,2024-02-06,House,"House: Reported from General Laws with substitute (19-Y 1-N)",19,1,0,2,22
1803610,1381043,2024-02-09,House,"House: Subcommittee recommends laying on the table (8-Y 0-N)",8,0,0,1,9
1803636,1368016,2024-01-23,House,"House: Subcommittee recommends reporting (7-Y 0-N)",7,0,0,0,7
1803636,1369355,2024-01-25,House,"House: Reported from Labor and Commerce (21-Y 0-N)",21,0,0,1,22
1803636,1374813,2024-02-02,House,"House: Subcommittee recommends reporting (8-Y 0-N)",8,0,0,1,9
1803636,1375795,2024-02-05,House,"House: Reported from Appropriations (21-Y 0-N)",21,0,0,1,22
1803636,1380539,2024-02-09,House,"House: VOTE: Block Vote Passage (96-Y 0-N)",96,0,0,4,100
1803636,1387590,2024-02-19,Senate,"Senate: Reported from Commerce and Labor (15-Y 0-N)",15,0,0,0,15
1803636,1395932,2024-02-27,Senate,"Senate: Constitutional reading dispensed (39-Y 0-N)",39,0,0,1,40
1803636,1395933,2024-02-27,Senate,"Senate: Reported from Finance and Appropriations (15-Y 0-N)",15,0,0,0,15
1803636,1398361,2024-02-28,Senate,"Senate: Passed Senate (39-Y 0-N)",39,0,0,1,40
1803662,1377741,2024-02-06,House,"House: Subcommittee recommends reporting with substitute (6-Y 0-N)",6,0,0,1,7
1803662,1380122,2024-02-08,House,"House: Reported from Labor and Commerce with substitute (22-Y 0-N)",22,0,0,0,22
1803662,1383113,2024-02-13,House,"House: VOTE: Block Vote Passage (99-Y 0-N)",99,0,0,1,100
1803662,1395218,2024-02-26,Senate,"Senate: Reported from Commerce and Labor with amendment (15-Y 0-N)",15,0,0,0,15
1803662,1398373,2024-02-28,Senate,"Senate: Constitutional reading dispensed (39-Y 0-N)",39,0,0,1,40
1803662,1399126,2024-02-29,Senate,"Senate: Passed Senate with amendment (39-Y 0-N)",39,0,0,1,40
1803662,1401644,2024-03-04,House,"House: VOTE: Adoption (94-Y 4-N)",94,4,0,2,100
1803687,1366512,2024-01-18,House,"House: Reported from Health and Human Services (22-Y 0-N)",22,0,0,0,22
1803687,1369046,2024-01-24,House,"House: VOTE: Block Vote Passage (99-Y 0-N)",99,0,0,1,100
1803687,1391549,2024-02-22,Senate,"Senate: Reported from Education and Health (15-Y 0-N)",15,0,0,0,15
1803687,1393978,2024-02-23,Senate,"Senate: Constitutional reading dispensed (38-Y 0-N)",38,0,0,2,40
1803687,1394732,2024-02-26,Senate,"Senate: Passed Senate (39-Y 0-N)",39,0,0,1,40
1803687,1394733,2024-02-26,Senate,"Senate: Reconsideration of Senate passage agreed to by Senate (40-Y 0-N)",40,0,0,0,40
1803687,1394734,2024-02-26,Senate,"Senate: Passed Senate (40-Y 0-N)",40,0,0,0,40
1803714,1369972,2024-01-26,House,"House: Subcommittee recommends laying on the table (5-Y 3-N)",5,3,0,1,9
1803740,1370666,2024-01-29,House,"House: Subcommittee recommends reporting (11-Y 0-N)",11,0,0,0,11
1803740,1372463,2024-01-31,House,"House: Reported from Education (22-Y 0-N)",22,0,0,0,22
1803740,1375654,2024-02-05,House,"House: Subcommittee recommends reporting (8-Y 0-N)",8,0,0,1,9
1803740,1375655,2024-02-05,House,"House: Reported from Appropriations (20-Y 0-N)",20,0,0,2,22
1803740,1380600,2024-02-09,House,"House: VOTE: Block Vote Passage (96-Y 0-N)",96,0,0,4,100
1803740,1392445,2024-02-22,Senate,"Senate: Reported from Education and Health (14-Y 0-N 1-A)",14,0,1,0,15
1803740,1401417,2024-03-04,Senate,"Senate: Continued to 2025 in Finance and Appropriations (12-Y 3-N)",12,3,0,0,15
1803763,1367996,2024-01-23,House,"House: Subcommittee recommends reporting (7-Y 0-N)",7,0,0,0,7
1803763,1369411,2024-01-25,House,"House: Tabled in Labor and Commerce (18-Y 3-N)",18,3,0,1,22
1803788,1375015,2024-02-02,House,"House: Subcommittee recommends reporting with substitute (6-Y 0-N)",6,0,0,0,6
1803788,1377670,2024-02-06,House,"House: Reported from General Laws with substitute (16-Y 4-N)",16,4,0,2,22
1803788,1382283,2024-02-12,House,"House: VOTE: Passage (68-Y 30-N)",68,30,0,2,100
1803788,1382284,2024-02-12,House,"House: VOTE: Passage #2 (65-Y 34-N)",65,34,0,1,100
1803788,1390584,2024-02-21,Senate,"Senate: Reported from General Laws and Technology with substitute (10-Y 5-N)",10,5,0,0,15
1803788,1395828,2024-02-27,Senate,"Senate: Constitutional reading dispensed (39-Y 0-N)",39,0,0,1,40
1803788,1395829,2024-02-27,Senate,"Senate: Reported from Finance and Appropriations (13-Y 2-N)",13,2,0,0,15
1803788,1398234,2024-02-28,Senate,"Senate: Passed Senate with substitute (32-Y 7-N)",32,7,0,1,40
1803788,1398235,2024-02-28,House,"House: VOTE: REJECTED (0-Y 96-N)",0,96,0,4,100
1803788,1398236,2024-02-28,Senate,"Senate: Senate insisted on substitute (39-Y 0-N)",39,0,0,1,40
1803815,1373722,2024-02-01,House,"House: Reported from Rules (17-Y 0-N)",17,0,0,1,18
1803815,1377625,2024-02-06,House,"House: VOTE: Block Vote Adoption (98-Y 0-N)",98,0,0,2,100
1803815,1394409,2024-02-26,Senate,"Senate: Reading waived (40-Y 0-N)",40,0,0,0,40
1803840,1373550,2024-02-01,House,"House: Subcommittee recommends reporting with substitute (8-Y 0-N)",8,0,0,0,8
1803840,1377258,2024-02-06,House,"House: Reported from Health and Human Services with substitute (22-Y 0-N)",22,0,0,0,22
1803840,1379416,2024-02-08,House,"House: Reported from Health and Human Services with substitute (22-Y 0-N)",22,0,0,0,22
1803840,1380550,2024-02-09,House,"House: Subcommittee recommends laying on the table (7-Y 0-N)",7,0,0,2,9
1803866,1367856,2024-01-23,House,"House: Subcommittee recommends reporting with amendments (8-Y 0-N)",8,0,0,1,9
1803866,1370252,2024-01-29,House,"House: Reported from Education with substitute (14-Y 8-N)",14,8,0,0,22
1803866,1374802,2024-02-02,House,"House: VOTE: Passage (59-Y 41-N)",59,41,0,0,100
1803866,1391503,2024-02-22,Senate,"Senate: Reported from Education and Health (11-Y 4-N)",11,4,0,0,15
1803866,1393794,2024-02-23,Senate,"Senate: Constitutional reading dispensed (38-Y 0-N)",38,0,0,2,40
1803866,1394452,2024-02-26,Senate,"Senate: Passed Senate (23-Y 17-N)",23,17,0,0,40
1803866,1429498,2024-04-17,Senate,"Senate: Senate concurred in Governor's recommendation (40-Y 0-N)",40,0,0,0,40
1803866,1430298,2024-04-17,House,"House: VOTE: Adoption (55-Y 42-N)",55,42,0,3,100
1803890,1373949,2024-02-01,House,"House: Subcommittee recommends reporting with substitute (8-Y 0-N)",8,0,0,1,9
1803890,1377327,2024-02-06,House,"House: Reported from Health and Human Services with substitute (22-Y 0-N)",22,0,0,0,22
1803890,1378624,2024-02-07,House,"House: Subcommittee recommends laying on the table (7-Y 0-N)",7,0,0,2,9
1803914,1369812,2024-01-26,House,"House: Subcommittee recommends reporting (5-Y 3-N)",5,3,0,0,8
1803914,1369813,2024-01-26,House,"House: Reported from Counties, Cities and Towns (11-Y 9-N)",11,9,0,2,22
1803960,1368116,2024-01-23,House,"House: Subcommittee recommends reporting (6-Y 2-N)",6,2,0,1,9
1803960,1369393,2024-01-25,House,"House: Reported from General Laws (20-Y 2-N)",20,2,0,0,22
1803960,1373161,2024-01-31,House,"House: VOTE: Passage (81-Y 18-N)",81,18,0,1,100
1803960,1386676,2024-02-16,Senate,"Senate: Reported from Rehabilitation and Social Services (12-Y 0-N)",12,0,0,0,12
1803960,1387396,2024-02-19,Senate,"Senate: Constitutional reading dispensed (38-Y 0-N)",38,0,0,2,40
1803960,1388658,2024-02-20,Senate,"Senate: Passed Senate (40-Y 0-N)",40,0,0,0,40
1803976,1377343,2024-02-06,Senate,"Senate: Reported from Agriculture, Conservation and Natural Resources with substitite (15-Y 0-N)",15,0,0,0,15
1803976,1381286,2024-02-12,Senate,"Senate: Reported from Finance and Appropriations (15-Y 0-N)",15,0,0,0,15
1803976,1381541,2024-02-12,Senate,"Senate: Constitutional reading dispensed (40-Y 0-N)",40,0,0,0,40
1803976,1383790,2024-02-13,Senate,"Senate: Constitutional reading dispensed (39-Y 0-N)",39,0,0,1,40
1803976,1383791,2024-02-13,Senate,"Senate: Passed Senate (40-Y 0-N)",40,0,0,0,40
1803976,1387981,2024-02-19,House,"House: Subcommittee recommends reporting (10-Y 0-N)",10,0,0,0,10
1803976,1390024,2024-02-21,House,"House: Reported from Agriculture, Chesapeake and Natural Resources (22-Y 0-N)",22,0,0,0,22
1803976,1394602,2024-02-26,House,"House: VOTE: Block Vote Passage (96-Y 0-N)",96,0,0,4,100
1803985,1367968,2024-01-23,Senate,"Senate: Failed to report (defeated) in Agriculture, Conservation and Natural Resources (6-Y 9-N)",6,9,0,0,15
1803986,1373678,2024-02-01,Senate,"Senate: Reported from Education and Health with substitute (15-Y 0-N)",15,0,0,0,15
1803986,1377026,2024-02-06,Senate,"Senate: Read third time and passed Senate (39-Y 0-N)",39,0,0,1,40
1803986,1432206,2024-02-21,House,"House: Subcommittee recommends laying on the table (6-Y 4-N)",6,4,0,0,10
1803988,1368068,2024-01-23,Senate,"Senate: Failed to report (defeated) in Agriculture, Conservation and Natural Resources (6-Y 9-N)",6,9,0,0,15
1803991,1376448,2024-02-05,Senate,"Senate: Continued to 2025 in Commerce and Labor (15-Y 0-N)",15,0,0,0,15
1803994,1378899,2024-02-07,Senate,"Senate: Continued to 2025 in General Laws and Technology (13-Y 2-N)",13,2,0,0,15
1803998,1378452,2024-02-07,Senate,"Senate: Passed by indefinitely in Courts of Justice (9-Y 6-N)",9,6,0,0,15
1804000,1368997,2024-01-25,Senate,"Senate: Reported from Education and Health (14-Y 1-N)",14,1,0,0,15
1804000,1372850,2024-01-31,Senate,"Senate: Reported from Finance and Appropriations with substitute (15-Y 0-N)",15,0,0,0,15
1804000,1374002,2024-02-01,Senate,"Senate: Constitutional reading dispensed (40-Y 0-N)",40,0,0,0,40
1804000,1376173,2024-02-05,Senate,"Senate: Read third time and passed Senate (35-Y 5-N)",35,5,0,0,40
1804004,1378803,2024-02-07,Senate,"Senate: Reported from General Laws and Technology with substitute (15-Y 0-N)",15,0,0,0,15
1804004,1381317,2024-02-12,Senate,"Senate: Reported from Finance and Appropriations (14-Y 0-N)",14,0,0,0,14
1804004,1381880,2024-02-12,Senate,"Senate: Constitutional reading dispensed (40-Y 0-N)",40,0,0,0,40
1804004,1383254,2024-02-13,Senate,"Senate: Constitutional reading dispensed (39-Y 0-N)",39,0,0,1,40
1804004,1383255,2024-02-13,Senate,"Senate: Passed Senate (40-Y 0-N)",40,0,0,0,40
1804004,1387318,2024-02-19,House,"House: Subcommittee recommends reporting (10-Y 0-N)",10,0,0,0,10
1804004,1387319,2024-02-19,House,"House: Reported from Communications, Technology and Innovation (22-Y 0-N)",22,0,0,0,22
1804004,1390710,2024-02-21,House,"House: Reported from Appropriations (22-Y 0-N)",22,0,0,0,22
1804004,1394361,2024-02-26,House,"House: VOTE: Block Vote Passage (96-Y 0-N)",96,0,0,4,100
1804006,1367293,2024-01-22,Senate,"Senate: Reported from Commerce and Labor (14-Y 0-N)",14,0,0,0,14
1804006,1368618,2024-01-24,Senate,"Senate: Constitutional reading dispensed (40-Y 0-N)",40,0,0,0,40
1804006,1369793,2024-01-26,Senate,"Senate: Read third time and passed Senate (38-Y 0-N)",38,0,0,2,40
1804006,1389268,2024-02-20,House,"House: Reported from Labor and Commerce (22-Y 0-N)",22,0,0,0,22
1804006,1393370,2024-02-23,House,"House: VOTE: Block Vote Passage (98-Y 0-N)",98,0,0,2,100
1804011,1369000,2024-01-25,Senate,"Senate: Reported from Education and Health (10-Y 5-N)",10,5,0,0,15
1804011,1369863,2024-01-26,Senate,"Senate: Constitutional reading dispensed (37-Y 0-N)",37,0,0,3,40
1804011,1371788,2024-01-30,Senate,"Senate: Read third time and passed Senate (22-Y 18-N)",22,18,0,0,40
1804011,1384131,2024-02-14,House,"House: Reported from Education (12-Y 9-N)",12,9,0,1,22
1804011,1387649,2024-02-19,House,"House: VOTE: Passage (53-Y 46-N)",53,46,0,1,100
1804011,1430118,2024-04-17,Senate,"Senate: Passed in enrolled form rejected (22-Y 18-N)",22,18,0,0,40
1804015,1367031,2024-01-18,Senate,"Senate: Reported from Transportation (14-Y 0-N)",14,0,0,0,14
1804015,1367619,2024-01-23,Senate,"Senate: Reported from Finance and Appropriations (13-Y 0-N)",13,0,0,0,13
1804015,1368850,2024-01-24,Senate,"Senate: Constitutional reading dispensed (40-Y 0-N)",40,0,0,0,40
1804015,1369722,2024-01-26,Senate,"Senate: Read third time and passed Senate (38-Y 0-N)",38,0,0,2,40
1804015,1391511,2024-02-22,House,"House: Reported from Transportation (22-Y 0-N)",22,0,0,0,22
1804015,1397055,2024-02-27,House,"House: VOTE: Block Vote Passage (97-Y 0-N)",97,0,0,3,100
1804018,1368982,2024-01-25,Senate,"Senate: Passed by indefinitely in Education and Health (15-Y 0-N)",15,0,0,0,15
1804020,1381279,2024-02-12,Senate,"Senate: Continued to 2025 in Finance and Appropriations (15-Y 0-N)",15,0,0,0,15
1804027,1377192,2024-02-06,Senate,"Senate: Reported from Privileges and Elections with substitute (8-Y 6-N)",8,6,0,0,14
1804027,1379728,2024-02-08,Senate,"Senate: Reported from Finance and Appropriations (10-Y 5-N)",10,5,0,0,15
1804027,1380799,2024-02-09,Senate,"Senate: Constitutional reading dispensed (39-Y 0-N)",39,0,0,1,40
1804027,1383626,2024-02-13,Senate,"Senate: Read third time and passed Senate (21-Y 19-N)",21,19,0,0,40
1804027,1400336,2024-03-01,House,"House: Reported from Privileges and Elections with substitute (13-Y 8-N)",13,8,0,1,22
1804027,1404120,2024-03-06,House,"House: VOTE: Passage (54-Y 45-N)",54,45,0,1,100
1804027,1405555,2024-03-07,Senate,"Senate: House substitute agreed to by Senate (21-Y 19-N)",21,19,0,0,40
1804027,1429511,2024-04-17,Senate,"Senate: Senate rejected Governor's recommendation (19-Y 21-N)",19,21,0,0,40
1804030,1368738,2024-01-24,Senate,"Senate: Continued to 2025 in General Laws and Technology (15-Y 0-N)",15,0,0,0,15
1804035,1374749,2024-02-01,Senate,"Senate: Reported from Transportation with amendments (15-Y 0-N)",15,0,0,0,15
1804035,1375776,2024-02-05,Senate,"Senate: Constitutional reading dispensed (39-Y 0-N)",39,0,0,1,40
1804035,1377717,2024-02-06,Senate,"Senate: Constitutional reading dispensed (39-Y 0-N)",39,0,0,1,40
1804035,1377718,2024-02-06,Senate,"Senate: Passed Senate (39-Y 0-N)",39,0,0,1,40
1804035,1388322,2024-02-20,House,"House: Subcommittee recommends reporting (8-Y 0-N)",8,0,0,0,8
1804035,1391336,2024-02-22,House,"House: Reported from Transportation (22-Y 0-N)",22,0,0,0,22
1804035,1395810,2024-02-27,House,"House: VOTE: Block Vote Passage (97-Y 0-N)",97,0,0,3,100
1804038,1380982,2024-02-09,Senate,"Senate: Reported from Commerce and Labor with substitute (12-Y 3-N)",12,3,0,0,15
1804038,1380983,2024-02-09,Senate,"Senate: Constitutional reading dispensed (39-Y 0-N)",39,0,0,1,40
1804038,1383068,2024-02-13,Senate,"Senate: Read third time and passed Senate (25-Y 15-N)",25,15,0,0,40
1804038,1388053,2024-02-19,House,"House: Subcommittee recommends reporting with amendments (8-Y 0-N)",8,0,0,1,9
1804038,1393635,2024-02-23,House,"House: Reported from Courts of Justice with substitute (17-Y 2-N)",17,2,1,2,22
1804038,1397909,2024-02-28,House,"House: VOTE: Passage (65-Y 33-N 1-A)",65,33,1,1,100
1804038,1400729,2024-03-01,Senate,"Senate: House substitute rejected by Senate (0-Y 40-N)",0,40,0,0,40
1804038,1403231,2024-03-05,Senate,"Senate: Senate acceded to request (40-Y 0-N)",40,0,0,0,40
1804038,1405269,2024-03-07,House,"House: VOTE: Adoption (65-Y 32-N 1-A)",65,32,1,2,100
1804038,1406122,2024-03-08,Senate,"Senate: Conference report agreed to by Senate (30-Y 9-N 1-A)",30,9,1,0,40
1804038,1430222,2024-04-17,Senate,"Senate: Senate concurred in Governor's recommendation (40-Y 0-N)",40,0,0,0,40
1804038,1430223,2024-04-17,House,"House: VOTE: Adoption (89-Y 10-N 1-A)",89,10,1,0,100
1804041,1366432,2024-01-17,Senate,"Senate: Reported from General Laws and Technology with amendment (15-Y 0-N)",15,0,0,0,15
1804041,1378498,2024-02-07,Senate,"Senate: Reported from Finance and Appropriations (15-Y 0-N)",15,0,0,0,15
1804041,1379951,2024-02-08,Senate,"Senate: Constitutional reading dispensed (40-Y 0-N)",40,0,0,0,40
1804041,1380961,2024-02-09,Senate,"Senate: Constitutional reading dispensed (40-Y 0-N)",40,0,0,0,40
1804041,1380962,2024-02-09,Senate,"Senate: Passed Senate (40-Y 0-N)",40,0,0,0,40
1804041,1389550,2024-02-20,House,"House: Reported from General Laws with substitute (21-Y 0-N)",21,0,0,1,22
1804041,1393781,2024-02-23,House,"House: VOTE: Block Vote Passage (98-Y 0-N)",98,0,0,2,100
1804041,1396498,2024-02-27,Senate,"Senate: House substitute agreed to by Senate (38-Y 0-N)",38,0,0,2,40
1804044,1374720,2024-02-01,Senate,"Senate: Reported from Transportation with substitute (8-Y 7-N)",8,7,0,0,15
1804044,1375821,2024-02-05,Senate,"Senate: Constitutional reading dispensed (39-Y 0-N)",39,0,0,1,40
1804044,1378381,2024-02-07,Senate,"Senate: Read third time and passed Senate (21-Y 19-N)",21,19,0,0,40
1804044,1392066,2024-02-22,House,"House: Reported from Transportation (13-Y 9-N)",13,9,0,0,22
1804044,1396991,2024-02-27,House,"House: VOTE: Passage (53-Y 44-N)",53,44,0,3,100
1804048,1379135,2024-02-08,Senate,"Senate: Reported from Education and Health with substitute (15-Y 0-N)",15,0,0,0,15
1804048,1381667,2024-02-12,Senate,"Senate: Reported from Finance and Appropriations with substitute (15-Y 0-N)",15,0,0,0,15
1804048,1381668,2024-02-12,Senate,"Senate: Constitutional reading dispensed (40-Y 0-N)",40,0,0,0,40
1804048,1383050,2024-02-13,Senate,"Senate: Constitutional reading dispensed (39-Y 0-N)",39,0,0,1,40
1804048,1383051,2024-02-13,Senate,"Senate: Passed Senate (40-Y 0-N)",40,0,0,0,40
1804048,1388292,2024-02-20,House,"House: Subcommittee recommends reporting with substitute (8-Y 0-N)",8,0,0,0,8
1804048,1389782,2024-02-21,House,"House: Reported from Education with substitute (22-Y 0-N)",22,0,0,0,22
1804048,1398517,2024-02-28,House,"House: VOTE: Passage (100-Y 0-N)",100,0,0,0,100
1804048,1400631,2024-03-01,Senate,"Senate: House substitute agreed to by Senate (40-Y 0-N)",40,0,0,0,40
1804050,1379771,2024-02-08,Senate,"Senate: Reported from Education and Health with substitute (9-Y 6-N)",9,6,0,0,15
1804050,1379772,2024-02-08,Senate,"Senate: Constitutional reading dispensed (40-Y 0-N)",40,0,0,0,40
1804050,1381502,2024-02-12,Senate,"Senate: Read third time and passed Senate (21-Y 19-N)",21,19,0,0,40
1804050,1388369,2024-02-20,House,"House: Subcommittee recommends reporting (6-Y 2-N)",6,2,0,0,8
1804050,1391498,2024-02-22,House,"House: Reported from Health and Human Services (13-Y 8-N)",13,8,0,1,22
1804050,1395764,2024-02-27,House,"House: VOTE: Passage (53-Y 43-N)",53,43,0,4,100
1804053,1377108,2024-02-06,Senate,"Senate: Reported from Finance and Appropriations with substitute (15-Y 0-N)",15,0,0,0,15
1804053,1378690,2024-02-07,Senate,"Senate: Constitutional reading dispensed (40-Y 0-N)",40,0,0,0,40
1804053,1379858,2024-02-08,Senate,"Senate: Constitutional reading dispensed (40-Y 0-N)",40,0,0,0,40
1804053,1379859,2024-02-08,Senate,"Senate: Read third time and passed Senate (40-Y 0-N)",40,0,0,0,40
1804055,1374683,2024-02-02,Senate,"Senate: Reported from Rules (14-Y 0-N)",14,0,0,0,14
1804055,1379891,2024-02-08,Senate,"Senate: Reported from Finance and Appropriations with substitute (15-Y 0-N)",15,0,0,0,15
1804055,1380740,2024-02-09,Senate,"Senate: Constitutional reading dispensed (39-Y 0-N)",39,0,0,1,40
1804055,1382035,2024-02-12,Senate,"Senate: Constitutional reading dispensed (40-Y 0-N)",40,0,0,0,40
1804055,1382036,2024-02-12,Senate,"Senate: Passed Senate (40-Y 0-N)",40,0,0,0,40
1804055,1393147,2024-02-23,House,"House: Subcommittee recommends reporting (6-Y 0-N)",6,0,0,0,6
1804055,1393234,2024-02-23,House,"House: Reported from Rules (16-Y 0-N)",16,0,0,2,18
1804055,1398451,2024-02-28,House,"House: Tabled in Appropriations (22-Y 0-N)",22,0,0,0,22
1804061,1371033,2024-01-29,Senate,"Senate: Reported from Commerce and Labor with substitute (13-Y 1-N 1-A)",13,1,1,0,15
1804061,1372471,2024-01-31,Senate,"Senate: Constitutional reading dispensed (40-Y 0-N)",40,0,0,0,40
1804061,1376375,2024-02-05,Senate,"Senate: Read third time and passed Senate (30-Y 10-N)",30,10,0,0,40
1804061,1393192,2024-02-23,House,"House: Subcommittee recommends reporting (4-Y 2-N)",4,2,0,0,6
1804061,1393193,2024-02-23,House,"House: Reported from Rules (13-Y 4-N)",13,4,0,1,18
1804061,1397584,2024-02-28,House,"House: Reported from Appropriations with amendment(s) (12-Y 10-N)",12,10,0,0,22
1804061,1401795,2024-03-04,House,"House: VOTE: Passage (52-Y 46-N)",52,46,0,2,100
1804061,1402847,2024-03-05,Senate,"Senate: House amendments agreed to by Senate (22-Y 17-N)",22,17,0,1,40
1804063,1377263,2024-02-06,Senate,"Senate: Passed by indefinitely in Finance and Appropriations (10-Y 5-N)",10,5,0,0,15
1804064,1364317,2024-01-15,Senate,"Senate: Passed by indefinitley in Courts of Justice (8-Y 7-N)",8,7,0,0,15
1804070,1376898,2024-02-06,Senate,"Senate: Continued to 2025 in Finance and Appropriations (14-Y 1-N)",14,1,0,0,15
1804073,1366873,2024-01-19,Senate,"Senate: Passed by indefinitely in Rehabilitation and Social Services (8-Y 7-N)",8,7,0,0,15
1804076,1371953,2024-01-30,Senate,"Senate: Reported from Finance and Appropriations (15-Y 0-N)",15,0,0,0,15
1804076,1373178,2024-01-31,Senate,"Senate: Constitutional reading dispensed (40-Y 0-N)",40,0,0,0,40
1804076,1432101,2024-02-26,House,"House: Reported from Appropriations (22-Y 0-N)",22,0,0,0,22
1804076,1432102,2024-02-29,House,"House: VOTE: Block Vote Passage (99-Y 0-N)",99,0,0,1,100
1804081,1367195,2024-01-22,Senate,"Senate: Reported from Courts of Justice with substitute (9-Y 6-N)",9,6,0,0,15
1804081,1372804,2024-01-31,Senate,"Senate: Reported from Finance and Appropriations (10-Y 5-N)",10,5,0,0,15
1804081,1374193,2024-02-01,Senate,"Senate: Constitutional reading dispensed (40-Y 0-N)",40,0,0,0,40
1804081,1376374,2024-02-05,Senate,"Senate: Read third time and passed Senate (21-Y 19-N)",21,19,0,0,40
1804081,1386807,2024-02-16,House,"House: Reported from Public Safety (12-Y 10-N)",12,10,0,0,22
1804081,1389940,2024-02-21,House,"House: VOTE: Passage (51-Y 49-N)",51,49,0,0,100
1804081,1429881,2024-04-17,Senate,"Senate: Passed in enrolled form rejected (21-Y 19-N)",21,19,0,0,40
1804083,1374662,2024-02-02,Senate,"Senate: Reported from Rules (14-Y 0-N)",14,0,0,0,14
1804083,1376498,2024-02-05,Senate,"Senate: Constitutional reading dispensed (39-Y 0-N)",39,0,0,1,40
1804083,1377705,2024-02-06,Senate,"Senate: Constitutional reading dispensed (39-Y 0-N)",39,0,0,1,40
1804083,1377706,2024-02-06,Senate,"Senate: Passed Senate (39-Y 0-N)",39,0,0,1,40
1804083,1393260,2024-02-23,House,"House: Subcommittee recommends reporting (6-Y 0-N)",6,0,0,0,6
1804083,1393261,2024-02-23,House,"House: Reported from Rules (16-Y 0-N)",16,0,0,2,18
1804087,1375575,2024-02-05,Senate,"Senate: Reported from Courts of Justice (15-Y 0-N)",15,0,0,0,15
1804087,1377673,2024-02-06,Senate,"Senate: Constitutional reading dispensed (39-Y 0-N)",39,0,0,1,40
1804087,1378808,2024-02-07,Senate,"Senate: Constitutional reading dispensed (40-Y 0-N)",40,0,0,0,40
1804087,1378809,2024-02-07,Senate,"Senate: Passed Senate (40-Y 0-N)",40,0,0,0,40
1804087,1386815,2024-02-16,House,"House: Reported from Courts of Justice (22-Y 0-N)",22,0,0,0,22
1804087,1391109,2024-02-21,House,"House: VOTE: Block Vote Passage (100-Y 0-N)",100,0,0,0,100
1804091,1364525,2024-01-16,Senate,"Senate: Rereferred from Privileges and Elections (14-Y 0-N)",14,0,0,0,14
1804091,1368979,2024-01-25,Senate,"Senate: Reported from Education and Health (15-Y 0-N)",15,0,0,0,15
1804091,1372437,2024-01-31,Senate,"Senate: Reported from Finance and Appropriations (11-Y 4-N)",11,4,0,0,15
1804091,1374174,2024-02-01,Senate,"Senate: Constitutional reading dispensed (40-Y 0-N)",40,0,0,0,40
1804091,1376324,2024-02-05,Senate,"Senate: Read third time and passed Senate (28-Y 12-N)",28,12,0,0,40
1804091,1385434,2024-02-15,House,"House: Reported from General Laws with amendment(s) (21-Y 1-N)",21,1,0,0,22
1804091,1388954,2024-02-20,House,"House: VOTE: Passage (91-Y 6-N)",91,6,0,3,100
1804091,1391895,2024-02-22,Senate,"Senate: House amendment agreed to by Senate (26-Y 13-N)",26,13,0,1,40
1804095,1367286,2024-01-22,Senate,"Senate: Reported from Commerce and Labor (8-Y 6-N)",8,6,0,0,14
1804095,1372740,2024-01-31,Senate,"Senate: Reported from Finance and Appropriations with substitute (10-Y 5-N)",10,5,0,0,15
1804095,1374181,2024-02-01,Senate,"Senate: Constitutional reading dispensed (40-Y 0-N)",40,0,0,0,40
1804095,1375855,2024-02-05,Senate,"Senate: Engrossment reconsidered by Senate (39-Y 0-N)",39,0,0,1,40
1804095,1376965,2024-02-06,Senate,"Senate: Read third time and passed Senate (24-Y 15-N)",24,15,0,1,40
1804095,1389143,2024-02-20,House,"House: Reported from Labor and Commerce (14-Y 7-N)",14,7,0,1,22
1804095,1393652,2024-02-23,House,"House: VOTE: Passage (69-Y 29-N)",69,29,0,2,100
1804095,1430203,2024-04-17,Senate,"Senate: Senate rejected Governor's recommendation (19-Y 21-N)",19,21,0,0,40
1804097,1380753,2024-02-09,Senate,"Senate: Reported from Commerce and Labor with substitute (10-Y 5-N)",10,5,0,0,15
1804097,1380754,2024-02-09,Senate,"Senate: Constitutional reading dispensed (39-Y 0-N)",39,0,0,1,40
1804097,1383610,2024-02-13,Senate,"Senate: Read third time and passed Senate (21-Y 16-N)",21,16,0,3,40
1804097,1389313,2024-02-20,House,"House: Reported from Labor and Commerce with substitute (14-Y 8-N)",14,8,0,0,22
1804097,1393972,2024-02-23,House,"House: VOTE: Passage (52-Y 46-N)",52,46,0,2,100
1804097,1396122,2024-02-27,Senate,"Senate: House amendment agreed to by Senate (21-Y 18-N)",21,18,0,1,40
1804100,1368222,2024-01-24,Senate,"Senate: Passed by indefinitely in Finance and Appropriations (9-Y 5-N)",9,5,0,0,14
1804103,1366477,2024-01-18,Senate,"Senate: Reported from Education and Health with amendment (15-Y 0-N)",15,0,0,0,15
1804103,1368190,2024-01-24,Senate,"Senate: Reported from Finance and Appropriations (14-Y 0-N)",14,0,0,0,14
1804103,1369339,2024-01-25,Senate,"Senate: Constitutional reading dispensed (40-Y 0-N)",40,0,0,0,40
1804103,1370387,2024-01-29,Senate,"Senate: Read third time and passed Senate (40-Y 0-N)",40,0,0,0,40
1804103,1385465,2024-02-15,House,"House: Subcommittee recommends reporting (7-Y 0-N)",7,0,0,1,8
1804103,1388476,2024-02-20,House,"House: Reported from Health and Human Services (22-Y 0-N)",22,0,0,0,22
1804103,1394018,2024-02-23,House,"House: VOTE: Block Vote Passage (98-Y 0-N)",98,0,0,2,100
1804107,1378601,2024-02-07,Senate,"Senate: Reported from General Laws and Technology with substitute (15-Y 0-N)",15,0,0,0,15
1804107,1381349,2024-02-12,Senate,"Senate: Reported from Finance and Appropriations with substitute (14-Y 0-N)",14,0,0,0,14
1804107,1381977,2024-02-12,Senate,"Senate: Constitutional reading dispensed (40-Y 0-N)",40,0,0,0,40
1804107,1383475,2024-02-13,Senate,"Senate: Constitutional reading dispensed (39-Y 0-N)",39,0,0,1,40
1804107,1383476,2024-02-13,Senate,"Senate: Passed Senate (40-Y 0-N)",40,0,0,0,40
1804107,1388518,2024-02-20,House,"House: Subcommittee recommends reporting with substitute (8-Y 0-N)",8,0,0,0,8
1804107,1392835,2024-02-22,House,"House: Reported from General Laws with substitute (22-Y 0-N)",22,0,0,0,22
1804107,1396404,2024-02-27,House,"House: VOTE: Block Vote Passage (97-Y 0-N)",97,0,0,3,100
1804107,1399563,2024-02-29,Senate,"Senate: House substitute rejected by Senate (0-Y 39-N)",0,39,0,1,40
1804107,1403283,2024-03-05,Senate,"Senate: Senate receded from its objection to House substitute (40-Y 0-N)",40,0,0,0,40
1804107,1429811,2024-04-17,Senate,"Senate: Senate concurred in Governor's recommendation (39-Y 1-N)",39,1,0,0,40
1804107,1429812,2024-04-17,House,"House: VOTE: (97-Y 0-N)",97,0,0,3,100
1804109,1366482,2024-01-18,Senate,"Senate: Rereferred from Education and Health (15-Y 0-N)",15,0,0,0,15
1804109,1376476,2024-02-05,Senate,"Senate: Reported from Commerce and Labor with substitute (10-Y 5-N)",10,5,0,0,15
1804109,1379703,2024-02-08,Senate,"Senate: Reported from Finance and Appropriations (9-Y 6-N)",9,6,0,0,15
1804109,1380594,2024-02-09,Senate,"Senate: Constitutional reading dispensed (39-Y 0-N)",39,0,0,1,40
1804109,1383019,2024-02-13,Senate,"Senate: Read third time and passed Senate (23-Y 16-N)",23,16,0,1,40
1804109,1388769,2024-02-20,House,"House: Reported from Labor and Commerce (12-Y 10-N)",12,10,0,0,22
1804109,1393499,2024-02-23,House,"House: VOTE: Passage (50-Y 47-N)",50,47,0,3,100
1804109,1430281,2024-04-17,Senate,"Senate: Passed in enrolled form rejected (21-Y 18-N)",21,18,0,1,40
1804115,1371026,2024-01-29,Senate,"Senate: Reported from Commerce and Labor with substitute (15-Y 0-N)",15,0,0,0,15
1804115,1376918,2024-02-06,Senate,"Senate: Reported from Finance and Appropriations (15-Y 0-N)",15,0,0,0,15
1804115,1378424,2024-02-07,Senate,"Senate: Constitutional reading dispensed (40-Y 0-N)",40,0,0,0,40
1804115,1380018,2024-02-08,Senate,"Senate: Constitutional reading dispensed (40-Y 0-N)",40,0,0,0,40
1804115,1380019,2024-02-08,Senate,"Senate: Read third time and passed Senate (40-Y 0-N)",40,0,0,0,40
1804115,1389708,2024-02-21,House,"House: Subcommittee recommends reporting with substitute (6-Y 4-N)",6,4,0,0,10
1804115,1389993,2024-02-21,House,"House: Reported from Agriculture, Chesapeake and Natural Resources with substitute (13-Y 9-N)",13,9,0,0,22
1804115,1394449,2024-02-26,House,"House: VOTE: Passage (50-Y 46-N)",50,46,0,4,100
1804115,1398136,2024-02-28,Senate,"Senate: House substitute rejected by Senate (0-Y 39-N)",0,39,0,1,40
1804115,1402237,2024-03-04,Senate,"Senate: Senate acceded to request (38-Y 0-N)",38,0,0,2,40
1804115,1405435,2024-03-07,House,"House: VOTE: Adoption (51-Y 48-N)",51,48,0,1,100
1804115,1406197,2024-03-08,Senate,"Senate: Conference report agreed to by Senate (39-Y 1-N)",39,1,0,0,40
1804115,1429596,2024-04-17,Senate,"Senate: Senate rejected Governor's recommendation (18-Y 22-N)",18,22,0,0,40
1804117,1371755,2024-01-30,Senate,"Senate: Reported from Agriculture, Conservation and Natural Resources (15-Y 0-N)",15,0,0,0,15
1804117,1378546,2024-02-07,Senate,"Senate: Reported from Finance and Appropriations (15-Y 0-N)",15,0,0,0,15
1804117,1379679,2024-02-08,Senate,"Senate: Constitutional reading dispensed (40-Y 0-N)",40,0,0,0,40
1804117,1380861,2024-02-09,Senate,"Senate: Constitutional reading dispensed (40-Y 0-N)",40,0,0,0,40
1804117,1380862,2024-02-09,Senate,"Senate: Passed Senate (40-Y 0-N)",40,0,0,0,40
1804117,1387988,2024-02-19,House,"House: Reported from Finance (22-Y 0-N)",22,0,0,0,22
1804117,1392306,2024-02-22,House,"House: VOTE: Block Vote Passage (99-Y 0-N)",99,0,0,1,100
1804121,1367792,2024-01-23,Senate,"Senate: Passed by indefinitely in Privileges and Elections (8-Y 6-N)",8,6,0,0,14
1804126,1373627,2024-02-01,Senate,"Senate: Reported from Education and Health with substitute (15-Y 0-N)",15,0,0,0,15
1804126,1379783,2024-02-08,Senate,"Senate: Incorporated by Finance and Appropriations ",15,0,0,0,15
1804130,1370653,2024-01-29,Senate,"Senate: Failed to report (defeated) in Local Government (7-Y 8-N)",7,8,0,0,15
1804132,1373106,2024-01-31,Senate,"Senate: Continued to 2025 in General Laws and Technology (15-Y 0-N)",15,0,0,0,15
1804135,1368873,2024-01-24,Senate,"Senate: Reported from General Laws and Technology with amendment (15-Y 0-N)",15,0,0,0,15
1804135,1369721,2024-01-26,Senate,"Senate: Constitutional reading dispensed (37-Y 0-N)",37,0,0,3,40
1804135,1371995,2024-01-30,Senate,"Senate: Read third time and passed Senate (40-Y 0-N)",40,0,0,0,40
1804135,1393035,2024-02-22,House,"House: Subcommittee recommends reporting (8-Y 0-N)",8,0,0,0,8
1804135,1397138,2024-02-27,House,"House: Reported from General Laws (20-Y 2-N)",20,2,0,0,22
1804135,1400656,2024-03-01,House,"House: VOTE: Passage (65-Y 31-N)",65,31,0,4,100
1804140,1369003,2024-01-25,Senate,"Senate: Reported from Education and Health with substitute (8-Y 6-N 1-A)",8,6,1,0,15
1804140,1376936,2024-02-06,Senate,"Senate: Reported from Finance and Appropriations (10-Y 5-N)",10,5,0,0,15
1804140,1378208,2024-02-07,Senate,"Senate: Constitutional reading dispensed (40-Y 0-N)",40,0,0,0,40
1804140,1380997,2024-02-09,Senate,"Senate: Read third time and passed Senate (21-Y 19-N)",21,19,0,0,40
1804143,1364273,2024-01-15,Senate,"Senate: Reported from Local Government (13-Y 0-N)",13,0,0,0,13
1804143,1368759,2024-01-16,Senate,"Senate: Constitutional reading dispensed (38-Y 0-N)",38,0,0,1,39
1804143,1368760,2024-01-18,Senate,"Senate: Read third time and passed Senate (40-Y 0-N)",40,0,0,0,40
1804143,1387087,2024-02-16,House,"House: Reported from Counties, Cities and Towns (22-Y 0-N)",22,0,0,0,22
1804143,1390261,2024-02-21,House,"House: VOTE: Block Vote Passage (100-Y 0-N)",100,0,0,0,100
1804145,1373620,2024-01-31,Senate,"Senate: Reported from Courts of Justice with amendments (9-Y 6-N)",9,6,0,0,15
1804145,1376989,2024-02-06,Senate,"Senate: Engrossment reconsidered by Senate (39-Y 0-N)",39,0,0,1,40
1804145,1376990,2024-02-06,Senate,"Senate: Constitutional reading dispensed (39-Y 0-N)",39,0,0,1,40
1804145,1376991,2024-02-06,Senate,"Senate: Passed Senate (21-Y 18-N)",21,18,0,1,40
1804145,1432107,2024-02-22,House,"House: Subcommittee recommends reporting (6-Y 3-N)",6,3,0,1,10
1804145,1432108,2024-02-23,House,"House: Reported from Public Safety (12-Y 9-N)",12,9,0,1,22
1804145,1432228,2024-02-28,House,"House: VOTE: Passage (52-Y 47-N)",52,47,0,1,100
1804145,1432229,2024-04-17,Senate,"Senate: Passed in enrolled form rejected (21-Y 19-N)",21,19,0,0,40
1804149,1371667,2024-01-30,Senate,"Senate: Reported from Privileges and Elections (8-Y 7-N)",8,7,0,0,15
1804149,1378311,2024-02-07,Senate,"Senate: Reported from Finance and Appropriations with amendment (10-Y 5-N)",10,5,0,0,15
1804149,1379564,2024-02-08,Senate,"Senate: Constitutional reading dispensed (40-Y 0-N)",40,0,0,0,40
1804149,1381446,2024-02-12,Senate,"Senate: Read third time and passed Senate (21-Y 19-N)",21,19,0,0,40
1804157,1373645,2024-02-01,Senate,"Senate: Reported from Education and Health with substitute (15-Y 0-N)",15,0,0,0,15
1804157,1379715,2024-02-08,Senate,"Senate: Incorporated by Finance and Appropriations ",15,0,0,0,15
1804158,1371715,2024-01-30,Senate,"Senate: Reported from Privileges and Elections with substitute (15-Y 0-N)",15,0,0,0,15
1804158,1378325,2024-02-07,Senate,"Senate: Reported from Finance and Appropriations (15-Y 0-N)",15,0,0,0,15
1804158,1379834,2024-02-08,Senate,"Senate: Constitutional reading dispensed (40-Y 0-N)",40,0,0,0,40
1804158,1380825,2024-02-09,Senate,"Senate: Constitutional reading dispensed (40-Y 0-N)",40,0,0,0,40
1804158,1380826,2024-02-09,Senate,"Senate: Passed Senate (40-Y 0-N)",40,0,0,0,40
1804158,1387812,2024-02-19,House,"House: Subcommittee recommends reporting (5-Y 3-N)",5,3,0,0,8
1804158,1400508,2024-03-01,House,"House: Reported from Privileges and Elections with substitute (18-Y 3-N)",18,3,0,1,22
1804158,1404099,2024-03-06,House,"House: VOTE: Passage (99-Y 0-N)",99,0,0,1,100
1804158,1405552,2024-03-07,Senate,"Senate: House substitute rejected by Senate (0-Y 40-N)",0,40,0,0,40
1804158,1405553,2024-03-07,Senate,"Senate: Senate acceded to request (40-Y 0-N)",40,0,0,0,40
1804160,1374727,2024-02-01,Senate,"Senate: Reported from Transportation with amendment (9-Y 6-N)",9,6,0,0,15
1804160,1379890,2024-02-08,Senate,"Senate: Passed by indefinitely in Finance and Appropriations (15-Y 0-N)",15,0,0,0,15
1804164,1371709,2024-01-30,Senate,"Senate: Stricken at request of Patron in Agriculture, Conservation and Natural Resources (13-Y 0-N)",13,0,0,0,13
1804166,1371517,2024-01-30,House,"House: Subcommittee recommends reporting with substitute (8-Y 0-N)",8,0,0,0,8
1804166,1373604,2024-02-01,House,"House: Reported from Health and Human Services with substitute (22-Y 0-N)",22,0,0,0,22
1804166,1375116,2024-02-02,House,"House: Subcommittee recommends laying on the table (8-Y 0-N)",8,0,0,1,9
1804177,1366319,2024-01-17,Senate,"Senate: Reported from General Laws and Technology with amendments (13-Y 0-N 2-A)",13,0,2,0,15
1804177,1371533,2024-01-30,Senate,"Senate: Reported from Finance and Appropriations with amendment (10-Y 5-N)",10,5,0,0,15
1804177,1372922,2024-01-31,Senate,"Senate: Constitutional reading dispensed (40-Y 0-N)",40,0,0,0,40
1804177,1376197,2024-02-05,Senate,"Senate: Read third time and passed Senate (21-Y 19-N)",21,19,0,0,40
1804177,1392496,2024-02-22,House,"House: Subcommittee recommends reporting with substitute (6-Y 2-N)",6,2,0,0,8
1804177,1396502,2024-02-27,House,"House: Reported from General Laws with substitute (13-Y 9-N)",13,9,0,0,22
1804177,1400786,2024-03-01,House,"House: VOTE: Passage (52-Y 45-N)",52,45,0,3,100
1804177,1403325,2024-03-05,Senate,"Senate: House substitute agreed to by Senate (26-Y 14-N)",26,14,0,0,40
1804177,1403326,2024-03-05,Senate,"Senate: Reconsideration of House substitute agreed to by Senate (40-Y 0-N)",40,0,0,0,40
1804177,1403327,2024-03-05,Senate,"Senate: House substitute agreed to by Senate (21-Y 19-N)",21,19,0,0,40
1804180,1377879,2024-02-07,Senate,"Senate: Reported from Finance and Appropriations (15-Y 0-N)",15,0,0,0,15
1804180,1379843,2024-02-08,Senate,"Senate: Constitutional reading dispensed (40-Y 0-N)",40,0,0,0,40
1804180,1380829,2024-02-09,Senate,"Senate: Constitutional reading dispensed (40-Y 0-N)",40,0,0,0,40
1804180,1380830,2024-02-09,Senate,"Senate: Passed Senate (40-Y 0-N)",40,0,0,0,40
1804180,1387333,2024-02-19,House,"House: Reported from Finance (22-Y 0-N)",22,0,0,0,22
1804180,1391692,2024-02-22,House,"House: VOTE: Block Vote Passage (99-Y 0-N)",99,0,0,1,100
1804185,1378527,2024-02-07,Senate,"Senate: Passed by indefinitely in Finance and Appropriations (10-Y 5-N)",10,5,0,0,15
1804188,1375573,2024-02-05,Senate,"Senate: Continued to 2025 in Local Government (11-Y 4-N)",11,4,0,0,15
1804191,1378600,2024-02-07,Senate,"Senate: Reported from General Laws and Technology with substitute (14-Y 0-N)",14,0,0,0,14
1804191,1381284,2024-02-12,Senate,"Senate: Reported from Finance and Appropriations (15-Y 0-N)",15,0,0,0,15
1804191,1381907,2024-02-12,Senate,"Senate: Constitutional reading dispensed (40-Y 0-N)",40,0,0,0,40
1804191,1383624,2024-02-13,Senate,"Senate: Constitutional reading dispensed (39-Y 0-N)",39,0,0,1,40
1804191,1383625,2024-02-13,Senate,"Senate: Passed Senate (40-Y 0-N)",40,0,0,0,40
1804191,1393236,2024-02-23,House,"House: Subcommittee recommends reporting (6-Y 0-N)",6,0,0,0,6
1804191,1393237,2024-02-23,House,"House: Reported from Rules (16-Y 0-N)",16,0,0,2,18
1804194,1366385,2024-01-17,Senate,"Senate: Reported from General Laws and Technology with substitute (15-Y 0-N)",15,0,0,0,15
1804194,1368646,2024-01-19,Senate,"Senate: Constitutional reading dispensed (37-Y 0-N)",37,0,0,3,40
1804194,1368647,2024-01-24,Senate,"Senate: Read third time and passed Senate (40-Y 0-N)",40,0,0,0,40
1804194,1385651,2024-02-15,House,"House: Reported from General Laws (17-Y 5-N)",17,5,0,0,22
1804194,1389204,2024-02-20,House,"House: VOTE: Passage (65-Y 34-N)",65,34,0,1,100
1804198,1378639,2024-02-07,Senate,"Senate: Reported from General Laws and Technology with substitute (10-Y 4-N 1-A)",10,4,1,0,15
1804198,1381307,2024-02-12,Senate,"Senate: Incorporated by Finance and Appropriations ",15,0,0,0,15
1804202,1366469,2024-01-17,Senate,"Senate: Rereferred from Courts of Justice (11-Y 0-N)",11,0,0,0,11
1804202,1373665,2024-02-01,Senate,"Senate: Reported from Education and Health (9-Y 6-N)",9,6,0,0,15
1804202,1377442,2024-02-06,Senate,"Senate: Read third time and passed Senate (23-Y 16-N)",23,16,0,1,40
1804202,1432201,2024-02-20,House,"House: Subcommittee recommends reporting with substitute (6-Y 2-N)",6,2,0,0,8
1804202,1432202,2024-02-21,House,"House: Reported from Education with substitute (14-Y 8-N)",14,8,0,0,22
1804202,1432203,2024-02-26,House,"House: VOTE: Passage (53-Y 43-N)",53,43,0,4,100
1804202,1432204,2024-02-28,Senate,"Senate: House substitute agreed to by Senate (20-Y 19-N)",20,19,0,1,40
1804202,1432205,2024-04-17,Senate,"Senate: Senate rejected Governor's recommendation (19-Y 21-N)",19,21,0,0,40
1804205,1378869,2024-02-07,Senate,"Senate: Reported from Courts of Justice with amendment (15-Y 0-N)",15,0,0,0,15
1804205,1380323,2024-02-08,Senate,"Senate: Constitutional reading dispensed (40-Y 0-N)",40,0,0,0,40
1804205,1381142,2024-02-09,Senate,"Senate: Constitutional reading dispensed (40-Y 0-N)",40,0,0,0,40
1804205,1381143,2024-02-09,Senate,"Senate: Passed Senate (40-Y 0-N)",40,0,0,0,40
1804205,1386825,2024-02-16,House,"House: Subcommittee recommends reporting (8-Y 0-N)",8,0,0,1,9
1804205,1394084,2024-02-23,House,"House: Reported from Courts of Justice (20-Y 0-N)",20,0,0,2,22
1804205,1398158,2024-02-28,House,"House: VOTE: Block Vote Passage (97-Y 0-N)",97,0,0,3,100
1804208,1371070,2024-01-29,Senate,"Senate: Failed to report (defeated) in Commerce and Labor (4-Y 9-N 2-A)",4,9,2,0,15
1804213,1367187,2024-01-22,Senate,"Senate: Reported from Local Government (13-Y 2-N)",13,2,0,0,15
1804213,1368945,2024-01-23,Senate,"Senate: Constitutional reading dispensed (39-Y 0-N)",39,0,0,1,40
1804213,1371148,2024-01-29,Senate,"Senate: Read third time and passed Senate (39-Y 1-N)",39,1,0,0,40
1804213,1395628,2024-02-27,House,"House: Subcommittee recommends reporting (6-Y 0-N)",6,0,0,2,8
1804213,1397347,2024-02-28,House,"House: Reported from Counties, Cities and Towns (21-Y 1-N)",21,1,0,0,22
1804213,1402464,2024-03-04,House,"House: VOTE: Passage (93-Y 2-N)",93,2,0,5,100
1804217,1366474,2024-01-18,Senate,"Senate: Reported from Education and Health (11-Y 4-N)",11,4,0,0,15
1804217,1381454,2024-02-12,Senate,"Senate: Reported from Finance and Appropriations with substitute (15-Y 0-N)",15,0,0,0,15
1804217,1381455,2024-02-12,Senate,"Senate: Constitutional reading dispensed (40-Y 0-N)",40,0,0,0,40
1804217,1383677,2024-02-13,Senate,"Senate: Constitutional reading dispensed (40-Y 0-N)",40,0,0,0,40
1804217,1383678,2024-02-13,Senate,"Senate: Passed Senate (40-Y 0-N)",40,0,0,0,40
1804217,1397278,2024-02-28,House,"House: Reported from Education with substitute (18-Y 4-N)",18,4,0,0,22
1804217,1402123,2024-03-04,House,"House: VOTE: Passage (84-Y 14-N)",84,14,0,2,100
1804217,1403234,2024-03-05,Senate,"Senate: House substitute agreed to by Senate (39-Y 1-N)",39,1,0,0,40
1804221,1380746,2024-02-09,Senate,"Senate: Reported from Commerce and Labor with substitute (10-Y 5-N)",10,5,0,0,15
1804221,1380747,2024-02-09,Senate,"Senate: Constitutional reading dispensed (39-Y 0-N)",39,0,0,1,40
1804221,1383260,2024-02-13,Senate,"Senate: Read third time and passed Senate (23-Y 17-N)",23,17,0,0,40
1804221,1389259,2024-02-20,House,"House: Reported from Labor and Commerce (13-Y 9-N)",13,9,0,0,22
1804221,1393890,2024-02-23,House,"House: VOTE: Passage (51-Y 47-N)",51,47,0,2,100
1804223,1366219,2024-01-16,Senate,"Senate: Stricken at request of Patron in Agriculture, Conservation and Natural Resources (14-Y 0-N)",14,0,0,0,14
1804229,1375921,2024-02-05,Senate,"Senate: Reported from Local Government with substitute (8-Y 6-N 1-A)",8,6,1,0,15
1804229,1377105,2024-02-06,Senate,"Senate: Constitutional reading dispensed (39-Y 0-N)",39,0,0,1,40
1804229,1380834,2024-02-09,Senate,"Senate: Engrossment reconsidered by Senate (40-Y 0-N)",40,0,0,0,40
1804229,1380835,2024-02-09,Senate,"Senate: Constitutional reading dispensed (38-Y 2-N)",38,2,0,0,40
1804229,1380836,2024-02-09,Senate,"Senate: Passed Senate (22-Y 18-N)",22,18,0,0,40
1804231,1378670,2024-02-07,Senate,"Senate: Reported from Courts of Justice with substitute (9-Y 6-N)",9,6,0,0,15
1804231,1380067,2024-02-08,Senate,"Senate: Constitutional reading dispensed (40-Y 0-N)",40,0,0,0,40
1804231,1382059,2024-02-12,Senate,"Senate: Read third time and passed Senate (21-Y 19-N)",21,19,0,0,40
1804231,1386977,2024-02-16,House,"House: Reported from Courts of Justice with substitute (11-Y 10-N)",11,10,0,1,22
1804231,1390685,2024-02-21,House,"House: Reported from Appropriations (12-Y 10-N)",12,10,0,0,22
1804231,1394357,2024-02-26,House,"House: VOTE: Passage (50-Y 46-N)",50,46,0,4,100
1804235,1373383,2024-01-31,Senate,"Senate: Reported from General Laws and Technology with substitute (8-Y 7-N)",8,7,0,0,15
1804235,1380583,2024-02-09,Senate,"Senate: Reported from Commerce and Labor with substitute (8-Y 6-N)",8,6,0,0,14
1804235,1381280,2024-02-12,Senate,"Senate: Continued to 2025 in Finance and Appropriations (11-Y 4-N)",11,4,0,0,15
1804238,1371066,2024-01-29,Senate,"Senate: Reported from Commerce and Labor with amendments (13-Y 2-N)",13,2,0,0,15
1804238,1377453,2024-02-06,Senate,"Senate: Reported from Finance and Appropriations with substitute (13-Y 2-N)",13,2,0,0,15
1804238,1378404,2024-02-07,Senate,"Senate: Constitutional reading dispensed (40-Y 0-N)",40,0,0,0,40
1804238,1380906,2024-02-09,Senate,"Senate: Read third time and passed Senate (31-Y 7-N)",31,7,0,2,40
1804238,1380907,2024-02-09,Senate,"Senate: Reconsideration of passage agreed to by Senate (37-Y 2-N)",37,2,0,1,40
1804238,1380908,2024-02-09,Senate,"Senate: Passed Senate (30-Y 10-N)",30,10,0,0,40
1804243,1377432,2024-02-06,Senate,"Senate: Incorporated by Privileges and Elections ",14,0,0,0,14
1804245,1374188,2024-02-01,House,"House: Subcommittee recommends reporting (8-Y 0-N)",8,0,0,0,8
1804245,1377328,2024-02-06,House,"House: Reported from Health and Human Services (22-Y 0-N)",22,0,0,0,22
1804245,1380734,2024-02-09,House,"House: Subcommittee recommends laying on the table (4-Y 3-N)",4,3,0,2,9
1804249,1375619,2024-02-05,House,"House: Subcommittee recommends reporting (11-Y 0-N)",11,0,0,0,11
1804249,1378617,2024-02-07,House,"House: Reported from Education (22-Y 0-N)",22,0,0,0,22
1804249,1383158,2024-02-13,House,"House: VOTE: Block Vote Passage (99-Y 0-N)",99,0,0,1,100
1804249,1399458,2024-02-29,Senate,"Senate: Reported from Education and Health with substitute (15-Y 0-N)",15,0,0,0,15
1804249,1400739,2024-03-01,Senate,"Senate: Constitutional reading dispensed (40-Y 0-N)",40,0,0,0,40
1804249,1402086,2024-03-04,Senate,"Senate: Passed Senate with substitute (39-Y 0-N)",39,0,0,1,40
1804249,1403351,2024-03-05,House,"House: VOTE: Adoption (99-Y 0-N)",99,0,0,1,100
1804253,1368084,2024-01-23,Senate,"Senate: Continued to 2025 in Agriculture, Conservation and Natural Resources (10-Y 5-N)",10,5,0,0,15
1804257,1368995,2024-01-25,Senate,"Senate: Reported from Education and Health with amendment (15-Y 0-N)",15,0,0,0,15
1804257,1372787,2024-01-31,Senate,"Senate: Continued to 2025 in Finance and Appropriations (10-Y 5-N)",10,5,0,0,15
1804262,1366107,2024-01-16,Senate,"Senate: Reported from Agriculture, Conservation and Natural Resources with amendment (10-Y 1-N)",10,1,0,0,11
1804262,1371553,2024-01-30,Senate,"Senate: Reported from Finance and Appropriations with amendments (15-Y 0-N)",15,0,0,0,15
1804262,1372120,2024-01-30,Senate,"Senate: Reported from Finance and Appropriations with substitute (15-Y 0-N)",15,0,0,0,15
1804262,1372960,2024-01-31,Senate,"Senate: Constitutional reading dispensed (40-Y 0-N)",40,0,0,0,40
1804262,1376069,2024-02-05,Senate,"Senate: Read third time and passed Senate (37-Y 3-N)",37,3,0,0,40
1804262,1390881,2024-02-21,House,"House: Subcommittee recommends reporting with substitute (9-Y 1-N)",9,1,0,0,10
1804262,1397407,2024-02-28,House,"House: Reported from Agriculture, Chesapeake and Natural Resources with substitute (16-Y 6-N)",16,6,0,0,22
1804262,1401526,2024-03-04,House,"House: VOTE: Passage (56-Y 41-N)",56,41,0,3,100
1804262,1403470,2024-03-05,Senate,"Senate: House substitute agreed to by Senate (25-Y 13-N)",25,13,0,2,40
1804265,1364276,2024-01-15,Senate,"Senate: Reported from Courts of Justice (15-Y 0-N)",15,0,0,0,15
1804265,1432103,2024-01-16,Senate,"Senate: Constitutional reading dispensed (38-Y 0-N)",38,0,0,1,39
1804265,1432104,2024-01-18,Senate,"Senate: Read third time and passed Senate (40-Y 0-N)",40,0,0,0,40
1804265,1432105,2024-02-16,House,"House: Reported from Courts of Justice (22-Y 0-N)",22,0,0,0,22
1804265,1432106,2024-02-21,House,"House: VOTE: Block Vote Passage (100-Y 0-N)",100,0,0,0,100
1804268,1371068,2024-01-29,Senate,"Senate: Reported from Commerce and Labor with amendments (9-Y 6-N)",9,6,0,0,15
1804268,1372455,2024-01-31,Senate,"Senate: Constitutional reading dispensed (40-Y 0-N)",40,0,0,0,40
1804268,1376221,2024-02-05,Senate,"Senate: Read third time and passed Senate (22-Y 18-N)",22,18,0,0,40
1804268,1389279,2024-02-20,House,"House: Reported from Labor and Commerce with amendment(s) (13-Y 9-N)",13,9,0,0,22
1804268,1393368,2024-02-23,House,"House: VOTE: Passage (53-Y 45-N)",53,45,0,2,100
1804268,1396285,2024-02-27,Senate,"Senate: House amendment agreed to by Senate (22-Y 17-N)",22,17,0,1,40
1804268,1429893,2024-04-17,Senate,"Senate: Senate concurred in Governor's recommendation (40-Y 0-N)",40,0,0,0,40
1804268,1429894,2024-04-17,House,"House: VOTE: Adoption (57-Y 40-N)",57,40,0,3,100
1804271,1364316,2024-01-15,Senate,"Senate: Reported from Local Government (13-Y 0-N)",13,0,0,0,13
1804271,1368608,2024-01-16,Senate,"Senate: Constitutional reading dispensed (38-Y 0-N)",38,0,0,1,39
1804271,1368609,2024-01-18,Senate,"Senate: Read third time and passed Senate (40-Y 0-N)",40,0,0,0,40
1804271,1391450,2024-02-22,House,"House: Subcommittee recommends reporting (8-Y 0-N)",8,0,0,0,8
1804271,1393304,2024-02-23,House,"House: Reported from Counties, Cities and Towns (22-Y 0-N)",22,0,0,0,22
1804271,1398584,2024-02-28,House,"House: VOTE: Block Vote Passage (97-Y 0-N)",97,0,0,3,100
1804276,1369417,2024-01-25,Senate,"Senate: Passed by indefinitely in Education and Health (15-Y 0-N)",15,0,0,0,15
1804279,1373693,2024-02-01,Senate,"Senate: Reported from Education and Health (15-Y 0-N)",15,0,0,0,15
1804279,1379707,2024-02-08,Senate,"Senate: Reported from Finance and Appropriations with substitute (15-Y 0-N)",15,0,0,0,15
1804279,1380694,2024-02-09,Senate,"Senate: Constitutional reading dispensed (39-Y 0-N)",39,0,0,1,40
1804279,1381468,2024-02-12,Senate,"Senate: Constitutional reading dispensed (40-Y 0-N)",40,0,0,0,40
1804279,1381469,2024-02-12,Senate,"Senate: Passed Senate (40-Y 0-N)",40,0,0,0,40
1804279,1394276,2024-02-26,House,"House: Reported from Education with substitute (14-Y 7-N)",14,7,0,1,22
1804279,1399342,2024-02-29,House,"House: VOTE: Passage (57-Y 43-N)",57,43,0,0,100
1804279,1401864,2024-03-04,Senate,"Senate: House substitute rejected by Senate (0-Y 39-N)",0,39,0,1,40
1804279,1404235,2024-03-06,Senate,"Senate: Senate acceded to request (40-Y 0-N)",40,0,0,0,40
1804279,1406698,2024-03-09,House,"House: VOTE: Adoption (59-Y 40-N)",59,40,0,1,100
1804279,1406699,2024-03-09,Senate,"Senate: Conference report agreed to by Senate (39-Y 1-N)",39,1,0,0,40
1804291,1376218,2024-02-05,Senate,"Senate: Reported from Commerce and Labor with substitute (15-Y 0-N)",15,0,0,0,15
1804291,1378246,2024-02-07,Senate,"Senate: Constitutional reading dispensed (40-Y 0-N)",40,0,0,0,40
1804291,1380260,2024-02-08,Senate,"Senate: Constitutional reading dispensed (40-Y 0-N)",40,0,0,0,40
1804291,1380261,2024-02-08,Senate,"Senate: Read third time and passed Senate (40-Y 0-N)",40,0,0,0,40
1804291,1389551,2024-02-20,House,"House: Reported from Labor and Commerce (14-Y 8-N)",14,8,0,0,22
1804291,1393596,2024-02-23,House,"House: VOTE: Passage (53-Y 45-N)",53,45,0,2,100
1804294,1373565,2024-02-01,Senate,"Senate: Reported from Education and Health with substitute (15-Y 0-N)",15,0,0,0,15
1804294,1377491,2024-02-06,Senate,"Senate: Read third time and passed Senate (39-Y 0-N)",39,0,0,1,40
1804294,1432110,2024-02-23,House,"House: Subcommittee recommends reporting (6-Y 0-N)",6,0,0,0,6
1804294,1432111,2024-02-23,House,"House: Reported from Rules (16-Y 0-N)",16,0,0,2,18
1804294,1432112,2024-02-28,House,"House: Reported from Appropriations (22-Y 0-N)",22,0,0,0,22
1804294,1432113,2024-03-04,House,"House: VOTE: Block Vote Passage (97-Y 0-N)",97,0,0,3,100
1804301,1368996,2024-01-25,Senate,"Senate: Rereferred from Education and Health (14-Y 0-N)",14,0,0,0,14
1804301,1373563,2024-01-31,Senate,"Senate: Continued to 2025 in Courts of Justice (15-Y 0-N)",15,0,0,0,15
1804304,1373706,2024-02-01,Senate,"Senate: Reported from Education and Health with amendment (9-Y 6-N)",9,6,0,0,15
1804304,1379758,2024-02-08,Senate,"Senate: Reported from Finance and Appropriations with amendment (11-Y 4-N)",11,4,0,0,15
1804304,1381046,2024-02-09,Senate,"Senate: Constitutional reading dispensed (39-Y 0-N)",39,0,0,1,40
1804304,1383154,2024-02-13,Senate,"Senate: Read third time and passed Senate (21-Y 19-N)",21,19,0,0,40
1804304,1392412,2024-02-22,House,"House: Subcommittee recommends reporting (5-Y 3-N)",5,3,0,0,8
1804304,1395573,2024-02-27,House,"House: Reported from Health and Human Services (11-Y 10-N)",11,10,0,1,22
1804304,1398337,2024-02-28,House,"House: Tabled in Appropriations (21-Y 0-N)",21,0,0,1,22
1804307,1375620,2024-02-05,Senate,"Senate: Continued to 2025 in Courts of Justice (12-Y 0-N)",12,0,0,0,12
1804311,1366460,2024-01-17,Senate,"Senate: Reported from General Laws and Technology with substitute (15-Y 0-N)",15,0,0,0,15
1804311,1381570,2024-02-12,Senate,"Senate: Reported from Finance and Appropriations with substitute (15-Y 0-N)",15,0,0,0,15
1804311,1381571,2024-02-12,Senate,"Senate: Constitutional reading dispensed (40-Y 0-N)",40,0,0,0,40
1804311,1383155,2024-02-13,Senate,"Senate: Constitutional reading dispensed (39-Y 0-N)",39,0,0,1,40
1804311,1383156,2024-02-13,Senate,"Senate: Passed Senate (40-Y 0-N)",40,0,0,0,40
1804311,1389574,2024-02-20,House,"House: Reported from General Laws with substitute (21-Y 0-N)",21,0,0,1,22
1804311,1393372,2024-02-23,House,"House: VOTE: Passage (93-Y 5-N)",93,5,0,2,100
1804311,1395918,2024-02-27,Senate,"Senate: House substitute rejected by Senate (0-Y 39-N)",0,39,0,1,40
1804311,1400650,2024-03-01,Senate,"Senate: Senate acceded to request (40-Y 0-N)",40,0,0,0,40
1804311,1405378,2024-03-07,House,"House: VOTE: Adoption (91-Y 6-N)",91,6,0,3,100
1804311,1406332,2024-03-08,Senate,"Senate: Conference report agreed to by Senate (39-Y 1-N)",39,1,0,0,40
1804313,1368521,2024-01-24,Senate,"Senate: Reported from Courts of Justice with substitute (9-Y 5-N)",9,5,0,0,14
1804313,1369927,2024-01-26,Senate,"Senate: Constitutional reading dispensed (37-Y 0-N)",37,0,0,3,40
1804313,1371950,2024-01-30,Senate,"Senate: Read third time and passed Senate (23-Y 17-N)",23,17,0,0,40
1804313,1384193,2024-02-14,House,"House: Subcommittee recommends reporting (6-Y 2-N)",6,2,0,1,9
1804313,1386817,2024-02-16,House,"House: Reported from Courts of Justice (13-Y 9-N)",13,9,0,0,22
1804313,1390890,2024-02-21,House,"House: VOTE: Passage (51-Y 49-N)",51,49,0,0,100
1804316,1371628,2024-01-30,Senate,"Senate: Stricken at request of Patron in Agriculture, Conservation and Natural Resources (13-Y 0-N)",13,0,0,0,13
1807822,1368860,2024-01-24,Senate,"Senate: Reported from General Laws and Technology (15-Y 0-N)",15,0,0,0,15
1807822,1369893,2024-01-26,Senate,"Senate: Constitutional reading dispensed (37-Y 0-N)",37,0,0,3,40
1807822,1371896,2024-01-30,Senate,"Senate: Read third time and passed Senate (40-Y 0-N)",40,0,0,0,40
1807822,1386258,2024-02-15,House,"House: Reported from General Laws (22-Y 0-N)",22,0,0,0,22
1807822,1388480,2024-02-20,House,"House: VOTE: Block Vote Passage (98-Y 0-N)",98,0,0,2,100
1807824,1378589,2024-02-07,Senate,"Senate: Reported from General Laws and Technology (15-Y 0-N)",15,0,0,0,15
1807824,1380130,2024-02-08,Senate,"Senate: Constitutional reading dispensed (40-Y 0-N)",40,0,0,0,40
1807824,1381027,2024-02-09,Senate,"Senate: Constitutional reading dispensed (40-Y 0-N)",40,0,0,0,40
1807824,1381028,2024-02-09,Senate,"Senate: Passed Senate (40-Y 0-N)",40,0,0,0,40
1807824,1391425,2024-02-22,House,"House: Subcommittee recommends reporting (8-Y 0-N)",8,0,0,0,8
1807824,1393167,2024-02-23,House,"House: Reported from Counties, Cities and Towns (22-Y 0-N)",22,0,0,0,22
1807824,1396507,2024-02-27,House,"House: Reported from General Laws (22-Y 0-N)",22,0,0,0,22
1807824,1400784,2024-03-01,House,"House: VOTE: Block Vote Passage (97-Y 0-N)",97,0,0,3,100
1807825,1366078,2024-01-16,Senate,"Senate: Stricken at request of Patron in Agriculture, Conservation and Natural Resources (14-Y 0-N)",14,0,0,0,14
1807826,1366966,2024-01-19,Senate,"Senate: Reported from Rehabilitation and Social Services (15-Y 0-N)",15,0,0,0,15
1807826,1377119,2024-02-06,Senate,"Senate: Reported from Finance and Appropriations (15-Y 0-N)",15,0,0,0,15
1807826,1378205,2024-02-07,Senate,"Senate: Constitutional reading dispensed (40-Y 0-N)",40,0,0,0,40
1807826,1379600,2024-02-08,Senate,"Senate: Constitutional reading dispensed (40-Y 0-N)",40,0,0,0,40
1807826,1379601,2024-02-08,Senate,"Senate: Read third time and passed Senate (40-Y 0-N)",40,0,0,0,40
1807826,1388380,2024-02-20,House,"House: Reported from Health and Human Services (21-Y 1-N)",21,1,0,0,22
1807826,1395331,2024-02-26,House,"House: Reported from Appropriations (22-Y 0-N)",22,0,0,0,22
1807826,1398188,2024-02-28,House,"House: VOTE: Passage (100-Y 0-N)",100,0,0,0,100
1807827,1378663,2024-02-07,Senate,"Senate: Continued to 2025 in General Laws and Technology (13-Y 2-N)",13,2,0,0,15
1807828,1367233,2024-01-22,Senate,"Senate: Reported from Commerce and Labor (13-Y 0-N 1-A)",13,0,1,0,14
1807828,1368542,2024-01-24,Senate,"Senate: Constitutional reading dispensed (40-Y 0-N)",40,0,0,0,40
1807828,1370385,2024-01-29,Senate,"Senate: Read third time and passed Senate (29-Y 11-N)",29,11,0,0,40
1807828,1391955,2024-02-22,House,"House: Subcommittee recommends reporting (8-Y 0-N)",8,0,0,0,8
1807828,1396225,2024-02-27,House,"House: Reported from Labor and Commerce (17-Y 4-N)",17,4,0,1,22
1807828,1400597,2024-03-01,House,"House: VOTE: Passage (70-Y 27-N)",70,27,0,3,100
1807829,1371017,2024-01-29,Senate,"Senate: Incorporated by Courts of Justice ",14,0,0,0,14
1807869,1369229,2024-01-25,House,"House: Subcommittee recommends reporting with amendments (8-Y 0-N)",8,0,0,0,8
1807869,1372082,2024-01-30,House,"House: Reported from General Laws with amendment(s) (22-Y 0-N)",22,0,0,0,22
1807869,1376074,2024-02-05,House,"House: VOTE: Block Vote Passage (98-Y 0-N)",98,0,0,2,100
1807869,1384957,2024-02-14,Senate,"Senate: Reported from General Laws and Technology (15-Y 0-N)",15,0,0,0,15
1807869,1386556,2024-02-16,Senate,"Senate: Constitutional reading dispensed (38-Y 0-N)",38,0,0,2,40
1807869,1387592,2024-02-19,Senate,"Senate: Passed Senate (39-Y 0-N)",39,0,0,1,40
1807870,1368246,2024-01-24,House,"House: Subcommittee recommends striking from docket (8-Y 0-N)",8,0,0,2,10
1807871,1379584,2024-02-08,House,"House: Subcommittee recommends laying on the table (5-Y 2-N)",5,2,0,1,8
1807872,1375629,2024-02-05,House,"House: Reported from Education with substitute (22-Y 0-N)",22,0,0,0,22
1807872,1380569,2024-02-09,House,"House: VOTE: Block Vote Passage (96-Y 0-N)",96,0,0,4,100
1807872,1391731,2024-02-22,Senate,"Senate: Reported from Education and Health (15-Y 0-N)",15,0,0,0,15
1807872,1393505,2024-02-23,Senate,"Senate: Constitutional reading dispensed (38-Y 0-N)",38,0,0,2,40
1807872,1394592,2024-02-26,Senate,"Senate: Passed Senate (40-Y 0-N)",40,0,0,0,40
1807874,1368139,2024-01-23,House,"House: Subcommittee recommends reporting with substitute (7-Y 0-N)",7,0,0,0,7
1807874,1369191,2024-01-25,House,"House: Reported from Labor and Commerce with substitute (21-Y 0-N)",21,0,0,1,22
1807874,1372720,2024-01-31,House,"House: VOTE: Block Vote Passage (100-Y 0-N)",100,0,0,0,100
1807874,1387745,2024-02-19,Senate,"Senate: Reported from Commerce and Labor with amendment (15-Y 0-N)",15,0,0,0,15
1807874,1390620,2024-02-21,Senate,"Senate: Constitutional reading dispensed (40-Y 0-N)",40,0,0,0,40
1807874,1392208,2024-02-22,Senate,"Senate: Passed Senate with amendments (40-Y 0-N)",40,0,0,0,40
1807874,1394855,2024-02-26,House,"House: VOTE: Adoption (96-Y 0-N)",96,0,0,4,100
1807875,1367202,2024-01-22,House,"House: Subcommittee recommends reporting (9-Y 1-N)",9,1,0,0,10
1807875,1368654,2024-01-24,House,"House: Reported from Education (21-Y 0-N)",21,0,0,1,22
1807875,1371948,2024-01-30,House,"House: VOTE: Block Vote Passage (100-Y 0-N)",100,0,0,0,100
1807875,1391494,2024-02-22,Senate,"Senate: Reported from Education and Health with substitute (15-Y 0-N)",15,0,0,0,15
1807875,1399398,2024-02-29,Senate,"Senate: Reported from Finance and Appropriations with substitute (14-Y 0-N)",14,0,0,0,14
1807875,1401966,2024-03-04,Senate,"Senate: Constitutional reading dispensed (40-Y 0-N)",40,0,0,0,40
1807875,1403051,2024-03-05,Senate,"Senate: Passed Senate with substitute (40-Y 0-N)",40,0,0,0,40
1807875,1404302,2024-03-06,House,"House: VOTE: REJECTED (0-Y 98-N)",0,98,0,2,100
1807875,1405162,2024-03-07,Senate,"Senate: Senate insisted on substitute (40-Y 0-N)",40,0,0,0,40
1807875,1406417,2024-03-08,Senate,"Senate: Conference report agreed to by Senate (40-Y 0-N)",40,0,0,0,40
1807875,1406418,2024-03-08,House,"House: VOTE: Adoption (99-Y 0-N)",99,0,0,1,100
1807876,1375093,2024-02-02,House,"House: Subcommittee recommends reporting with substitute (5-Y 0-N)",5,0,1,0,6
1807876,1377631,2024-02-06,House,"House: Reported from General Laws with substitute (11-Y 8-N)",11,8,1,2,22
1807876,1381813,2024-02-12,House,"House: VOTE: Passage (52-Y 48-N)",52,48,0,0,100
1807876,1393144,2024-02-23,Senate,"Senate: Reported from Rehabilitation and Social Services with substitute (10-Y 5-N)",10,5,0,0,15
1807876,1395895,2024-02-27,Senate,"Senate: Constitutional reading dispensed (39-Y 0-N)",39,0,0,1,40
1807876,1395896,2024-02-27,Senate,"Senate: Reported from Finance and Appropriations with substitute (10-Y 5-N)",10,5,0,0,15
1807876,1398179,2024-02-28,Senate,"Senate: Reading of substitute waived (28-Y 11-N)",28,11,0,1,40
1807876,1398180,2024-02-28,Senate,"Senate: Passed Senate with substitute (21-Y 18-N)",21,18,0,1,40
1807876,1398181,2024-02-28,House,"House: VOTE: Adoption (51-Y 47-N)",51,47,0,2,100
1807877,1372004,2024-01-30,House,"House: Referred from Transportation (22-Y 0-N)",22,0,0,0,22
1807877,1376200,2024-02-05,House,"House: Subcommittee recommends striking from docket (8-Y 0-N)",8,0,0,1,9
1807879,1376866,2024-02-06,House,"House: Subcommittee recommends striking from docket (8-Y 0-N)",8,0,0,0,8
1807880,1371220,2024-01-29,House,"House: Subcommittee recommends laying on the table (4-Y 3-N)",4,3,0,2,9
1807881,1369182,2024-01-25,House,"House: Subcommittee recommends reporting with amendments (8-Y 0-N)",8,0,0,0,8
1807881,1371478,2024-01-30,House,"House: Reported from Health and Human Services with amendment(s) (22-Y 0-N)",22,0,0,0,22
1807881,1376031,2024-02-05,House,"House: VOTE: Block Vote Passage (98-Y 0-N)",98,0,0,2,100
1807881,1392434,2024-02-22,Senate,"Senate: Reported from Education and Health (14-Y 0-N)",14,0,0,0,14
1807881,1393895,2024-02-23,Senate,"Senate: Constitutional reading dispensed (38-Y 0-N)",38,0,0,2,40
1807881,1395054,2024-02-26,Senate,"Senate: Passed Senate (40-Y 0-N)",40,0,0,0,40
1807883,1371199,2024-01-29,House,"House: Subcommittee recommends reporting with substitute (7-Y 0-N)",7,0,0,2,9
1807883,1372757,2024-01-31,House,"House: Reported from Appropriations with amendment(s) (22-Y 0-N)",22,0,0,0,22
1807883,1373628,2024-01-31,House,"House: Reported from Appropriations with substitute (22-Y 0-N)",22,0,0,0,22
1807883,1377562,2024-02-06,House,"House: VOTE: Block Vote Passage (99-Y 0-N)",99,0,0,1,100
1807883,1390223,2024-02-21,Senate,"Senate: Reported from Finance and Appropriations with substitute (14-Y 0-N)",14,0,0,0,14
1807883,1391886,2024-02-22,Senate,"Senate: Constitutional reading dispensed (40-Y 0-N)",40,0,0,0,40
1807883,1393554,2024-02-23,Senate,"Senate: Passed Senate with substitute (39-Y 0-N)",39,0,0,1,40
1807883,1396351,2024-02-27,House,"House: VOTE: REJECTED (0-Y 97-N)",0,97,0,3,100
1807883,1399287,2024-02-29,Senate,"Senate: Senate insisted on substitute (39-Y 0-N)",39,0,0,1,40
1807883,1404208,2024-03-06,House,"House: VOTE: Adoption (98-Y 0-N)",98,0,0,2,100
1807883,1406765,2024-03-09,Senate,"Senate: Conference report agreed to by Senate (40-Y 0-N)",40,0,0,0,40
1807885,1379465,2024-02-08,House,"House: Subcommittee recommends striking from docket (8-Y 0-N)",8,0,0,0,8
1807885,1380427,2024-02-08,House,"House: Stricken from docket by General Laws (20-Y 0-N)",20,0,0,2,22
1807886,1370490,2024-01-29,House,"House: Subcommittee recommends reporting (11-Y 0-N)",11,0,0,0,11
1807886,1372810,2024-01-31,House,"House: Reported from Education (22-Y 0-N)",22,0,0,0,22
1807886,1376320,2024-02-05,House,"House: Subcommittee recommends laying on the table (8-Y 0-N)",8,0,0,1,9
1807887,1377774,2024-02-06,House,"House: Subcommittee recommends reporting (8-Y 0-N)",8,0,0,0,8
1807887,1378317,2024-02-07,House,"House: Reported from Education (22-Y 0-N)",22,0,0,0,22
1807887,1383513,2024-02-13,House,"House: VOTE: Block Vote Passage (99-Y 0-N)",99,0,0,1,100
1807887,1399107,2024-02-29,Senate,"Senate: Reported from Education and Health (15-Y 0-N)",15,0,0,0,15
1807887,1401419,2024-03-04,Senate,"Senate: Continued to 2025 in Finance and Appropriations (14-Y 1-N)",14,1,0,0,15
1807888,1371211,2024-01-29,House,"House: Subcommittee recommends reporting with amendments (7-Y 0-N)",7,0,0,2,9
1807888,1372762,2024-01-31,House,"House: Reported from Appropriations with amendment(s) (22-Y 0-N)",22,0,0,0,22
1807888,1377533,2024-02-06,House,"House: VOTE: Block Vote Passage (99-Y 0-N)",99,0,0,1,100
1807888,1396151,2024-02-27,Senate,"Senate: Constitutional reading dispensed (39-Y 0-N)",39,0,0,1,40
1807888,1396152,2024-02-27,Senate,"Senate: Reported from Finance and Appropriations (15-Y 0-N)",15,0,0,0,15
1807888,1397695,2024-02-28,Senate,"Senate: Passed Senate (39-Y 0-N)",39,0,0,1,40
1807890,1379449,2024-02-08,House,"House: Subcommittee recommends laying on the table (3-Y 2-N)",3,2,0,0,5
1807891,1377770,2024-02-06,House,"House: Subcommittee recommends reporting with amendments (8-Y 0-N)",8,0,0,1,9
1807891,1378641,2024-02-07,House,"House: Reported from Finance with substitute (18-Y 0-N)",18,0,0,4,22
1807891,1378642,2024-02-07,House,"House: Reported from Finance with substitute (19-Y 0-N)",19,0,0,3,22
1807892,1369433,2024-01-25,House,"House: Subcommittee recommends reporting with substitute (8-Y 0-N)",8,0,0,0,8
1807892,1372003,2024-01-30,House,"House: Reported from Labor and Commerce with substitute (22-Y 0-N)",22,0,0,0,22
1807892,1377529,2024-02-06,House,"House: VOTE: Passage (98-Y 0-N)",98,0,0,2,100
1807892,1387548,2024-02-19,Senate,"Senate: Rereferred from Commerce and Labor (14-Y 0-N)",14,0,0,0,14
1807892,1398470,2024-02-28,Senate,"Senate: Reported from General Laws and Technology (15-Y 0-N)",15,0,0,0,15
1807892,1401096,2024-03-01,Senate,"Senate: Constitutional reading dispensed (40-Y 0-N)",40,0,0,0,40
1807892,1401900,2024-03-04,Senate,"Senate: Amendment by Senator Suetterlien rejected (19-Y 20-N)",19,20,0,1,40
1807892,1401901,2024-03-04,Senate,"Senate: Passed Senate (39-Y 0-N)",39,0,0,1,40
1807892,1429825,2024-04-17,House,"House: VOTE: Adoption (44-Y 56-N)",44,56,0,0,100
1807893,1377490,2024-02-06,House,"House: Subcommittee recommends striking from docket (8-Y 0-N)",8,0,0,1,9
1807894,1372959,2024-01-31,House,"House: Subcommittee recommends reporting with substitute (8-Y 0-N)",8,0,0,1,9
1807894,1375645,2024-02-02,House,"House: Reported from Courts of Justice with substitute (21-Y 0-N)",21,0,0,1,22
1807894,1380156,2024-02-08,House,"House: VOTE: Block Vote Passage (98-Y 0-N)",98,0,0,2,100
1807894,1387330,2024-02-19,Senate,"Senate: Continued to 2025 in Courts of Justice (11-Y 2-N)",11,2,0,0,13
1807904,1373336,2024-01-31,House,"House: Subcommittee recommends reporting with substitute (5-Y 2-N)",5,2,1,1,9
1807904,1378805,2024-02-07,House,"House: Reported from Courts of Justice with substitute (13-Y 9-N)",13,9,0,0,22
1807905,1376292,2024-02-05,House,"House: Subcommittee recommends reporting with substitute (8-Y 0-N)",8,0,0,1,9
1807905,1378472,2024-02-07,House,"House: Reported from Courts of Justice with substitute (22-Y 0-N)",22,0,0,0,22
1807905,1380744,2024-02-09,House,"House: Subcommittee recommends laying on the table (6-Y 1-N)",6,1,0,2,9
1807906,1378447,2024-02-07,Senate,"Senate: Reported from General Laws and Technology with substitute (14-Y 0-N 1-A)",14,0,1,0,15
1807906,1379739,2024-02-08,Senate,"Senate: Constitutional reading dispensed (40-Y 0-N)",40,0,0,0,40
1807906,1381435,2024-02-12,Senate,"Senate: Read third time and passed Senate (40-Y 0-N)",40,0,0,0,40
1807906,1387264,2024-02-19,House,"House: Subcommittee recommends continuing to 2025 with amendment(s) (9-Y 1-N)",9,1,0,0,10
1807907,1374354,2024-02-01,House,"House: Subcommittee recommends reporting with substitute (8-Y 0-N)",8,0,0,0,8
1807907,1377644,2024-02-06,House,"House: Reported from General Laws with substitute (16-Y 4-N)",16,4,0,2,22
1807907,1382482,2024-02-12,House,"House: VOTE: Passage (67-Y 30-N)",67,30,0,3,100
1807907,1391122,2024-02-21,Senate,"Senate: Reported from General Laws and Technology (9-Y 6-N)",9,6,0,0,15
1807907,1393390,2024-02-23,Senate,"Senate: Constitutional reading dispensed (38-Y 0-N)",38,0,0,2,40
1807907,1394953,2024-02-26,Senate,"Senate: Passed Senate (23-Y 17-N)",23,17,0,0,40
1807908,1373622,2024-01-31,Senate,"Senate: Reported from Courts of Justice with substitute (9-Y 6-N)",9,6,0,0,15
1807908,1378232,2024-02-07,Senate,"Senate: Reported from Finance and Appropriations (10-Y 5-N)",10,5,0,0,15
1807908,1379570,2024-02-08,Senate,"Senate: Constitutional reading dispensed (40-Y 0-N)",40,0,0,0,40
1807908,1383273,2024-02-13,Senate,"Senate: Engrossment reconsidered by Senate (40-Y 0-N)",40,0,0,0,40
1807908,1383274,2024-02-13,Senate,"Senate: Committee substitute reconsidered (40-Y 0-N)",40,0,0,0,40
1807908,1383275,2024-02-13,Senate,"Senate: Constitutional reading dispensed (40-Y 0-N)",40,0,0,0,40
1807908,1383276,2024-02-13,Senate,"Senate: Passed Senate (21-Y 19-N)",21,19,0,0,40
1807908,1386768,2024-02-16,House,"House: Reported from Public Safety with substitute (12-Y 10-N)",12,10,0,0,22
1807908,1390790,2024-02-21,House,"House: VOTE: Passage (52-Y 48-N)",52,48,0,0,100
1807908,1393748,2024-02-23,Senate,"Senate: House substitute rejected by Senate (0-Y 39-N)",0,39,0,1,40
1807908,1398172,2024-02-28,Senate,"Senate: Senate acceded to request (21-Y 18-N)",21,18,0,1,40
1807908,1403992,2024-03-06,Senate,"Senate: Conference report agreed to by Senate (21-Y 19-N)",21,19,0,0,40
1807908,1404565,2024-03-06,House,"House: VOTE: Adoption (51-Y 48-N)",51,48,0,1,100
1807910,1375084,2024-02-02,House,"House: Subcommittee recommends laying on the table (7-Y 1-N)",7,1,0,0,8
1807912,1375837,2024-02-05,House,"House: Subcommittee recommends reporting with substitute (6-Y 4-N)",6,4,0,0,10
1807912,1378428,2024-02-07,House,"House: Reported from Education with substitute (13-Y 9-N)",13,9,0,0,22
1807912,1382972,2024-02-13,House,"House: VOTE: Passage (60-Y 38-N)",60,38,0,2,100
1807912,1399092,2024-02-29,Senate,"Senate: Reported from Education and Health (15-Y 0-N)",15,0,0,0,15
1807912,1400941,2024-03-01,Senate,"Senate: Constitutional reading dispensed (40-Y 0-N)",40,0,0,0,40
1807912,1401609,2024-03-04,Senate,"Senate: Passed Senate (39-Y 0-N)",39,0,0,1,40
1807915,1374863,2024-02-02,House,"House: Subcommittee recommends reporting with substitute (5-Y 3-N)",5,3,0,0,8
1807915,1376964,2024-02-06,House,"House: Reported from Transportation with substitute (12-Y 10-N)",12,10,0,0,22
1807915,1382469,2024-02-12,House,"House: VOTE: Passage (51-Y 49-N)",51,49,0,0,100
1807915,1392385,2024-02-22,Senate,"Senate: Reported from Transportation with amendments (14-Y 0-N 1-A)",14,0,1,0,15
1807915,1395396,2024-02-26,Senate,"Senate: Constitutional reading dispensed (40-Y 0-N)",40,0,0,0,40
1807915,1397060,2024-02-27,Senate,"Senate: Passed Senate with amendments (38-Y 1-N)",38,1,0,1,40
1807915,1399935,2024-02-29,House,"House: VOTE: Adoption (52-Y 48-N)",52,48,0,0,100
1807917,1369390,2024-01-25,House,"House: Subcommittee recommends reporting (5-Y 3-N)",5,3,0,0,8
1807917,1372039,2024-01-30,House,"House: Reported from Labor and Commerce (12-Y 10-N)",12,10,0,0,22
1807918,1367438,2024-01-22,House,"House: Subcommittee recommends reporting (7-Y 0-N)",7,0,0,2,9
1807918,1369804,2024-01-26,House,"House: Reported from Courts of Justice (21-Y 0-N)",21,0,0,1,22
1807918,1373894,2024-02-01,House,"House: VOTE: Block Vote Passage (99-Y 0-N)",99,0,0,1,100
1807918,1385125,2024-02-14,Senate,"Senate: Reported from Courts of Justice (9-Y 0-N)",9,0,0,0,9
1807918,1386760,2024-02-16,Senate,"Senate: Constitutional reading dispensed (38-Y 0-N)",38,0,0,2,40
1807918,1387604,2024-02-19,Senate,"Senate: Passed Senate (39-Y 0-N)",39,0,0,1,40
1807919,1379090,2024-02-08,House,"House: Subcommittee recommends laying on the table (5-Y 2-N)",5,2,0,1,8
1807920,1377539,2024-02-06,House,"House: Subcommittee recommends reporting with amendments (8-Y 0-N)",8,0,0,1,9
1807920,1379937,2024-02-08,House,"House: Reported from General Laws with amendment(s) (19-Y 0-N)",19,0,0,3,22
1807920,1383092,2024-02-13,House,"House: VOTE: Block Vote Passage (99-Y 0-N)",99,0,0,1,100
1807920,1393133,2024-02-23,Senate,"Senate: Reported from Rehabilitation and Social Services (15-Y 0-N)",15,0,0,0,15
1807920,1394553,2024-02-26,Senate,"Senate: Constitutional reading dispensed (40-Y 0-N)",40,0,0,0,40
1807920,1396140,2024-02-27,Senate,"Senate: Passed Senate (39-Y 0-N)",39,0,0,1,40
1807922,1375105,2024-02-02,House,"House: Subcommittee recommends laying on the table (4-Y 3-N)",4,3,0,2,9
1807924,1372785,2024-01-31,House,"House: Subcommittee recommends reporting with substitute (7-Y 1-N)",7,1,0,1,9
1807924,1375668,2024-02-02,House,"House: Reported from Courts of Justice with substitute (20-Y 1-N)",20,1,0,1,22
1807924,1381010,2024-02-09,House,"House: VOTE: Passage (86-Y 9-N)",86,9,0,5,100
1807924,1390394,2024-02-21,Senate,"Senate: Reported from General Laws and Technology with amendment (15-Y 0-N)",15,0,0,0,15
1807924,1393649,2024-02-23,Senate,"Senate: Constitutional reading dispensed (38-Y 0-N)",38,0,0,2,40
1807924,1394824,2024-02-26,Senate,"Senate: Passed Senate with amendment (40-Y 0-N)",40,0,0,0,40
1807924,1398104,2024-02-28,House,"House: VOTE: Adoption (93-Y 5-N)",93,5,0,2,100
1807926,1374325,2024-02-01,House,"House: Subcommittee recommends reporting (3-Y 2-N)",3,2,0,3,8
1807926,1377315,2024-02-06,House,"House: Reported from General Laws (11-Y 9-N)",11,9,0,2,22
1807926,1381690,2024-02-12,House,"House: VOTE: Passage (53-Y 47-N)",53,47,0,0,100
1807926,1398730,2024-02-28,Senate,"Senate: Reported from Courts of Justice (9-Y 6-N)",9,6,0,0,15
1807926,1401053,2024-03-01,Senate,"Senate: Constitutional reading dispensed (40-Y 0-N)",40,0,0,0,40
1807926,1402896,2024-03-05,Senate,"Senate: Passed Senate (21-Y 19-N)",21,19,0,0,40
1807926,1430242,2024-04-17,House,"House: VOTE: Adoption (0-Y 100-N)",0,100,0,0,100
1807928,1376441,2024-02-05,House,"House: Subcommittee recommends reporting with substitute (5-Y 3-N)",5,3,0,0,8
1807928,1378364,2024-02-07,House,"House: Reported from Finance with substitute (13-Y 8-N)",13,8,0,1,22
1807928,1382817,2024-02-13,House,"House: VOTE: Passage (69-Y 28-N)",69,28,0,3,100
1807928,1390046,2024-02-21,Senate,"Senate: Reported from Finance and Appropriations with substitute (11-Y 3-N)",11,3,0,0,14
1807928,1392503,2024-02-22,Senate,"Senate: Constitutional reading dispensed (40-Y 0-N)",40,0,0,0,40
1807928,1393878,2024-02-23,Senate,"Senate: Passed Senate with substitute (27-Y 12-N)",27,12,0,1,40
1807928,1395959,2024-02-27,House,"House: VOTE: Adoption (71-Y 26-N)",71,26,0,3,100
1807929,1371918,2024-01-30,House,"House: Subcommittee recommends reporting with amendments (8-Y 0-N)",8,0,0,0,8
1807929,1375720,2024-02-05,House,"House: Reported from Education with amendment(s) (20-Y 2-N)",20,2,0,0,22
1807929,1382042,2024-02-12,House,"House: VOTE: Passage (81-Y 19-N)",81,19,0,0,100
1807929,1399129,2024-02-29,Senate,"Senate: Continued to 2025 in Education and Health (14-Y 1-N)",14,1,0,0,15
1807931,1368728,2024-01-24,Senate,"Senate: Reported from General Laws and Technology with substitute (15-Y 0-N)",15,0,0,0,15
1807931,1376937,2024-02-06,Senate,"Senate: Reported from Finance and Appropriations with substitute (15-Y 0-N)",15,0,0,0,15
1807931,1378320,2024-02-07,Senate,"Senate: Constitutional reading dispensed (40-Y 0-N)",40,0,0,0,40
1807931,1379362,2024-02-08,Senate,"Senate: Constitutional reading dispensed (40-Y 0-N)",40,0,0,0,40
1807931,1379363,2024-02-08,Senate,"Senate: Read third time and passed Senate (40-Y 0-N)",40,0,0,0,40
1807931,1385446,2024-02-15,House,"House: Reported from General Laws with substitute (22-Y 0-N)",22,0,0,0,22
1807931,1388848,2024-02-20,House,"House: VOTE: Passage (95-Y 1-N)",95,1,0,4,100
1807931,1392031,2024-02-22,Senate,"Senate: House substitute rejected by Senate (0-Y 40-N)",0,40,0,0,40
1807931,1396220,2024-02-27,Senate,"Senate: Senate acceded to request (39-Y 0-N)",39,0,0,1,40
1807931,1400620,2024-03-01,House,"House: VOTE: Adoption (92-Y 4-N)",92,4,0,4,100
1807931,1400621,2024-03-01,Senate,"Senate: Conference report agreed to by Senate (40-Y 0-N)",40,0,0,0,40
1807932,1377093,2024-02-06,House,"House: Subcommittee recommends reporting with substitute (8-Y 0-N)",8,0,0,1,9
1807932,1377668,2024-02-06,House,"House: Reported from General Laws with substitute (20-Y 0-N)",20,0,0,2,22
1807932,1380574,2024-02-09,House,"House: Subcommittee recommends reporting with amendments (7-Y 0-N)",7,0,0,2,9
1807932,1380714,2024-02-09,House,"House: Reported from Appropriations with amendment(s) (20-Y 0-N)",20,0,0,2,22
1807932,1382850,2024-02-13,House,"House: VOTE: Passage (87-Y 12-N)",87,12,0,1,100
1807932,1395850,2024-02-27,Senate,"Senate: Constitutional reading dispensed (39-Y 0-N)",39,0,0,1,40
1807932,1395851,2024-02-27,Senate,"Senate: Reported from Finance and Appropriations with substitute (15-Y 0-N)",15,0,0,0,15
1807932,1398248,2024-02-28,Senate,"Senate: Passed Senate with substitute (39-Y 0-N)",39,0,0,1,40
1807932,1398249,2024-02-28,House,"House: VOTE: REJECTED (1-Y 95-N)",1,95,0,4,100
1807932,1398250,2024-02-28,Senate,"Senate: Senate insisted on substitute (39-Y 0-N)",39,0,0,1,40
1807932,1406218,2024-03-08,Senate,"Senate: Conference report agreed to by Senate (21-Y 19-N)",21,19,0,0,40
1807932,1406219,2024-03-08,House,"House: VOTE: Adoption (86-Y 10-N)",86,10,0,4,100
1807932,1429809,2024-04-17,House,"House: VOTE: Adoption (88-Y 12-N)",88,12,0,0,100
1807932,1429810,2024-04-17,Senate,"Senate: Senate concurred in Governor's recommendation (33-Y 7-N)",33,7,0,0,40
1807933,1366104,2024-01-16,Senate,"Senate: Rereferred from Agriculture, Conservation and Natural Resources (14-Y 0-N)",14,0,0,0,14
1807933,1376001,2024-02-05,Senate,"Senate: Reported from Local Government (10-Y 5-N)",10,5,0,0,15
1807933,1379788,2024-02-08,Senate,"Senate: Reported from Finance and Appropriations with substitute (10-Y 5-N)",10,5,0,0,15
1807933,1380819,2024-02-09,Senate,"Senate: Constitutional reading dispensed (39-Y 0-N)",39,0,0,1,40
1807933,1383812,2024-02-13,Senate,"Senate: Read third time and passed Senate (21-Y 19-N)",21,19,0,0,40
1807933,1390895,2024-02-21,House,"House: Subcommittee recommends reporting (8-Y 1-N)",8,1,0,1,10
1807933,1397365,2024-02-28,House,"House: Reported from Agriculture, Chesapeake and Natural Resources (13-Y 9-N)",13,9,0,0,22
1807933,1401968,2024-03-04,House,"House: Reported from Appropriations (12-Y 10-N)",12,10,0,0,22
1807933,1405232,2024-03-07,House,"House: VOTE: Passage (51-Y 47-N)",51,47,0,2,100
1807935,1377073,2024-02-06,House,"House: Subcommittee recommends reporting with substitute (8-Y 0-N)",8,0,0,1,9
1807935,1377658,2024-02-06,House,"House: Reported from General Laws with substitute (20-Y 0-N)",20,0,0,2,22
1807935,1380549,2024-02-09,House,"House: Subcommittee recommends reporting with amendments (6-Y 1-N)",6,1,0,2,9
1807935,1380709,2024-02-09,House,"House: Reported from Appropriations with amendment(s) (20-Y 0-N)",20,0,0,2,22
1807935,1383136,2024-02-13,House,"House: VOTE: Block Vote Passage (99-Y 0-N)",99,0,0,1,100
1807935,1395132,2024-02-26,Senate,"Senate: Reported from Commerce and Labor with amendments (15-Y 0-N)",15,0,0,0,15
1807935,1395768,2024-02-27,Senate,"Senate: Constitutional reading dispensed (39-Y 0-N)",39,0,0,1,40
1807935,1395769,2024-02-27,Senate,"Senate: Reported from Finance and Appropriations (15-Y 0-N)",15,0,0,0,15
1807935,1398089,2024-02-28,Senate,"Senate: Passed Senate with amendments (37-Y 2-N)",37,2,0,1,40
1807935,1398090,2024-02-28,House,"House: VOTE: Adoption (94-Y 3-N)",94,3,0,3,100
1807935,1430089,2024-04-17,Senate,"Senate: Senate concurred in Governor's recommendation (39-Y 1-N)",39,1,0,0,40
1807935,1430090,2024-04-17,House,"House: VOTE: Adoption (92-Y 1-N)",92,1,0,7,100
1807938,1367487,2024-01-22,House,"House: Subcommittee recommends laying on the table (8-Y 0-N)",8,0,0,1,9
1807939,1374286,2024-02-01,House,"House: Subcommittee recommends reporting with amendments (4-Y 2-N)",4,2,0,2,8
1807939,1377733,2024-02-06,House,"House: Reported from Labor and Commerce with amendment(s) (12-Y 10-N)",12,10,0,0,22
1807939,1382434,2024-02-12,House,"House: VOTE: Passage (51-Y 49-N)",51,49,0,0,100
1807939,1400698,2024-03-01,Senate,"Senate: Reported from Rehabilitation and Social Services with amendment (14-Y 0-N)",14,0,0,0,14
1807939,1401888,2024-03-04,Senate,"Senate: Constitutional reading dispensed (40-Y 0-N)",40,0,0,0,40
1807939,1403238,2024-03-05,Senate,"Senate: Passed Senate with amendment (40-Y 0-N)",40,0,0,0,40
1807939,1404403,2024-03-06,House,"House: VOTE: Adoption (52-Y 47-N)",52,47,0,1,100
1807939,1430336,2024-04-17,House,"House: VOTE: Adoption (55-Y 44-N)",55,44,0,1,100
1807939,1430337,2024-04-17,House,"House: VOTE: Adoption (0-Y 100-N)",0,100,0,0,100
1807939,1430338,2024-04-17,Senate,"Senate: Senate concurred in Governor's recommendations #1 and #2 (40-Y 0-N)",40,0,0,0,40
1807941,1366209,2024-01-16,Senate,"Senate: Reported from Agriculture, Conservation and Natural Resources with amendment (14-Y 0-N)",14,0,0,0,14
1807941,1432114,2024-01-18,Senate,"Senate: Constitutional reading dispensed (40-Y 0-N)",40,0,0,0,40
1807941,1432115,2024-01-22,Senate,"Senate: Read third time and passed Senate (40-Y 0-N)",40,0,0,0,40
1807941,1432116,2024-02-21,House,"House: Subcommittee recommends reporting (10-Y 0-N)",10,0,0,0,10
1807941,1432117,2024-02-21,House,"House: Reported from Agriculture, Chesapeake and Natural Resources (21-Y 1-N)",21,1,0,0,22
1807941,1432235,2024-02-26,House,"House: VOTE: Passage (92-Y 4-N)",92,4,0,4,100
1807944,1367615,2024-01-23,House,"House: Subcommittee recommends reporting (8-Y 0-N)",8,0,0,1,9
1807944,1368492,2024-01-24,House,"House: Reported from Education (21-Y 0-N)",21,0,0,1,22
1807944,1371949,2024-01-30,House,"House: VOTE: Block Vote Passage (100-Y 0-N)",100,0,0,0,100
1807944,1392499,2024-02-22,Senate,"Senate: Reported from Education and Health (15-Y 0-N)",15,0,0,0,15
1807944,1393954,2024-02-23,Senate,"Senate: Constitutional reading dispensed (38-Y 0-N)",38,0,0,2,40
1807944,1394621,2024-02-26,Senate,"Senate: Passed Senate (40-Y 0-N)",40,0,0,0,40
1807946,1368783,2024-01-24,House,"House: Subcommittee recommends reporting with substitute (9-Y 1-N)",9,1,0,0,10
1807946,1372777,2024-01-31,House,"House: Reported from Agriculture, Chesapeake and Natural Resources with substitute (22-Y 0-N)",22,0,0,0,22
1807946,1376923,2024-02-06,House,"House: VOTE: (94-Y 2-N)",94,2,0,4,100
1807946,1388860,2024-02-20,Senate,"Senate: Reported from Agriculture, Conservation and Natural Resources (15-Y 0-N)",15,0,0,0,15
1807946,1392047,2024-02-22,Senate,"Senate: Constitutional reading dispensed (40-Y 0-N)",40,0,0,0,40
1807946,1394068,2024-02-23,Senate,"Senate: Passed Senate (39-Y 0-N)",39,0,0,1,40
1807948,1376802,2024-02-06,House,"House: Subcommittee recommends reporting (6-Y 1-N)",6,1,0,1,8
1807948,1378457,2024-02-07,House,"House: Reported from Education (20-Y 2-N)",20,2,0,0,22
1807948,1383526,2024-02-13,House,"House: VOTE: Passage (92-Y 6-N)",92,6,0,2,100
1807949,1370339,2024-01-29,House,"House: Subcommittee recommends laying on the table (6-Y 0-N)",6,0,0,0,6
1807952,1372047,2024-01-30,House,"House: Subcommittee recommends laying on the table (10-Y 0-N)",10,0,0,0,10
1807954,1367989,2024-01-23,House,"House: Subcommittee recommends laying on the table (5-Y 3-N)",5,3,0,0,8
1807955,1379721,2024-02-08,Senate,"Senate: Incorporated by Education and Health ",15,0,0,0,15
1807956,1369634,2024-01-25,House,"House: Subcommittee recommends reporting with substitute (7-Y 0-N)",7,0,0,1,8
1807956,1372228,2024-01-30,House,"House: Reported from General Laws with substitute (22-Y 0-N)",22,0,0,0,22
1807956,1376012,2024-02-05,House,"House: VOTE: Block Vote Passage (98-Y 0-N)",98,0,0,2,100
1807956,1384574,2024-02-14,Senate,"Senate: Reported from General Laws and Technology (15-Y 0-N)",15,0,0,0,15
1807956,1399474,2024-02-29,Senate,"Senate: Reported from Finance and Appropriations (14-Y 0-N)",14,0,0,0,14
1807956,1401956,2024-03-04,Senate,"Senate: Constitutional reading dispensed (40-Y 0-N)",40,0,0,0,40
1807956,1403254,2024-03-05,Senate,"Senate: Passed Senate (40-Y 0-N)",40,0,0,0,40
1807959,1372027,2024-01-30,House,"House: Subcommittee recommends reporting with substitute (7-Y 0-N)",7,0,0,0,7
1807959,1374247,2024-02-01,House,"House: Reported from Labor and Commerce with substitute (22-Y 0-N)",22,0,0,0,22
1807959,1378611,2024-02-07,House,"House: VOTE: Block Vote Passage (100-Y 0-N)",100,0,0,0,100
1807959,1387562,2024-02-19,Senate,"Senate: Reported from Commerce and Labor (14-Y 0-N)",14,0,0,0,14
1807959,1389807,2024-02-21,Senate,"Senate: Reported from Finance and Appropriations with amendment (14-Y 0-N)",14,0,0,0,14
1807959,1391947,2024-02-22,Senate,"Senate: Constitutional reading dispensed (40-Y 0-N)",40,0,0,0,40
1807959,1393517,2024-02-23,Senate,"Senate: Passed Senate with amendment (39-Y 0-N)",39,0,0,1,40
1807959,1396535,2024-02-27,House,"House: VOTE: REJECTED (0-Y 97-N)",0,97,0,3,100
1807959,1399622,2024-02-29,Senate,"Senate: Senate insisted on amendment (39-Y 0-N)",39,0,0,1,40
1807959,1404447,2024-03-06,House,"House: VOTE: Adoption (97-Y 0-N)",97,0,0,3,100
1807959,1405280,2024-03-07,Senate,"Senate: Conference report agreed to by Senate (40-Y 0-N)",40,0,0,0,40
1807960,1370526,2024-01-29,House,"House: Subcommittee recommends reporting with substitute (5-Y 3-N)",5,3,0,1,9
1807960,1375866,2024-02-02,House,"House: Reported from Courts of Justice with substitute (13-Y 8-N)",13,8,0,1,22
1807960,1379626,2024-02-08,House,"House: VOTE: Passage (55-Y 42-N)",55,42,0,3,100
1807960,1387367,2024-02-19,Senate,"Senate: Reported from Courts of Justice with substitute (8-Y 5-N)",8,5,0,0,13
1807960,1398271,2024-02-28,Senate,"Senate: Reported from Finance and Appropriations with amendment (10-Y 5-N)",10,5,0,0,15
1807960,1399629,2024-02-29,Senate,"Senate: Constitutional reading dispensed (39-Y 0-N)",39,0,0,1,40
1807960,1404237,2024-03-06,Senate,"Senate: Passed Senate with substitute with amendment (23-Y 17-N)",23,17,0,0,40
1807960,1405437,2024-03-07,House,"House: VOTE: Adoption (49-Y 47-N)",49,47,0,4,100
1807961,1371003,2024-01-29,House,"House: Subcommittee recommends reporting (6-Y 0-N)",6,0,0,0,6
1807961,1374309,2024-02-01,House,"House: Reported from Rules (18-Y 0-N)",18,0,0,0,18
1807961,1378801,2024-02-07,House,"House: Subcommittee recommends laying on the table (7-Y 0-N)",7,0,0,2,9
1807961,1380529,2024-02-09,House,"House: Subcommittee recommends reporting with amendments (7-Y 0-N)",7,0,0,2,9
1807961,1380687,2024-02-09,House,"House: Reported from Appropriations with amendment(s) (20-Y 0-N)",20,0,0,2,22
1807961,1382502,2024-02-12,House,"House: VOTE: Block vote adoption (97-Y 0-N)",97,0,0,3,100
1807961,1402287,2024-03-04,Senate,"Senate: Reading waived (40-Y 0-N)",40,0,0,0,40
1807964,1366274,2024-01-17,Senate,"Senate: Reported from Courts of Justice with substitute (15-Y 0-N)",15,0,0,0,15
1807964,1432051,2024-01-19,Senate,"Senate: Constitutional reading dispensed (37-Y 0-N)",37,0,0,3,40
1807964,1432052,2024-01-23,Senate,"Senate: Engrossment reconsidered by Senate (39-Y 0-N)",39,0,0,1,40
1807964,1432053,2024-01-23,Senate,"Senate: Constitutional reading dispensed (39-Y 0-N)",39,0,0,1,40
1807964,1432054,2024-01-23,Senate,"Senate: Passed Senate (38-Y 0-N)",38,0,0,2,40
1807964,1432055,2024-02-14,House,"House: Subcommittee recommends reporting (8-Y 0-N)",8,0,0,1,9
1807966,1368389,2024-01-24,Senate,"Senate: Reported from Finance and Appropriations (9-Y 5-N)",9,5,0,0,14
1807966,1369177,2024-01-25,Senate,"Senate: Constitutional reading dispensed (40-Y 0-N)",40,0,0,0,40
1807966,1371149,2024-01-29,Senate,"Senate: Read third time and passed Senate (21-Y 19-N)",21,19,0,0,40
1807966,1389562,2024-02-20,House,"House: Reported from Labor and Commerce with substitute (12-Y 10-N)",12,10,0,0,22
1807966,1393797,2024-02-23,House,"House: VOTE: Passage (51-Y 46-N)",51,46,0,3,100
1807966,1396807,2024-02-27,Senate,"Senate: House substitute rejected by Senate (1-Y 38-N)",1,38,0,1,40
1807966,1400829,2024-03-01,Senate,"Senate: Senate acceded to request (40-Y 0-N)",40,0,0,0,40
1807966,1406569,2024-03-08,Senate,"Senate: Conference report agreed to by Senate (21-Y 19-N)",21,19,0,0,40
1807966,1406769,2024-03-09,House,"House: VOTE: Adoption (51-Y 47-N)",51,47,0,2,100
1807968,1370707,2024-01-29,House,"House: Subcommittee recommends reporting (7-Y 4-N)",7,4,0,0,11
1807968,1372459,2024-01-31,House,"House: Reported from Education (22-Y 0-N)",22,0,0,0,22
1807968,1377358,2024-02-06,House,"House: VOTE: Block Vote Passage (99-Y 0-N)",99,0,0,1,100
1807968,1385236,2024-02-15,Senate,"Senate: Reported from Education and Health (13-Y 0-N)",13,0,0,0,13
1807968,1386891,2024-02-16,Senate,"Senate: Constitutional reading dispensed (38-Y 0-N)",38,0,0,2,40
1807968,1387954,2024-02-19,Senate,"Senate: Passed Senate (39-Y 0-N)",39,0,0,1,40
1807969,1367164,2024-01-22,House,"House: Subcommittee recommends reporting (7-Y 3-N)",7,3,0,0,10
1807969,1368297,2024-01-24,House,"House: Reported from Education (12-Y 9-N)",12,9,0,1,22
1807969,1377918,2024-02-07,House,"House: Subcommittee recommends reporting with substitute (8-Y 0-N)",8,0,0,1,9
1807969,1378825,2024-02-07,House,"House: Reported from Appropriations with substitute (17-Y 5-N)",17,5,0,0,22
1807969,1383552,2024-02-13,House,"House: VOTE: Passage (59-Y 40-N)",59,40,0,1,100
1807969,1399291,2024-02-29,Senate,"Senate: Reported from Education and Health (14-Y 1-N)",14,1,0,0,15
1807969,1401031,2024-03-01,Senate,"Senate: Constitutional reading dispensed (40-Y 0-N)",40,0,0,0,40
1807969,1402798,2024-03-05,Senate,"Senate: Passed Senate (26-Y 14-N)",26,14,0,0,40
1807970,1367179,2024-01-22,Senate,"Senate: Reported from Local Government (13-Y 2-N)",13,2,0,0,15
1807970,1368353,2024-01-23,Senate,"Senate: Constitutional reading dispensed (39-Y 0-N)",39,0,0,1,40
1807970,1369236,2024-01-25,Senate,"Senate: Read third time and passed Senate (28-Y 12-N)",28,12,0,0,40
1807970,1391291,2024-02-22,House,"House: Subcommittee recommends reporting (5-Y 3-N)",5,3,0,0,8
1807970,1393155,2024-02-23,House,"House: Reported from Counties, Cities and Towns (12-Y 10-N)",12,10,0,0,22
1807970,1398140,2024-02-28,House,"House: VOTE: DEFEATED (52-Y 48-N)",52,48,0,0,100
1807972,1373896,2024-02-01,House,"House: Subcommittee recommends reporting with amendments (6-Y 4-N)",6,4,0,0,10
1807972,1374747,2024-02-02,House,"House: Reported from Public Safety with amendment(s) (12-Y 10-N)",12,10,0,0,22
1807972,1379936,2024-02-08,House,"House: VOTE: Passage (50-Y 47-N)",50,47,0,3,100
1807972,1394252,2024-02-26,Senate,"Senate: Reported from Courts of Justice (9-Y 6-N)",9,6,0,0,15
1807972,1397477,2024-02-28,Senate,"Senate: Reported from Finance and Appropriations with amendment (10-Y 5-N)",10,5,0,0,15
1807972,1399125,2024-02-29,Senate,"Senate: Constitutional reading dispensed (39-Y 0-N)",39,0,0,1,40
1807972,1401702,2024-03-04,Senate,"Senate: Passed Senate with amendment (20-Y 19-N)",20,19,0,1,40
1807972,1402812,2024-03-05,House,"House: VOTE: Adoption (50-Y 49-N)",50,49,0,1,100
1807974,1372049,2024-01-30,House,"House: Subcommittee recommends laying on the table (7-Y 0-N)",7,0,0,0,7
1807976,1364274,2024-01-15,Senate,"Senate: Reported from Courts of Justice with amendments (15-Y 0-N)",15,0,0,0,15
1807976,1368852,2024-01-16,Senate,"Senate: Constitutional reading dispensed (38-Y 0-N)",38,0,0,1,39
1807976,1368853,2024-01-18,Senate,"Senate: Read third time and passed Senate (40-Y 0-N)",40,0,0,0,40
1807976,1386808,2024-02-16,House,"House: Reported from Courts of Justice (12-Y 10-N)",12,10,0,0,22
1807976,1389962,2024-02-21,House,"House: VOTE: Passage (51-Y 49-N)",51,49,0,0,100
1807976,1430320,2024-04-17,Senate,"Senate: Senate concurred in Governor's recommendation (40-Y 0-N)",40,0,0,0,40
1807976,1430321,2024-04-17,House,"House: VOTE: (97-Y 0-N)",97,0,0,3,100
1807979,1374011,2024-02-01,House,"House: Subcommittee recommends reporting (6-Y 4-N)",6,4,0,0,10
1807979,1374764,2024-02-02,House,"House: Reported from Public Safety (12-Y 10-N)",12,10,0,0,22
1807979,1380205,2024-02-08,House,"House: VOTE: Passage (51-Y 46-N)",51,46,0,3,100
1807979,1394257,2024-02-26,Senate,"Senate: Reported from Courts of Justice (9-Y 6-N)",9,6,0,0,15
1807979,1397508,2024-02-28,Senate,"Senate: Reported from Finance and Appropriations with amendment (10-Y 5-N)",10,5,0,0,15
1807979,1399228,2024-02-29,Senate,"Senate: Constitutional reading dispensed (39-Y 0-N)",39,0,0,1,40
1807979,1401638,2024-03-04,Senate,"Senate: Passed Senate with amendment (20-Y 19-N)",20,19,0,1,40
1807979,1402761,2024-03-05,House,"House: VOTE: Adoption (50-Y 49-N)",50,49,0,1,100
1807983,1372060,2024-01-30,House,"House: Subcommittee recommends laying on the table (6-Y 1-N)",6,1,0,0,7
1807984,1368986,2024-01-25,House,"House: Subcommittee recommends reporting (4-Y 2-N)",4,2,0,0,6
1807984,1369679,2024-01-26,House,"House: Reported from Public Safety (12-Y 10-N)",12,10,0,0,22
1807984,1373694,2024-02-01,House,"House: VOTE: Passage (55-Y 45-N)",55,45,0,0,100
1807984,1387275,2024-02-19,Senate,"Senate: Rereferred from Local Government (13-Y 0-N)",13,0,0,0,13
1807984,1398623,2024-02-28,Senate,"Senate: Reported from Courts of Justice (9-Y 6-N)",9,6,0,0,15
1807984,1401252,2024-03-01,Senate,"Senate: Constitutional reading dispensed (40-Y 0-N)",40,0,0,0,40
1807984,1403755,2024-03-05,Senate,"Senate: Passed Senate (21-Y 19-N)",21,19,0,0,40
1807985,1369841,2024-01-26,House,"House: Reported from Rules (17-Y 0-N)",17,0,0,1,18
1807985,1373925,2024-02-01,House,"House: VOTE: Block Vote Passage (99-Y 0-N)",99,0,0,1,100
1807985,1393823,2024-02-23,Senate,"Senate: Reported from Rules (15-Y 0-N)",15,0,0,0,15
1807985,1394566,2024-02-26,Senate,"Senate: Constitutional reading dispensed (40-Y 0-N)",40,0,0,0,40
1807985,1396214,2024-02-27,Senate,"Senate: Passed Senate (39-Y 0-N)",39,0,0,1,40
1807987,1369254,2024-01-25,House,"House: Subcommittee recommends laying on the table (5-Y 3-N)",5,3,0,0,8
1807988,1374186,2024-02-01,House,"House: Subcommittee recommends reporting (4-Y 3-N)",4,3,0,1,8
1807988,1374558,2024-02-01,House,"House: Subcommittee recommends reporting (5-Y 3-N)",5,3,0,0,8
1807988,1377671,2024-02-06,House,"House: Reported from General Laws with substitute (10-Y 9-N)",10,9,0,3,22
1807988,1382136,2024-02-12,House,"House: VOTE: Passage (52-Y 48-N)",52,48,0,0,100
1807988,1390746,2024-02-21,Senate,"Senate: Reported from General Laws and Technology (8-Y 0-N)",8,0,0,0,8
1807988,1393608,2024-02-23,Senate,"Senate: Constitutional reading dispensed (38-Y 0-N)",38,0,0,2,40
1807988,1394385,2024-02-26,Senate,"Senate: Passed Senate (24-Y 16-N)",24,16,0,0,40
1807988,1430207,2024-04-17,House,"House: VOTE: Adoption (52-Y 47-N)",52,47,0,1,100
1807988,1430208,2024-04-17,Senate,"Senate: Senate concurred in Governor's recommendation (40-Y 0-N)",40,0,0,0,40
1807989,1364066,2024-01-11,Senate,"Senate: Rereferred from Education and Health (15-Y 0-N)",15,0,0,0,15
1807989,1366423,2024-01-17,Senate,"Senate: Reported from Courts of Justice with substitute (15-Y 0-N)",15,0,0,0,15
1807989,1368365,2024-01-24,Senate,"Senate: Reported from Finance and Appropriations with amendment (14-Y 0-N)",14,0,0,0,14
1807989,1369174,2024-01-25,Senate,"Senate: Constitutional reading dispensed (40-Y 0-N)",40,0,0,0,40
1807989,1370877,2024-01-29,Senate,"Senate: Read third time and passed Senate (40-Y 0-N)",40,0,0,0,40
1807989,1393257,2024-02-23,House,"House: Subcommittee recommends reporting (6-Y 0-N)",6,0,0,0,6
1807989,1393258,2024-02-23,House,"House: Reported from Rules (16-Y 0-N)",16,0,0,2,18
1807989,1398696,2024-02-28,House,"House: Reported from Appropriations (22-Y 0-N)",22,0,0,0,22
1807989,1402326,2024-03-04,House,"House: VOTE: Block Vote Passage (97-Y 0-N)",97,0,0,3,100
1807990,1369434,2024-01-25,House,"House: Subcommittee recommends reporting (5-Y 3-N)",5,3,0,0,8
1807990,1372088,2024-01-30,House,"House: Reported from Labor and Commerce (12-Y 10-N)",12,10,0,0,22
1807990,1376920,2024-02-06,House,"House: VOTE: Passage (51-Y 47-N)",51,47,0,2,100
1807990,1388324,2024-02-19,Senate,"Senate: Reported from Commerce and Labor with substitute (9-Y 6-N)",9,6,0,0,15
1807990,1389896,2024-02-21,Senate,"Senate: Constitutional reading dispensed (40-Y 0-N)",40,0,0,0,40
1807990,1392153,2024-02-22,Senate,"Senate: Passed Senate with substitute (21-Y 18-N)",21,18,0,1,40
1807990,1394380,2024-02-26,House,"House: VOTE: Adoption (50-Y 46-N)",50,46,0,4,100
1807991,1374439,2024-02-01,House,"House: Subcommittee recommends reporting with substitute (8-Y 0-N)",8,0,0,0,8
1807991,1377204,2024-02-06,House,"House: Reported from Health and Human Services with substitute (22-Y 0-N)",22,0,0,0,22
1807991,1381622,2024-02-12,House,"House: VOTE: Block Vote Passage (100-Y 0-N)",100,0,0,0,100
1807991,1392463,2024-02-22,Senate,"Senate: Reported from Education and Health (13-Y 0-N 1-A)",13,0,1,0,14
1807991,1393934,2024-02-23,Senate,"Senate: Constitutional reading dispensed (38-Y 0-N)",38,0,0,2,40
1807991,1394679,2024-02-26,Senate,"Senate: Passed Senate (40-Y 0-N)",40,0,0,0,40
1807995,1377649,2024-02-06,House,"House: Subcommittee recommends reporting with substitute (8-Y 2-N)",8,2,0,0,10
1807995,1380138,2024-02-08,House,"House: Reported from Labor and Commerce with substitute (19-Y 3-N)",19,3,0,0,22
1807995,1383465,2024-02-13,House,"House: VOTE: Passage (90-Y 7-N)",90,7,0,3,100
1807995,1395203,2024-02-26,Senate,"Senate: Reported from Commerce and Labor with substitute (9-Y 6-N)",9,6,0,0,15
1807995,1398404,2024-02-28,Senate,"Senate: Constitutional reading dispensed (39-Y 0-N)",39,0,0,1,40
1807995,1399235,2024-02-29,Senate,"Senate: Passed Senate with substitute with amendment (21-Y 18-N)",21,18,0,1,40
1807995,1401705,2024-03-04,House,"House: VOTE: Adoption (90-Y 8-N)",90,8,0,2,100
1807995,1430278,2024-04-17,House,"House: VOTE: Adoption (95-Y 5-N)",95,5,0,0,100
1807995,1430279,2024-04-17,Senate,"Senate: Senate concurred in Governor's recommendation (39-Y 1-N)",39,1,0,0,40
1807996,1367731,2024-01-23,House,"House: Subcommittee recommends reporting (8-Y 0-N)",8,0,0,0,8
1807996,1369450,2024-01-25,House,"House: Reported from Transportation (21-Y 0-N)",21,0,0,1,22
1807996,1373334,2024-01-31,House,"House: VOTE: Block Vote Passage (100-Y 0-N)",100,0,0,0,100
1807996,1386534,2024-02-15,Senate,"Senate: Reported from Transportation (15-Y 0-N)",15,0,0,0,15
1807996,1387703,2024-02-19,Senate,"Senate: Constitutional reading dispensed (38-Y 0-N)",38,0,0,2,40
1807996,1388838,2024-02-20,Senate,"Senate: Passed Senate (40-Y 0-N)",40,0,0,0,40
1807998,1371140,2024-01-29,House,"House: Subcommittee recommends reporting with substitute (7-Y 1-N)",7,1,0,0,8
1807998,1374665,2024-02-02,House,"House: Reported from Privileges and Elections with substitute (13-Y 9-N)",13,9,0,0,22
1807998,1379610,2024-02-08,House,"House: VOTE: Passage (53-Y 44-N)",53,44,0,3,100
1808001,1373895,2024-02-01,House,"House: Subcommittee recommends reporting with substitute (6-Y 3-N)",6,3,0,1,10
1808001,1374633,2024-02-02,House,"House: Reported from Public Safety with substitute (12-Y 10-N)",12,10,0,0,22
1808001,1380149,2024-02-08,House,"House: VOTE: Passage (51-Y 46-N)",51,46,0,3,100
1808001,1387335,2024-02-19,Senate,"Senate: Reported from Courts of Justice (7-Y 4-N)",7,4,0,0,11
1808001,1397387,2024-02-28,Senate,"Senate: Reported from Finance and Appropriations (10-Y 5-N)",10,5,0,0,15
1808001,1399678,2024-02-29,Senate,"Senate: Constitutional reading dispensed (39-Y 0-N)",39,0,0,1,40
1808001,1402213,2024-03-04,Senate,"Senate: Defeated by Senate (19-Y 19-N)",19,19,0,2,40
1808001,1402214,2024-03-04,Senate,"Senate: Reconsideration of defeated action agreed to by Senate (39-Y 0-N)",39,0,0,1,40
1808001,1402215,2024-03-04,Senate,"Senate: Passed Senate (20-Y 19-N)",20,19,0,1,40
1808001,1430216,2024-04-17,House,"House: VOTE: Adoption (0-Y 98-N)",0,98,0,2,100
1808003,1372424,2024-01-31,House,"House: Subcommittee recommends laying on the table (10-Y 0-N)",10,0,0,0,10
1808004,1370001,2024-01-26,House,"House: Subcommittee recommends continuing to 2025 (8-Y 0-N)",8,0,0,1,9
1808005,1374331,2024-02-01,House,"House: Reported from Rules (18-Y 0-N)",18,0,0,0,18
1808005,1377757,2024-02-06,House,"House: VOTE: Block Vote Adoption (98-Y 0-N)",98,0,0,2,100
1808005,1395293,2024-02-26,Senate,"Senate: Reading waived (40-Y 0-N)",40,0,0,0,40
1808009,1372423,2024-01-31,House,"House: Subcommittee recommends reporting with amendments (9-Y 1-N)",9,1,0,0,10
1808009,1378420,2024-02-07,House,"House: Reported from Agriculture, Chesapeake and Natural Resources with amendment(s) (20-Y 2-N)",20,2,0,0,22
1808009,1383536,2024-02-13,House,"House: VOTE: Passage (81-Y 16-N)",81,16,0,3,100
1808009,1396718,2024-02-27,Senate,"Senate: Reported from Agriculture, Conservation and Natural Resources (13-Y 1-N)",13,1,0,0,14
1808009,1399675,2024-02-29,Senate,"Senate: Constitutional reading dispensed (39-Y 0-N)",39,0,0,1,40
1808009,1402200,2024-03-04,Senate,"Senate: Passed Senate (39-Y 0-N)",39,0,0,1,40
1808011,1367550,2024-01-22,House,"House: Subcommittee recommends reporting with substitute (8-Y 0-N)",8,0,0,1,9
1808011,1369840,2024-01-26,House,"House: Reported from Courts of Justice with substitute (21-Y 0-N)",21,0,0,1,22
1808011,1373842,2024-02-01,House,"House: VOTE: Block Vote Passage (99-Y 0-N)",99,0,0,1,100
1808011,1387383,2024-02-19,Senate,"Senate: Reported from Courts of Justice (12-Y 0-N)",12,0,0,0,12
1808011,1388474,2024-02-20,Senate,"Senate: Constitutional reading dispensed (39-Y 0-N)",39,0,0,1,40
1808011,1390003,2024-02-21,Senate,"Senate: Passed Senate (40-Y 0-N)",40,0,0,0,40
1808013,1376449,2024-02-05,House,"House: Subcommittee recommends continuing to 2025 (7-Y 0-N)",7,0,0,1,8
1808016,1370323,2024-01-29,House,"House: Subcommittee recommends reporting (5-Y 3-N)",5,3,0,1,9
1808016,1373048,2024-01-31,House,"House: Reported from Finance (13-Y 9-N)",13,9,0,0,22
1808016,1378491,2024-02-07,House,"House: Subcommittee recommends reporting with amendments (7-Y 1-N)",7,1,0,1,9
1808016,1378492,2024-02-07,House,"House: Reported from Appropriations with amendment(s) (14-Y 8-N)",14,8,0,0,22
1808016,1383318,2024-02-13,House,"House: VOTE: Passage (62-Y 37-N)",62,37,0,1,100
1808016,1396186,2024-02-27,Senate,"Senate: Constitutional reading dispensed (39-Y 0-N)",39,0,0,1,40
1808016,1396187,2024-02-27,Senate,"Senate: Reported from Finance and Appropriations with substitute (15-Y 0-N)",15,0,0,0,15
1808016,1398333,2024-02-28,Senate,"Senate: Passed Senate with substitute (39-Y 0-N)",39,0,0,1,40
1808016,1398334,2024-02-28,House,"House: VOTE: REJECTED (0-Y 98-N)",0,98,0,2,100
1808016,1398335,2024-02-28,Senate,"Senate: Senate insisted on substitute (39-Y 0-N)",39,0,0,1,40
1808016,1404770,2024-03-06,House,"House: VOTE: Adoption (78-Y 19-N)",78,19,0,3,100
1808016,1405774,2024-03-07,Senate,"Senate: Conference report agreed to by Senate (38-Y 2-N)",38,2,0,0,40
1808019,1379635,2024-02-08,Senate,"Senate: Continued to 2025 in Education and Health (15-Y 0-N)",15,0,0,0,15
1808023,1368506,2024-01-24,House,"House: Subcommittee recommends striking from docket (7-Y 0-N)",7,0,0,2,9
1808024,1368993,2024-01-25,Senate,"Senate: Reported from Education and Health with amendment (15-Y 0-N)",15,0,0,0,15
1808024,1371523,2024-01-30,Senate,"Senate: Reported from Finance and Appropriations (15-Y 0-N)",15,0,0,0,15
1808024,1372904,2024-01-31,Senate,"Senate: Constitutional reading dispensed (40-Y 0-N)",40,0,0,0,40
1808024,1432236,2024-02-15,House,"House: Reported from Health and Human Services with amendment(s) (21-Y 1-N)",21,1,0,0,22
1808024,1432237,2024-02-20,House,"House: VOTE: Passage (63-Y 36-N)",63,36,0,1,100
1808024,1432238,2024-02-22,Senate,"Senate: House amendment agreed to by Senate (36-Y 2-N)",36,2,0,2,40
1808025,1376581,2024-02-05,Senate,"Senate: Reported from Commerce and Labor with substitute (15-Y 0-N)",15,0,0,0,15
1808025,1379895,2024-02-08,Senate,"Senate: Reported from Finance and Appropriations (15-Y 0-N)",15,0,0,0,15
1808025,1380959,2024-02-09,Senate,"Senate: Constitutional reading dispensed (39-Y 0-N)",39,0,0,1,40
1808025,1381564,2024-02-12,Senate,"Senate: Constitutional reading dispensed (40-Y 0-N)",40,0,0,0,40
1808025,1381565,2024-02-12,Senate,"Senate: Passed Senate (40-Y 0-N)",40,0,0,0,40
1808025,1389530,2024-02-20,House,"House: Reported from Labor and Commerce with substitute (22-Y 0-N)",22,0,0,0,22
1808025,1391055,2024-02-21,House,"House: Reported from Appropriations (22-Y 0-N)",22,0,0,0,22
1808025,1395104,2024-02-26,House,"House: VOTE: Block Vote Passage (96-Y 0-N)",96,0,0,4,100
1808025,1398483,2024-02-28,Senate,"Senate: House substitute agreed to by Senate (39-Y 0-N)",39,0,0,1,40
1808027,1368947,2024-01-24,House,"House: Subcommittee recommends reporting (5-Y 3-N)",5,3,0,0,8
1808027,1371446,2024-01-30,House,"House: Reported from Transportation (12-Y 10-N)",12,10,0,0,22
1808031,1375818,2024-02-05,House,"House: Subcommittee recommends continuing to 2025 (7-Y 0-N)",7,0,0,1,8
1808033,1369896,2024-01-26,Senate,"Senate: Reported from Rules with substitute (11-Y 4-N)",11,4,0,0,15
1808033,1370545,2024-01-29,Senate,"Senate: Constitutional reading dispensed (39-Y 0-N)",39,0,0,1,40
1808033,1372558,2024-01-31,Senate,"Senate: Read third time and passed Senate (21-Y 19-N)",21,19,0,0,40
1808033,1393205,2024-02-23,House,"House: Subcommittee recommends reporting (4-Y 2-N)",4,2,0,0,6
1808033,1393206,2024-02-23,House,"House: Reported from Rules (12-Y 5-N)",12,5,0,1,18
1808033,1398439,2024-02-28,House,"House: Reported from Appropriations with substitute (13-Y 9-N)",13,9,0,0,22
1808033,1401850,2024-03-04,House,"House: VOTE: Passage (52-Y 45-N)",52,45,0,3,100
1808033,1402958,2024-03-05,Senate,"Senate: House substitute agreed to by Senate (21-Y 19-N)",21,19,0,0,40
1808033,1429636,2024-04-17,Senate,"Senate: Passed in enrolled form rejected (21-Y 19-N)",21,19,0,0,40
1808035,1372050,2024-01-30,House,"House: Subcommittee recommends striking from docket (8-Y 0-N)",8,0,0,0,8
1808036,1369345,2024-01-25,House,"House: Subcommittee recommends reporting with amendments (6-Y 2-N)",6,2,0,0,8
1808036,1371486,2024-01-30,House,"House: Reported from Health and Human Services with substitute (22-Y 0-N)",22,0,0,0,22
1808036,1375183,2024-02-02,House,"House: Subcommittee recommends laying on the table (8-Y 0-N)",8,0,0,1,9
1808039,1367698,2024-01-23,House,"House: Subcommittee recommends reporting with substitute (8-Y 0-N)",8,0,0,0,8
1808039,1369443,2024-01-25,House,"House: Reported from Health and Human Services with substitute (22-Y 0-N)",22,0,0,0,22
1808039,1372869,2024-01-31,House,"House: VOTE: Passage (76-Y 23-N)",76,23,0,1,100
1808039,1392419,2024-02-22,Senate,"Senate: Reported from Education and Health with amendment (9-Y 5-N 1-A)",9,5,1,0,15
1808039,1393830,2024-02-23,Senate,"Senate: Constitutional reading dispensed (38-Y 0-N)",38,0,0,2,40
1808039,1395071,2024-02-26,Senate,"Senate: Passed Senate with amendment (21-Y 18-N)",21,18,0,1,40
1808039,1398738,2024-02-28,House,"House: VOTE: Adoption (74-Y 22-N)",74,22,0,4,100
1808039,1430302,2024-04-17,House,"House: VOTE: Adoption (25-Y 74-N)",25,74,0,1,100
1808040,1374868,2024-02-02,House,"House: Subcommittee recommends reporting with substitute (8-Y 0-N)",8,0,0,0,8
1808040,1377245,2024-02-06,House,"House: Reported from Transportation with substitute (21-Y 0-N)",21,0,0,1,22
1808040,1382412,2024-02-12,House,"House: VOTE: Passage (98-Y 2-N)",98,2,0,0,100
1808040,1391869,2024-02-22,Senate,"Senate: Reported from Transportation (12-Y 2-N 1-A)",12,2,1,0,15
1808040,1398200,2024-02-28,Senate,"Senate: Reported from Finance and Appropriations with substitute (15-Y 0-N)",15,0,0,0,15
1808040,1399861,2024-02-29,Senate,"Senate: Constitutional reading dispensed (39-Y 0-N)",39,0,0,1,40
1808040,1402429,2024-03-04,Senate,"Senate: Passed Senate with substitute (37-Y 2-N)",37,2,0,1,40
1808040,1402677,2024-03-05,House,"House: VOTE: Adoption (99-Y 1-N)",99,1,0,0,100
1808041,1364406,2024-01-16,Senate,"Senate: Rereferred from Privileges and Elections (14-Y 0-N)",14,0,0,0,14
1808041,1375705,2024-02-05,Senate,"Senate: Reported from Courts of Justice with substitute (7-Y 6-N 2-A)",7,6,2,0,15
1808041,1379737,2024-02-08,Senate,"Senate: Reported from Finance and Appropriations (10-Y 5-N)",10,5,0,0,15
1808041,1380743,2024-02-09,Senate,"Senate: Constitutional reading dispensed (39-Y 0-N)",39,0,0,1,40
1808041,1383700,2024-02-13,Senate,"Senate: Read third time and passed Senate (21-Y 19-N)",21,19,0,0,40
1808041,1388001,2024-02-19,House,"House: Subcommittee recommends reporting with substitute (6-Y 2-N)",6,2,0,0,8
1808041,1400499,2024-03-01,House,"House: Reported from Privileges and Elections with substitute (14-Y 7-N)",14,7,0,1,22
1808041,1404607,2024-03-06,House,"House: VOTE: Passage (52-Y 47-N)",52,47,0,1,100
1808041,1405469,2024-03-07,Senate,"Senate: House substitute agreed to by Senate (20-Y 19-N)",20,19,0,1,40
1808041,1429527,2024-04-17,Senate,"Senate: Senate concurred in Governor's recommendation (40-Y 0-N)",40,0,0,0,40
1808041,1430303,2024-04-17,House,"House: VOTE: Adoption (52-Y 47-N)",52,47,0,1,100
1808043,1364281,2024-01-15,Senate,"Senate: Reported from Courts of Justice with substitute (15-Y 0-N)",15,0,0,0,15
1808043,1368336,2024-01-24,Senate,"Senate: Reported from Finance and Appropriations with substitute (14-Y 0-N)",14,0,0,0,14
1808043,1369225,2024-01-25,Senate,"Senate: Constitutional reading dispensed (40-Y 0-N)",40,0,0,0,40
1808043,1370281,2024-01-29,Senate,"Senate: Read third time and passed Senate (40-Y 0-N)",40,0,0,0,40
1808043,1390905,2024-02-21,House,"House: Subcommittee recommends reporting (6-Y 4-N)",6,4,0,0,10
1808043,1397385,2024-02-28,House,"House: Reported from Agriculture, Chesapeake and Natural Resources (12-Y 9-N)",12,9,1,0,22
1808043,1402010,2024-03-04,House,"House: Reported from Courts of Justice (19-Y 2-N)",19,2,0,1,22
1808044,1370987,2024-01-29,House,"House: Subcommittee recommends laying on the table (6-Y 0-N)",6,0,0,0,6
1808047,1369038,2024-01-25,House,"House: Subcommittee recommends reporting (6-Y 0-N)",6,0,0,0,6
1808047,1369966,2024-01-26,House,"House: Reported from Public Safety (22-Y 0-N)",22,0,0,0,22
1808047,1373846,2024-02-01,House,"House: VOTE: Block Vote Passage (99-Y 0-N)",99,0,0,1,100
1808047,1384496,2024-02-14,Senate,"Senate: Reported from General Laws and Technology (15-Y 0-N)",15,0,0,0,15
1808047,1386933,2024-02-16,Senate,"Senate: Constitutional reading dispensed (38-Y 0-N)",38,0,0,2,40
1808047,1387939,2024-02-19,Senate,"Senate: Passed Senate (39-Y 0-N)",39,0,0,1,40
1808047,1430316,2024-04-17,House,"House: VOTE: (100-Y 0-N)",100,0,0,0,100
1808047,1430317,2024-04-17,Senate,"Senate: Senate concurred in Governor's recommendation (40-Y 0-N)",40,0,0,0,40
1808048,1374782,2024-02-02,House,"House: Subcommittee recommends reporting with amendments (8-Y 0-N)",8,0,0,0,8
1808048,1377364,2024-02-06,House,"House: Reported from Transportation with amendment(s) (22-Y 0-N)",22,0,0,0,22
1808048,1382485,2024-02-12,House,"House: VOTE: Block Vote Passage (100-Y 0-N)",100,0,0,0,100
1808048,1392889,2024-02-22,Senate,"Senate: Reported from Transportation (15-Y 0-N)",15,0,0,0,15
1808048,1394437,2024-02-26,Senate,"Senate: Constitutional reading dispensed (40-Y 0-N)",40,0,0,0,40
1808048,1395741,2024-02-27,Senate,"Senate: Passed Senate (39-Y 0-N)",39,0,0,1,40
1808050,1368659,2024-01-24,House,"House: Subcommittee recommends reporting with substitute (7-Y 0-N)",7,0,0,2,9
1808050,1369808,2024-01-26,House,"House: Reported from Courts of Justice with substitute (21-Y 0-N)",21,0,0,1,22
1808050,1373864,2024-02-01,House,"House: VOTE: Block Vote Passage (99-Y 0-N)",99,0,0,1,100
1808050,1384789,2024-02-14,Senate,"Senate: Reported from Courts of Justice with amendments (15-Y 0-N)",15,0,0,0,15
1808050,1387105,2024-02-16,Senate,"Senate: Constitutional reading dispensed (38-Y 0-N)",38,0,0,2,40
1808050,1388084,2024-02-19,Senate,"Senate: Passed Senate (39-Y 0-N)",39,0,0,1,40
1808050,1390981,2024-02-21,House,"House: VOTE: Adoption (99-Y 0-N)",99,0,0,1,100
1808052,1380637,2024-02-09,House,"House: Reported from Counties, Cities and Towns with substitute (12-Y 9-N)",12,9,0,1,22
1808052,1383189,2024-02-13,House,"House: VOTE: Passage (56-Y 43-N)",56,43,0,1,100
1808052,1398607,2024-02-28,Senate,"Senate: Reported from General Laws and Technology (11-Y 4-N)",11,4,0,0,15
1808052,1400746,2024-03-01,Senate,"Senate: Constitutional reading dispensed (40-Y 0-N)",40,0,0,0,40
1808052,1403250,2024-03-05,Senate,"Senate: Passed Senate (40-Y 0-N)",40,0,0,0,40
1808052,1430205,2024-04-17,House,"House: VOTE: Adoption (0-Y 100-N)",0,100,0,0,100
1808053,1367767,2024-01-23,House,"House: Subcommittee recommends reporting (8-Y 0-N)",8,0,0,0,8
1808053,1368700,2024-01-24,House,"House: Reported from Finance (21-Y 0-N)",21,0,0,1,22
1808053,1371813,2024-01-30,House,"House: VOTE: Block Vote Passage (100-Y 0-N)",100,0,0,0,100
1808053,1395837,2024-02-27,Senate,"Senate: Passed by indefinitely in Finance and Appropriations (15-Y 0-N)",15,0,0,0,15
1808054,1379439,2024-02-08,House,"House: Subcommittee recommends reporting with substitute (5-Y 3-N)",5,3,0,0,8
1808054,1380365,2024-02-08,House,"House: Reported from Labor and Commerce with substitute (12-Y 10-N)",12,10,0,0,22
1808054,1383432,2024-02-13,House,"House: VOTE: Passage (51-Y 48-N)",51,48,0,1,100
1808054,1394613,2024-02-26,Senate,"Senate: Reported from Local Government (8-Y 7-N)",8,7,0,0,15
1808054,1399434,2024-02-29,Senate,"Senate: Continued to 2025 in Finance and Appropriations (14-Y 0-N)",14,0,0,0,14
1808055,1367223,2024-01-22,House,"House: Subcommittee recommends reporting (8-Y 2-N)",8,2,0,0,10
1808055,1368225,2024-01-24,House,"House: Reported from Education (21-Y 0-N)",21,0,0,1,22
1808055,1371572,2024-01-30,House,"House: VOTE: Block Vote Passage (100-Y 0-N)",100,0,0,0,100
1808055,1391433,2024-02-22,Senate,"Senate: Reported from Education and Health (13-Y 0-N 1-A)",13,0,1,0,14
1808055,1393821,2024-02-23,Senate,"Senate: Constitutional reading dispensed (38-Y 0-N)",38,0,0,2,40
1808055,1395022,2024-02-26,Senate,"Senate: Passed Senate (40-Y 0-N)",40,0,0,0,40
1808056,1368955,2024-01-24,House,"House: Subcommittee recommends striking from docket (8-Y 0-N)",8,0,0,1,9
1808056,1371191,2024-01-29,House,"House: Stricken from docket by Appropriations (21-Y 0-N)",21,0,0,1,22
1808059,1372426,2024-01-31,House,"House: Subcommittee recommends reporting with substitute (6-Y 4-N)",6,4,0,0,10
1808059,1378178,2024-02-07,House,"House: Reported from Agriculture, Chesapeake and Natural Resources with substitute (12-Y 10-N)",12,10,0,0,22
1808059,1381001,2024-02-09,House,"House: Subcommittee recommends laying on the table (8-Y 0-N)",8,0,0,1,9
1808060,1375742,2024-02-05,House,"House: Subcommittee recommends reporting with substitute (7-Y 2-N)",7,2,1,0,10
1808060,1378454,2024-02-07,House,"House: Reported from Education with substitute (13-Y 9-N)",13,9,0,0,22
1808060,1382913,2024-02-13,House,"House: VOTE: Passage (56-Y 43-N)",56,43,0,1,100
1808060,1391470,2024-02-22,Senate,"Senate: Reported from Education and Health (14-Y 0-N)",14,0,0,0,14
1808060,1393700,2024-02-23,Senate,"Senate: Constitutional reading dispensed (38-Y 0-N)",38,0,0,2,40
1808060,1395763,2024-02-27,Senate,"Senate: Passed Senate (39-Y 0-N)",39,0,0,1,40
1808061,1375617,2024-02-05,House,"House: Subcommittee recommends reporting with substitute (10-Y 0-N)",10,0,0,0,10
1808061,1378735,2024-02-07,House,"House: Reported from Education with substitute (22-Y 0-N)",22,0,0,0,22
1808061,1383235,2024-02-13,House,"House: VOTE: Block Vote Passage (99-Y 0-N)",99,0,0,1,100
1808061,1399886,2024-02-29,Senate,"Senate: Reported from Education and Health (15-Y 0-N)",15,0,0,0,15
1808061,1401084,2024-03-01,Senate,"Senate: Constitutional reading dispensed (40-Y 0-N)",40,0,0,0,40
1808061,1402318,2024-03-04,Senate,"Senate: Passed Senate (39-Y 0-N)",39,0,0,1,40
1808061,1430307,2024-04-17,House,"House: VOTE: Adoption (49-Y 50-N)",49,50,0,1,100
1808063,1378212,2024-02-07,House,"House: Reported from Education with substitute (18-Y 4-N)",18,4,0,0,22
1808063,1383697,2024-02-13,House,"House: VOTE: Passage (89-Y 9-N)",89,9,0,2,100
1808063,1399130,2024-02-29,Senate,"Senate: Reported from Education and Health with substitute (15-Y 0-N)",15,0,0,0,15
1808063,1400970,2024-03-01,Senate,"Senate: Constitutional reading dispensed (40-Y 0-N)",40,0,0,0,40
1808063,1401607,2024-03-04,Senate,"Senate: Passed Senate (39-Y 0-N)",39,0,0,1,40
1808063,1402718,2024-03-05,House,"House: VOTE: REJECTED (3-Y 97-N)",3,97,0,0,100
1808063,1404047,2024-03-06,Senate,"Senate: Senate insisted on substitute (40-Y 0-N)",40,0,0,0,40
1808063,1406216,2024-03-08,Senate,"Senate: Conference report agreed to by Senate (39-Y 1-N)",39,1,0,0,40
1808063,1406217,2024-03-08,House,"House: VOTE: Adoption (94-Y 4-N)",94,4,0,2,100
1808066,1374298,2024-02-01,House,"House: Subcommittee recommends reporting with amendments (8-Y 0-N)",8,0,0,1,9
1808066,1377101,2024-02-06,House,"House: Reported from Health and Human Services with amendment(s) (22-Y 0-N)",22,0,0,0,22
1808066,1378634,2024-02-07,House,"House: Subcommittee recommends reporting with substitute (7-Y 0-N)",7,0,0,2,9
1808066,1380945,2024-02-09,House,"House: Reported from Appropriations with substitute (20-Y 0-N)",20,0,0,2,22
1808066,1382966,2024-02-13,House,"House: VOTE: Block Vote Passage (99-Y 0-N)",99,0,0,1,100
1808066,1391328,2024-02-22,Senate,"Senate: Reported from Education and Health with substitute (15-Y 0-N)",15,0,0,0,15
1808066,1395773,2024-02-27,Senate,"Senate: Constitutional reading dispensed (39-Y 0-N)",39,0,0,1,40
1808066,1395774,2024-02-27,Senate,"Senate: Reported from Finance and Appropriations with amendment (15-Y 0-N)",15,0,0,0,15
1808066,1397966,2024-02-28,Senate,"Senate: Passed Senate with substitute with amendment (39-Y 0-N)",39,0,0,1,40
1808066,1400712,2024-03-01,House,"House: VOTE: REJECTED (2-Y 95-N)",2,95,0,3,100
1808066,1403256,2024-03-05,Senate,"Senate: Senate insisted on substitute with amendment (40-Y 0-N)",40,0,0,0,40
1808066,1405263,2024-03-07,House,"House: VOTE: Adoption (96-Y 0-N)",96,0,0,4,100
1808066,1406114,2024-03-08,Senate,"Senate: Conference report agreed to by Senate (40-Y 0-N)",40,0,0,0,40
1808069,1378760,2024-02-07,Senate,"Senate: Reported from Courts of Justice (10-Y 5-N)",10,5,0,0,15
1808069,1380154,2024-02-08,Senate,"Senate: Constitutional reading dispensed (40-Y 0-N)",40,0,0,0,40
1808069,1382286,2024-02-12,Senate,"Senate: Read third time and passed Senate (40-Y 0-N)",40,0,0,0,40
1808069,1386814,2024-02-16,House,"House: Subcommittee recommends reporting with amendments (5-Y 3-N)",5,3,0,1,9
1808069,1394013,2024-02-23,House,"House: Reported from Courts of Justice with amendment(s) (11-Y 10-N)",11,10,0,1,22
1808069,1398401,2024-02-28,House,"House: VOTE: Passage (71-Y 28-N)",71,28,0,1,100
1808069,1401136,2024-03-01,Senate,"Senate: House amendments agreed to by Senate (40-Y 0-N)",40,0,0,0,40
1808070,1376248,2024-02-05,House,"House: Subcommittee recommends striking from docket (8-Y 0-N)",8,0,0,1,9
1808071,1371937,2024-01-30,Senate,"Senate: Reported from Agriculture, Conservation and Natural Resources (15-Y 0-N)",15,0,0,0,15
1808071,1377682,2024-02-06,Senate,"Senate: Reported from Finance and Appropriations (13-Y 0-N 1-A)",13,0,1,0,14
1808071,1377962,2024-02-07,Senate,"Senate: Constitutional reading dispensed (40-Y 0-N)",40,0,0,0,40
1808071,1381040,2024-02-09,Senate,"Senate: Read third time and passed Senate (38-Y 0-N 1-A)",38,0,1,1,40
1808071,1381041,2024-02-09,Senate,"Senate: Reconsideration of passage agreed to by Senate (38-Y 0-N 1-A)",38,0,1,1,40
1808071,1381042,2024-02-09,Senate,"Senate: Passed Senate (39-Y 0-N 1-A)",39,0,1,0,40
1808071,1394491,2024-02-26,House,"House: Subcommittee recommends reporting (8-Y 2-N)",8,2,0,0,10
1808071,1398260,2024-02-28,House,"House: Reported from Agriculture, Chesapeake and Natural Resources (17-Y 5-N)",17,5,0,0,22
1808071,1402133,2024-03-04,House,"House: VOTE: Passage (71-Y 26-N)",71,26,0,3,100
1808072,1374143,2024-02-01,House,"House: Subcommittee recommends reporting with substitute (5-Y 3-N)",5,3,0,0,8
1808072,1377666,2024-02-06,House,"House: Reported from General Laws with substitute (10-Y 9-N)",10,9,0,3,22
1808072,1381885,2024-02-12,House,"House: VOTE: Passage (52-Y 48-N)",52,48,0,0,100
1808072,1398575,2024-02-28,Senate,"Senate: Reported from General Laws and Technology (9-Y 6-N)",9,6,0,0,15
1808072,1400687,2024-03-01,Senate,"Senate: Constitutional reading dispensed (40-Y 0-N)",40,0,0,0,40
1808072,1403125,2024-03-05,Senate,"Senate: Passed Senate (21-Y 19-N)",21,19,0,0,40
1808072,1430137,2024-04-17,House,"House: VOTE: Adoption (0-Y 99-N)",0,99,0,1,100
1808076,1370965,2024-01-29,Senate,"Senate: Reported from Commerce and Labor with substitute (9-Y 6-N)",9,6,0,0,15
1808077,1372061,2024-01-30,House,"House: Subcommittee recommends striking from docket (8-Y 0-N)",8,0,0,1,9
1808078,1379424,2024-02-08,House,"House: Subcommittee recommends laying on the table (4-Y 2-N)",4,2,0,0,6
1808079,1380520,2024-02-09,House,"House: Reported from Privileges and Elections with substitute (22-Y 0-N)",22,0,0,0,22
1808079,1383069,2024-02-13,House,"House: VOTE: Passage (88-Y 10-N)",88,10,0,2,100
1808079,1388538,2024-02-20,Senate,"Senate: Reported from Privileges and Elections (12-Y 3-N)",12,3,0,0,15
1808079,1392701,2024-02-22,Senate,"Senate: Constitutional reading dispensed (40-Y 0-N)",40,0,0,0,40
1808079,1394021,2024-02-23,Senate,"Senate: Passed Senate (27-Y 12-N)",27,12,0,1,40
1808080,1369544,2024-01-25,House,"House: Subcommittee recommends laying on the table (6-Y 4-N)",6,4,0,0,10
1808082,1377216,2024-02-06,House,"House: Subcommittee recommends reporting with substitute (7-Y 0-N)",7,0,0,1,8
1808082,1379345,2024-02-08,House,"House: Reported from Health and Human Services with substitute (22-Y 0-N)",22,0,0,0,22
1808082,1383917,2024-02-13,House,"House: VOTE: Block Vote Passage (99-Y 0-N)",99,0,0,1,100
1808082,1399512,2024-02-29,Senate,"Senate: Reported from Education and Health with substitute (15-Y 0-N)",15,0,0,0,15
1808082,1400857,2024-03-01,Senate,"Senate: Constitutional reading dispensed (40-Y 0-N)",40,0,0,0,40
1808082,1402340,2024-03-04,Senate,"Senate: Passed Senate with substitute (39-Y 0-N)",39,0,0,1,40
1808082,1403634,2024-03-05,House,"House: VOTE: Adoption (99-Y 0-N)",99,0,0,1,100
1808085,1374067,2024-02-01,House,"House: Reported from Rules (16-Y 0-N)",16,0,0,2,18
1808085,1377278,2024-02-06,House,"House: VOTE: Block Vote Adoption (98-Y 0-N)",98,0,0,2,100
1808085,1395346,2024-02-26,Senate,"Senate: Reading waived (40-Y 0-N)",40,0,0,0,40
1808088,1371774,2024-01-30,House,"House: Subcommittee recommends striking from docket (8-Y 0-N)",8,0,0,1,9
1808088,1373917,2024-02-01,House,"House: Stricken from docket by General Laws (22-Y 0-N)",22,0,0,0,22
1808089,1372429,2024-01-31,House,"House: Subcommittee recommends reporting (9-Y 1-N)",9,1,0,0,10
1808089,1378263,2024-02-07,House,"House: Reported from Agriculture, Chesapeake and Natural Resources (17-Y 5-N)",17,5,0,0,22
1808089,1383522,2024-02-13,House,"House: VOTE: Passage (78-Y 21-N)",78,21,0,1,100
1808089,1396733,2024-02-27,Senate,"Senate: Reported from Agriculture, Conservation and Natural Resources (10-Y 4-N)",10,4,0,0,14
1808089,1399710,2024-02-29,Senate,"Senate: Constitutional reading dispensed (39-Y 0-N)",39,0,0,1,40
1808089,1402220,2024-03-04,Senate,"Senate: Passed Senate (23-Y 14-N)",23,14,0,3,40
1808090,1369491,2024-01-25,House,"House: Subcommittee recommends reporting with amendments (8-Y 0-N)",8,0,0,0,8
1808090,1372238,2024-01-30,House,"House: Reported from General Laws with amendment(s) (22-Y 0-N)",22,0,0,0,22
1808090,1376622,2024-02-05,House,"House: VOTE: Block Vote Passage (98-Y 0-N)",98,0,0,2,100
1808090,1384457,2024-02-14,Senate,"Senate: Reported from General Laws and Technology with amendment (15-Y 0-N)",15,0,0,0,15
1808090,1386896,2024-02-16,Senate,"Senate: Constitutional reading dispensed (38-Y 0-N)",38,0,0,2,40
1808090,1387995,2024-02-19,Senate,"Senate: Passed Senate (39-Y 0-N)",39,0,0,1,40
1808090,1390942,2024-02-21,House,"House: VOTE: Adoption (99-Y 0-N)",99,0,0,1,100
1808091,1373193,2024-01-31,House,"House: Subcommittee recommends reporting with substitute (7-Y 1-N)",7,1,0,0,8
1808091,1377524,2024-02-06,House,"House: Reported from Transportation with substitute (22-Y 0-N)",22,0,0,0,22
1808092,1368544,2024-01-24,House,"House: Subcommittee recommends laying on the table (4-Y 3-N)",4,3,0,2,9
1808098,1373933,2024-02-01,Senate,"Senate: Reported from Education and Health with substitute (15-Y 0-N)",15,0,0,0,15
1808098,1376856,2024-02-06,Senate,"Senate: Read third time and passed Senate (39-Y 0-N)",39,0,0,1,40
1808099,1369349,2024-01-25,House,"House: Stricken from docket by General Laws (21-Y 0-N)",21,0,0,1,22
1808102,1375627,2024-02-05,Senate,"Senate: Reported from Courts of Justice (15-Y 0-N)",15,0,0,0,15
1808102,1376897,2024-02-06,Senate,"Senate: Constitutional reading dispensed (39-Y 0-N)",39,0,0,1,40
1808102,1378042,2024-02-07,Senate,"Senate: Constitutional reading dispensed (40-Y 0-N)",40,0,0,0,40
1808102,1378043,2024-02-07,Senate,"Senate: Passed Senate (40-Y 0-N)",40,0,0,0,40
1808102,1386809,2024-02-16,House,"House: Reported from Courts of Justice (22-Y 0-N)",22,0,0,0,22
1808102,1389970,2024-02-21,House,"House: VOTE: Block Vote Passage (100-Y 0-N)",100,0,0,0,100
1808103,1369723,2024-01-25,Senate,"Senate: Reported from Transportation (15-Y 0-N)",15,0,0,0,15
1808103,1370407,2024-01-29,Senate,"Senate: Constitutional reading dispensed (39-Y 0-N)",39,0,0,1,40
1808103,1372695,2024-01-31,Senate,"Senate: Read third time and passed Senate (40-Y 0-N)",40,0,0,0,40
1808103,1391516,2024-02-22,House,"House: Reported from Transportation (22-Y 0-N)",22,0,0,0,22
1808103,1401127,2024-03-01,House,"House: VOTE: Passage (97-Y 0-N)",97,0,0,3,100
1808105,1371485,2024-01-30,House,"House: Referred from Transportation (21-Y 0-N)",21,0,0,1,22
1808107,1370585,2024-01-29,Senate,"Senate: Reported from Courts of Justice with amendments (9-Y 6-N)",9,6,0,0,15
1808107,1371789,2024-01-30,Senate,"Senate: Constitutional reading dispensed (40-Y 0-N)",40,0,0,0,40
1808107,1374173,2024-02-01,Senate,"Senate: Read third time and passed Senate (21-Y 19-N)",21,19,0,0,40
1808107,1386788,2024-02-16,House,"House: Reported from Public Safety (12-Y 10-N)",12,10,0,0,22
1808107,1390534,2024-02-21,House,"House: VOTE: Passage (51-Y 49-N)",51,49,0,0,100
1808107,1430113,2024-04-17,Senate,"Senate: Passed in enrolled form rejected (21-Y 19-N)",21,19,0,0,40
1808109,1372056,2024-01-30,House,"House: Reported from Labor and Commerce (12-Y 10-N)",12,10,0,0,22
1808109,1375596,2024-02-05,House,"House: Subcommittee recommends reporting with substitute (6-Y 2-N)",6,2,0,1,9
1808109,1375783,2024-02-05,House,"House: Reported from Appropriations with substitute (14-Y 7-N)",14,7,0,1,22
1808109,1380787,2024-02-09,House,"House: VOTE: Passage (65-Y 31-N)",65,31,0,4,100
1808109,1387593,2024-02-19,Senate,"Senate: Reported from Commerce and Labor with substitute (9-Y 6-N)",9,6,0,0,15
1808109,1389821,2024-02-21,Senate,"Senate: Reported from Finance and Appropriations (11-Y 3-N)",11,3,0,0,14
1808109,1391772,2024-02-22,Senate,"Senate: Constitutional reading dispensed (40-Y 0-N)",40,0,0,0,40
1808109,1393435,2024-02-23,Senate,"Senate: Passed Senate with substitute (23-Y 16-N)",23,16,0,1,40
1808109,1397805,2024-02-28,House,"House: VOTE: Adoption (57-Y 43-N)",57,43,0,0,100
1808109,1430227,2024-04-17,House,"House: VOTE: Adoption (15-Y 84-N)",15,84,0,1,100
1808114,1374005,2024-02-01,House,"House: Subcommittee recommends reporting with amendments (6-Y 3-N)",6,3,0,2,11
1808114,1374911,2024-02-02,House,"House: Reported from Public Safety with amendment(s) (12-Y 10-N)",12,10,0,0,22
1808114,1378161,2024-02-07,House,"House: Subcommittee recommends reporting (5-Y 3-N)",5,3,0,1,9
1808114,1378975,2024-02-07,House,"House: Reported from Appropriations (13-Y 9-N)",13,9,0,0,22
1808114,1383315,2024-02-13,House,"House: VOTE: Passage (52-Y 47-N)",52,47,0,1,100
1808114,1395119,2024-02-26,Senate,"Senate: Reported from Courts of Justice (9-Y 5-N)",9,5,0,0,14
1808114,1398228,2024-02-28,Senate,"Senate: Reported from Finance and Appropriations (10-Y 5-N)",10,5,0,0,15
1808114,1399893,2024-02-29,Senate,"Senate: Constitutional reading dispensed (39-Y 0-N)",39,0,0,1,40
1808114,1402313,2024-03-04,Senate,"Senate: Passed Senate (20-Y 19-N)",20,19,0,1,40
1808115,1377732,2024-02-06,House,"House: Subcommittee recommends reporting with amendments (5-Y 2-N)",5,2,0,0,7
1808115,1380063,2024-02-08,House,"House: Reported from Labor and Commerce with amendment(s) (13-Y 9-N)",13,9,0,0,22
1808115,1383937,2024-02-13,House,"House: VOTE: Passage (59-Y 39-N)",59,39,0,2,100
1808115,1401842,2024-03-04,Senate,"Senate: Reported from Commerce and Labor with amendment (14-Y 0-N)",14,0,0,0,14
1808115,1403149,2024-03-05,Senate,"Senate: Constitutional reading dispensed (40-Y 0-N)",40,0,0,0,40
1808115,1404763,2024-03-06,Senate,"Senate: Passed Senate with amendment",40,0,0,0,40
1808115,1405751,2024-03-07,House,"House: VOTE: Adoption (56-Y 43-N)",56,43,0,1,100
1808116,1374668,2024-02-02,House,"House: Reported from Privileges and Elections (12-Y 10-N)",12,10,0,0,22
1808116,1376335,2024-02-05,House,"House: Subcommittee recommends laying on the table (8-Y 0-N)",8,0,0,1,9
1808117,1370363,2024-01-29,House,"House: Subcommittee recommends reporting (6-Y 0-N)",6,0,0,0,6
1808117,1373724,2024-02-01,House,"House: Reported from Rules (18-Y 0-N)",18,0,0,0,18
1808122,1372801,2024-01-31,House,"House: Subcommittee recommends striking from docket (8-Y 0-N)",8,0,0,1,9
1808124,1367366,2024-01-22,Senate,"Senate: Incorporated by Courts of Justice ",15,0,0,0,15
1808126,1376987,2024-02-06,House,"House: Subcommittee recommends laying on the table (6-Y 2-N)",6,2,0,0,8
1808127,1367562,2024-01-22,House,"House: Subcommittee recommends reporting (8-Y 0-N)",8,0,0,1,9
1808127,1370004,2024-01-26,House,"House: Reported from Courts of Justice (21-Y 0-N)",21,0,0,1,22
1808127,1370724,2024-01-29,House,"House: Subcommittee recommends reporting (7-Y 0-N)",7,0,0,2,9
1808127,1373414,2024-01-31,House,"House: Reported from Appropriations (22-Y 0-N)",22,0,0,0,22
1808127,1377210,2024-02-06,House,"House: VOTE: Block Vote Passage (99-Y 0-N)",99,0,0,1,100
1808127,1387353,2024-02-19,Senate,"Senate: Reported from Courts of Justice (13-Y 1-N)",13,1,0,0,14
1808127,1396486,2024-02-27,Senate,"Senate: Constitutional reading dispensed (39-Y 0-N)",39,0,0,1,40
1808127,1396487,2024-02-27,Senate,"Senate: Reported from Finance and Appropriations (12-Y 3-N)",12,3,0,0,15
1808127,1397761,2024-02-28,Senate,"Senate: Passed Senate (34-Y 5-N)",34,5,0,1,40
1808130,1374407,2024-02-01,House,"House: Subcommittee recommends reporting with amendments (5-Y 3-N)",5,3,0,0,8
1808130,1377570,2024-02-06,House,"House: Reported from General Laws with amendment(s) (10-Y 9-N)",10,9,0,3,22
1808130,1382422,2024-02-12,House,"House: VOTE: Passage (51-Y 49-N)",51,49,0,0,100
1808130,1390401,2024-02-21,Senate,"Senate: Reported from General Laws and Technology with substitute (9-Y 6-N)",9,6,0,0,15
1808130,1393653,2024-02-23,Senate,"Senate: Constitutional reading dispensed (38-Y 0-N)",38,0,0,2,40
1808130,1395215,2024-02-26,Senate,"Senate: Passed Senate with substitute (22-Y 18-N)",22,18,0,0,40
1808130,1398555,2024-02-28,House,"House: VOTE: Adoption (51-Y 49-N)",51,49,0,0,100
1808130,1429826,2024-04-17,House,"House: VOTE: Adoption (0-Y 100-N)",0,100,0,0,100
1808131,1367774,2024-01-23,House,"House: Subcommittee recommends laying on the table (4-Y 3-N)",4,3,1,1,9
1808132,1368032,2024-01-23,House,"House: Subcommittee recommends laying on the table (5-Y 2-N)",5,2,0,1,8
1808136,1367586,2024-01-22,House,"House: Subcommittee recommends laying on the table (5-Y 3-N)",5,3,0,1,9
1808138,1374041,2024-02-01,Senate,"Senate: Reported from Education and Health with substitute (15-Y 0-N)",15,0,0,0,15
1808138,1381281,2024-02-12,Senate,"Senate: Reported from Finance and Appropriations with substitute (15-Y 0-N)",15,0,0,0,15
1808138,1381998,2024-02-12,Senate,"Senate: Constitutional reading dispensed (40-Y 0-N)",40,0,0,0,40
1808138,1383709,2024-02-13,Senate,"Senate: Constitutional reading dispensed (39-Y 0-N)",39,0,0,1,40
1808138,1383710,2024-02-13,Senate,"Senate: Passed Senate (40-Y 0-N)",40,0,0,0,40
1808138,1393181,2024-02-23,House,"House: Subcommittee recommends reporting (6-Y 0-N)",6,0,0,0,6
1808138,1393182,2024-02-23,House,"House: Reported from Rules (16-Y 0-N)",16,0,0,2,18
1808139,1369296,2024-01-25,House,"House: Subcommittee recommends reporting (7-Y 0-N)",7,0,0,1,8
1808139,1372231,2024-01-30,House,"House: Reported from General Laws (22-Y 0-N)",22,0,0,0,22
1808139,1376928,2024-02-06,House,"House: VOTE: Passage (98-Y 0-N)",98,0,0,2,100
1808139,1384459,2024-02-14,Senate,"Senate: Reported from General Laws and Technology (15-Y 0-N)",15,0,0,0,15
1808139,1386633,2024-02-16,Senate,"Senate: Constitutional reading dispensed (38-Y 0-N)",38,0,0,2,40
1808139,1387434,2024-02-19,Senate,"Senate: Passed Senate (39-Y 0-N)",39,0,0,1,40
1808143,1369256,2024-01-25,House,"House: Subcommittee recommends reporting with amendments (8-Y 0-N)",8,0,0,0,8
1808143,1371454,2024-01-30,House,"House: Reported from Health and Human Services with amendment(s) (22-Y 0-N)",22,0,0,0,22
1808143,1380575,2024-02-09,House,"House: Subcommittee recommends reporting (7-Y 0-N)",7,0,0,2,9
1808143,1380678,2024-02-09,House,"House: Reported from Appropriations (20-Y 0-N)",20,0,0,2,22
1808143,1383027,2024-02-13,House,"House: VOTE: Block Vote Passage (99-Y 0-N)",99,0,0,1,100
1808143,1393301,2024-02-23,Senate,"Senate: Reported from Rehabilitation and Social Services (15-Y 0-N)",15,0,0,0,15
1808143,1396146,2024-02-27,Senate,"Senate: Continued to 2025 in Finance and Appropriations (15-Y 0-N)",15,0,0,0,15
1808144,1374328,2024-02-01,House,"House: Reported from Rules (18-Y 0-N)",18,0,0,0,18
1808144,1377561,2024-02-06,House,"House: VOTE: Block Vote Adoption (98-Y 0-N)",98,0,0,2,100
1808144,1395029,2024-02-26,Senate,"Senate: Reading waived (40-Y 0-N)",40,0,0,0,40
1808146,1367333,2024-01-22,House,"House: Subcommittee recommends reporting (6-Y 2-N)",6,2,0,1,9
1808146,1370012,2024-01-26,House,"House: Reported from Courts of Justice (11-Y 10-N)",11,10,0,1,22
1808146,1373637,2024-02-01,House,"House: VOTE: Passage (62-Y 37-N)",62,37,0,1,100
1808146,1385017,2024-02-14,Senate,"Senate: Continued to 2025 in Courts of Justice (8-Y 7-N)",8,7,0,0,15
1808147,1369021,2024-01-25,House,"House: Subcommittee recommends reporting (8-Y 0-N)",8,0,0,0,8
1808147,1371501,2024-01-30,House,"House: Reported from Health and Human Services (22-Y 0-N)",22,0,0,0,22
1808147,1375894,2024-02-05,House,"House: VOTE: Block Vote Passage (98-Y 0-N)",98,0,0,2,100
1808147,1391507,2024-02-22,Senate,"Senate: Reported from Education and Health (15-Y 0-N)",15,0,0,0,15
1808147,1394001,2024-02-23,Senate,"Senate: Constitutional reading dispensed (38-Y 0-N)",38,0,0,2,40
1808147,1394711,2024-02-26,Senate,"Senate: Passed Senate (40-Y 0-N)",40,0,0,0,40
1808151,1377595,2024-02-06,House,"House: Subcommittee recommends laying on the table (5-Y 3-N)",5,3,0,0,8
1808152,1375328,2024-02-02,House,"House: Subcommittee recommends reporting with substitute (5-Y 3-N)",5,3,0,1,9
1808152,1378857,2024-02-07,House,"House: Reported from Courts of Justice with substitute (12-Y 10-N)",12,10,0,0,22
1808152,1380712,2024-02-09,House,"House: Subcommittee recommends reporting (4-Y 3-N)",4,3,0,2,9
1808152,1380713,2024-02-09,House,"House: Reported from Appropriations (11-Y 9-N)",11,9,0,2,22
1808152,1382920,2024-02-13,House,"House: VOTE: Passage (50-Y 46-N)",50,46,0,4,100
1808152,1391072,2024-02-21,Senate,"Senate: Reported from Courts of Justice with amendment (9-Y 6-N)",9,6,0,0,15
1808152,1396153,2024-02-27,Senate,"Senate: Constitutional reading dispensed (39-Y 0-N)",39,0,0,1,40
1808152,1396154,2024-02-27,Senate,"Senate: Reported from Finance and Appropriations (11-Y 4-N)",11,4,0,0,15
1808152,1398710,2024-02-28,Senate,"Senate: Passed Senate with amendment (21-Y 18-N)",21,18,0,1,40
1808152,1400588,2024-03-01,House,"House: VOTE: Adoption (49-Y 46-N)",49,46,0,5,100
1808153,1371475,2024-01-30,House,"House: Subcommittee recommends reporting (8-Y 0-N)",8,0,0,0,8
1808153,1374958,2024-02-02,House,"House: Reported from Privileges and Elections (22-Y 0-N)",22,0,0,0,22
1808153,1378348,2024-02-07,House,"House: VOTE: Adoption (99-Y 0-N)",99,0,0,1,100
1808153,1388837,2024-02-20,Senate,"Senate: Reported from Privileges and Elections (14-Y 0-N)",14,0,0,0,14
1808153,1396161,2024-02-27,Senate,"Senate: Reported from Finance and Appropriations (15-Y 0-N)",15,0,0,0,15
1808153,1398589,2024-02-28,Senate,"Senate: Agreed to by Senate (39-Y 0-N)",39,0,0,1,40
1808157,1370934,2024-01-29,House,"House: Subcommittee recommends reporting with amendments (6-Y 2-N)",6,2,0,1,9
1808157,1375568,2024-02-02,House,"House: Reported from Courts of Justice with amendment(s) (12-Y 9-N)",12,9,0,1,22
1808159,1369388,2024-01-25,House,"House: Subcommittee recommends reporting with amendments (5-Y 3-N)",5,3,0,0,8
1808159,1372064,2024-01-30,House,"House: Reported from Labor and Commerce with amendment(s) (14-Y 8-N)",14,8,0,0,22
1808159,1377048,2024-02-06,House,"House: VOTE: Passage (54-Y 45-N)",54,45,0,1,100
1808159,1395182,2024-02-26,Senate,"Senate: Reported from Commerce and Labor (9-Y 6-N)",9,6,0,0,15
1808159,1398238,2024-02-28,Senate,"Senate: Constitutional reading dispensed (39-Y 0-N)",39,0,0,1,40
1808159,1399071,2024-02-29,Senate,"Senate: Passed Senate (20-Y 19-N)",20,19,0,1,40
1808162,1371431,2024-01-30,House,"House: Subcommittee recommends reporting with amendments (7-Y 1-N)",7,1,0,0,8
1808162,1372983,2024-01-31,House,"House: Reported from Education with amendment(s) (17-Y 5-N)",17,5,0,0,22
1808162,1377252,2024-02-06,House,"House: VOTE: Passage (88-Y 11-N)",88,11,0,1,100
1808162,1392457,2024-02-22,Senate,"Senate: Reported from Education and Health (14-Y 1-N)",14,1,0,0,15
1808162,1393930,2024-02-23,Senate,"Senate: Constitutional reading dispensed (38-Y 0-N)",38,0,0,2,40
1808162,1395309,2024-02-26,Senate,"Senate: Passed Senate (39-Y 1-N)",39,1,0,0,40
1808163,1378717,2024-02-07,House,"House: Subcommittee recommends striking from docket (8-Y 0-N)",8,0,0,0,8
1808164,1373598,2024-02-01,House,"House: Subcommittee recommends reporting (8-Y 0-N)",8,0,0,0,8
1808164,1374886,2024-02-02,House,"House: Reported from Counties, Cities and Towns (22-Y 0-N)",22,0,0,0,22
1808164,1379700,2024-02-08,House,"House: VOTE: Block Vote Passage (98-Y 0-N)",98,0,0,2,100
1808164,1394624,2024-02-26,Senate,"Senate: Continued to 2025 in Local Government (12-Y 3-N)",12,3,0,0,15
1808168,1367831,2024-01-23,Senate,"Senate: Reported from Privileges and Elections with amendments (13-Y 1-N)",13,1,0,0,14
1808168,1372696,2024-01-31,Senate,"Senate: Reported from Finance and Appropriations (15-Y 0-N)",15,0,0,0,15
1808168,1374109,2024-02-01,Senate,"Senate: Constitutional reading dispensed (40-Y 0-N)",40,0,0,0,40
1808168,1377541,2024-02-06,Senate,"Senate: Read third time and passed Senate (35-Y 4-N)",35,4,0,1,40
1808168,1393542,2024-02-23,House,"House: Reported from Privileges and Elections (22-Y 0-N)",22,0,0,0,22
1808169,1370636,2024-01-29,House,"House: Subcommittee recommends reporting with amendments (10-Y 0-N)",10,0,0,0,10
1808169,1372451,2024-01-31,House,"House: Reported from Education with amendment(s) (22-Y 0-N)",22,0,0,0,22
1808169,1378235,2024-02-07,House,"House: Subcommittee recommends laying on the table (6-Y 2-N)",6,2,0,1,9
1808170,1371147,2024-01-29,House,"House: Subcommittee recommends reporting (8-Y 0-N)",8,0,0,0,8
1808170,1374640,2024-02-02,House,"House: Reported from Privileges and Elections (22-Y 0-N)",22,0,0,0,22
1808170,1379784,2024-02-08,House,"House: VOTE: Block Vote Passage (98-Y 0-N)",98,0,0,2,100
1808170,1388889,2024-02-20,Senate,"Senate: Reported from Privileges and Elections (15-Y 0-N)",15,0,0,0,15
1808170,1392218,2024-02-22,Senate,"Senate: Constitutional reading dispensed (40-Y 0-N)",40,0,0,0,40
1808170,1393777,2024-02-23,Senate,"Senate: Passed Senate (39-Y 0-N)",39,0,0,1,40
1808171,1369484,2024-01-25,House,"House: Reported from Health and Human Services with substitute (22-Y 0-N)",22,0,0,0,22
1808171,1375175,2024-02-02,House,"House: Subcommittee recommends laying on the table (8-Y 0-N)",8,0,0,1,9
1808173,1373808,2024-02-01,House,"House: Subcommittee failed to recommend reporting (3-Y 5-N)",3,5,0,0,8
1808175,1368891,2024-01-24,Senate,"Senate: Reported from General Laws and Technology (14-Y 1-N)",14,1,0,0,15
1808175,1377111,2024-02-06,Senate,"Senate: Incorporated by Finance and Appropriations ",15,0,0,0,15
1808180,1376028,2024-02-05,House,"House: Subcommittee recommends reporting with amendments (8-Y 0-N)",8,0,0,1,9
1808180,1380525,2024-02-09,House,"House: Reported from Privileges and Elections with amendment(s) (22-Y 0-N)",22,0,0,0,22
1808180,1383532,2024-02-13,House,"House: VOTE: Passage (88-Y 11-N)",88,11,0,1,100
1808180,1388519,2024-02-20,Senate,"Senate: Reported from Privileges and Elections (15-Y 0-N)",15,0,0,0,15
1808180,1395835,2024-02-27,Senate,"Senate: Constitutional reading dispensed (39-Y 0-N)",39,0,0,1,40
1808180,1395836,2024-02-27,Senate,"Senate: Reported from Finance and Appropriations (15-Y 0-N)",15,0,0,0,15
1808180,1398208,2024-02-28,Senate,"Senate: Passed Senate (39-Y 0-N)",39,0,0,1,40
1808181,1373134,2024-01-31,House,"House: Subcommittee recommends reporting (5-Y 3-N)",5,3,0,1,9
1808181,1380848,2024-02-09,House,"House: Reported from Courts of Justice with amendment(s) (12-Y 10-N)",12,10,0,0,22
1808181,1383533,2024-02-13,House,"House: VOTE: Passage (55-Y 42-N)",55,42,0,3,100
1808181,1398855,2024-02-28,Senate,"Senate: Reported from Courts of Justice with amendment (11-Y 0-N 4-A)",11,0,4,0,15
1808181,1401038,2024-03-01,Senate,"Senate: Constitutional reading dispensed (40-Y 0-N)",40,0,0,0,40
1808181,1402809,2024-03-05,Senate,"Senate: Passed Senate with amendment (39-Y 1-N)",39,1,0,0,40
1808181,1404129,2024-03-06,House,"House: VOTE: Adoption (55-Y 42-N 1-A)",55,42,1,2,100
1808181,1404130,2024-03-06,House,"House: VOTE: Adoption #2 (57-Y 40-N)",57,40,0,3,100
1808182,1364286,2024-01-10,House,"House: VOTE: Adoption (100-Y 0-N)",100,0,0,0,100
1808183,1364270,2024-01-15,Senate,"Senate: Reported from Local Government with amendment (12-Y 1-N)",12,1,0,0,13
1808183,1432118,2024-01-16,Senate,"Senate: Constitutional reading dispensed (38-Y 0-N)",38,0,0,1,39
1808183,1432119,2024-01-18,Senate,"Senate: Read third time and passed Senate (40-Y 0-N)",40,0,0,0,40
1808183,1432120,2024-02-22,House,"House: Subcommittee recommends reporting (8-Y 0-N)",8,0,0,0,8
1808183,1432121,2024-02-23,House,"House: Reported from Counties, Cities and Towns (22-Y 0-N)",22,0,0,0,22
1808183,1432122,2024-02-28,House,"House: VOTE: Block Vote Passage (97-Y 0-N)",97,0,0,3,100
1808185,1366351,2024-01-17,Senate,"Senate: Rereferred from General Laws and Technology (15-Y 0-N)",15,0,0,0,15
1808185,1369682,2024-01-25,Senate,"Senate: Continued to 2025 in Transportation (15-Y 0-N)",15,0,0,0,15
1808187,1369140,2024-01-25,House,"House: Subcommittee recommends reporting with substitute (8-Y 0-N)",8,0,0,1,9
1808187,1370015,2024-01-26,House,"House: Reported from Counties, Cities and Towns with substitute (20-Y 0-N)",20,0,0,2,22
1808187,1374222,2024-02-01,House,"House: VOTE: Block Vote Passage (99-Y 0-N)",99,0,0,1,100
1808187,1387270,2024-02-19,Senate,"Senate: Reported from Local Government (15-Y 0-N)",15,0,0,0,15
1808187,1389088,2024-02-20,Senate,"Senate: Constitutional reading dispensed (39-Y 0-N)",39,0,0,1,40
1808187,1390011,2024-02-21,Senate,"Senate: Passed Senate (40-Y 0-N)",40,0,0,0,40
1808191,1367914,2024-01-23,House,"House: Subcommittee recommends reporting with substitute (8-Y 0-N)",8,0,0,1,9
1808191,1368746,2024-01-24,House,"House: Reported from Education with substitute (21-Y 0-N)",21,0,0,1,22
1808191,1376174,2024-02-05,House,"House: Subcommittee recommends reporting with amendments (8-Y 0-N)",8,0,0,1,9
1808191,1378744,2024-02-07,House,"House: Reported from Appropriations with amendment(s) (22-Y 0-N)",22,0,0,0,22
1808191,1383044,2024-02-13,House,"House: VOTE: Block Vote Passage (99-Y 0-N)",99,0,0,1,100
1808191,1399139,2024-02-29,Senate,"Senate: Reported from Education and Health with substitute (15-Y 0-N)",15,0,0,0,15
1808191,1400968,2024-03-01,Senate,"Senate: Constitutional reading dispensed (40-Y 0-N)",40,0,0,0,40
1808191,1401594,2024-03-04,Senate,"Senate: Passed Senate (39-Y 0-N)",39,0,0,1,40
1808191,1404095,2024-03-06,House,"House: VOTE: Adoption (97-Y 1-N)",97,1,0,2,100
1808193,1370658,2024-01-29,House,"House: Subcommittee recommends reporting with substitute (5-Y 3-N)",5,3,0,1,9
1808193,1375793,2024-02-02,House,"House: Reported from Courts of Justice with substitute (12-Y 9-N)",12,9,0,1,22
1808193,1379695,2024-02-08,House,"House: VOTE: Passage (51-Y 47-N)",51,47,0,2,100
1808193,1398652,2024-02-28,Senate,"Senate: Reported from Courts of Justice with amendments (9-Y 2-N 4-A)",9,2,4,0,15
1808193,1401069,2024-03-01,Senate,"Senate: Constitutional reading dispensed (40-Y 0-N)",40,0,0,0,40
1808193,1403275,2024-03-05,Senate,"Senate: Passed Senate with amendments (21-Y 19-N)",21,19,0,0,40
1808193,1404155,2024-03-06,House,"House: VOTE: REJECTED (0-Y 99-N)",0,99,0,1,100
1808193,1405827,2024-03-07,Senate,"Senate: Senate insisted on amendments (40-Y 0-N)",40,0,0,0,40
1808193,1406758,2024-03-09,House,"House: VOTE: Adoption (51-Y 47-N)",51,47,0,2,100
1808193,1406759,2024-03-09,Senate,"Senate: Conference report agreed to by Senate (21-Y 19-N)",21,19,0,0,40
1808195,1366611,2024-01-18,Senate,"Senate: Reported from Education and Health (15-Y 0-N)",15,0,0,0,15
1808195,1373110,2024-01-31,Senate,"Senate: Continued to 2025 in Finance and Appropriations (12-Y 3-N)",12,3,0,0,15
1808197,1367991,2024-01-23,House,"House: Reported from Health and Human Services with amendment(s) (21-Y 1-N)",21,1,0,0,22
1808197,1375180,2024-02-02,House,"House: Subcommittee recommends laying on the table (8-Y 0-N)",8,0,0,1,9
1808199,1366486,2024-01-18,Senate,"Senate: Reported from Education and Health (15-Y 0-N)",15,0,0,0,15
1808199,1373034,2024-01-31,Senate,"Senate: Reported from Finance and Appropriations with amendment (11-Y 3-N)",11,3,0,0,14
1808199,1374066,2024-02-01,Senate,"Senate: Constitutional reading dispensed (40-Y 0-N)",40,0,0,0,40
1808199,1376607,2024-02-05,Senate,"Senate: Read third time and passed Senate (40-Y 0-N)",40,0,0,0,40
1808199,1386263,2024-02-15,House,"House: Subcommittee recommends reporting (7-Y 0-N)",7,0,0,1,8
1808199,1388427,2024-02-20,House,"House: Reported from Health and Human Services (22-Y 0-N)",22,0,0,0,22
1808199,1395334,2024-02-26,House,"House: Tabled in Appropriations (22-Y 0-N)",22,0,0,0,22
1808200,1372769,2024-01-31,House,"House: Subcommittee recommends reporting with amendments (10-Y 0-N)",10,0,0,0,10
1808200,1378580,2024-02-07,House,"House: Reported from Agriculture, Chesapeake and Natural Resources with amendment(s) (22-Y 0-N)",22,0,0,0,22
1808200,1380674,2024-02-09,House,"House: Subcommittee recommends reporting (8-Y 0-N)",8,0,0,1,9
1808200,1380675,2024-02-09,House,"House: Reported from Appropriations (20-Y 0-N)",20,0,0,2,22
1808200,1383210,2024-02-13,House,"House: VOTE: Block Vote Passage (99-Y 0-N)",99,0,0,1,100
1808200,1386608,2024-02-16,Senate,"Senate: Reported from Agriculture, Conservation and Natural Resources (11-Y 0-N)",11,0,0,0,11
1808200,1398114,2024-02-28,Senate,"Senate: Reported from Finance and Appropriations (13-Y 0-N)",13,0,0,0,13
1808200,1399365,2024-02-29,Senate,"Senate: Constitutional reading dispensed (39-Y 0-N)",39,0,0,1,40
1808200,1400671,2024-03-01,Senate,"Senate: Passed Senate (40-Y 0-N)",40,0,0,0,40
1808201,1370341,2024-01-29,Senate,"Senate: Continued to 2025 in Local Government (8-Y 7-N)",8,7,0,0,15
1808203,1371527,2024-01-30,House,"House: Reported from Health and Human Services with substitute (22-Y 0-N)",22,0,0,0,22
1808203,1374804,2024-02-02,House,"House: Subcommittee recommends reporting (8-Y 0-N)",8,0,0,1,9
1808203,1375741,2024-02-05,House,"House: Reported from Appropriations (21-Y 0-N)",21,0,0,1,22
1808203,1380855,2024-02-09,House,"House: VOTE: Block Vote Passage (96-Y 0-N)",96,0,0,4,100
1808203,1393524,2024-02-23,Senate,"Senate: Reported from Rules (15-Y 0-N)",15,0,0,0,15
1808203,1399361,2024-02-29,Senate,"Senate: Reported from Finance and Appropriations (14-Y 0-N)",14,0,0,0,14
1808203,1401964,2024-03-04,Senate,"Senate: Constitutional reading dispensed (40-Y 0-N)",40,0,0,0,40
1808203,1403048,2024-03-05,Senate,"Senate: Passed Senate (40-Y 0-N)",40,0,0,0,40
1808210,1369025,2024-01-25,House,"House: Subcommittee recommends reporting (6-Y 2-N)",6,2,0,0,8
1808210,1371504,2024-01-30,House,"House: Reported from Health and Human Services (15-Y 7-N)",15,7,0,0,22
1808210,1376077,2024-02-05,House,"House: VOTE: Passage (71-Y 26-N)",71,26,0,3,100
1808210,1391474,2024-02-22,Senate,"Senate: Reported from Education and Health (15-Y 0-N)",15,0,0,0,15
1808210,1393992,2024-02-23,Senate,"Senate: Constitutional reading dispensed (38-Y 0-N)",38,0,0,2,40
1808210,1394689,2024-02-26,Senate,"Senate: Passed Senate (36-Y 4-N)",36,4,0,0,40
1808213,1372076,2024-01-30,House,"House: Subcommittee recommends striking from docket (8-Y 0-N)",8,0,0,0,8
1808219,1369704,2024-01-26,Senate,"Senate: Stricken at request of Patron in Rehabilitation and Social Services (10-Y 0-N)",10,0,0,0,10
1808221,1368553,2024-01-24,House,"House: Subcommittee recommends reporting (8-Y 0-N)",8,0,0,1,9
1808221,1369987,2024-01-26,House,"House: Reported from Courts of Justice (21-Y 0-N)",21,0,0,1,22
1808221,1374240,2024-02-01,House,"House: VOTE: Block Vote Passage (99-Y 0-N)",99,0,0,1,100
1808221,1384757,2024-02-14,Senate,"Senate: Reported from Courts of Justice (9-Y 0-N)",9,0,0,0,9
1808221,1387088,2024-02-16,Senate,"Senate: Constitutional reading dispensed (38-Y 0-N)",38,0,0,2,40
1808221,1388023,2024-02-19,Senate,"Senate: Passed Senate (39-Y 0-N)",39,0,0,1,40
1808222,1367165,2024-01-22,House,"House: Reported from Education (16-Y 5-N)",16,5,0,1,22
1808222,1370781,2024-01-29,House,"House: VOTE: Passage (80-Y 18-N)",80,18,0,2,100
1808222,1385362,2024-02-15,Senate,"Senate: Reported from Education and Health with substitute (14-Y 1-N)",14,1,0,0,15
1808222,1386642,2024-02-16,Senate,"Senate: Constitutional reading dispensed (38-Y 0-N)",38,0,0,2,40
1808222,1387742,2024-02-19,Senate,"Senate: Passed Senate with substitute (37-Y 2-N)",37,2,0,1,40
1808222,1390503,2024-02-21,House,"House: VOTE: Adoption (79-Y 20-N)",79,20,0,1,100
1808224,1371681,2024-01-30,Senate,"Senate: Reported from Privileges and Elections with substitute (8-Y 7-N)",8,7,0,0,15
1808224,1378321,2024-02-07,Senate,"Senate: Reported from Finance and Appropriations (10-Y 5-N)",10,5,0,0,15
1808224,1379839,2024-02-08,Senate,"Senate: Constitutional reading dispensed (40-Y 0-N)",40,0,0,0,40
1808224,1381497,2024-02-12,Senate,"Senate: Read third time and passed Senate (21-Y 19-N)",21,19,0,0,40
1808225,1372090,2024-01-30,House,"House: Subcommittee recommends laying on the table (7-Y 0-N)",7,0,0,1,8
1808229,1366893,2024-01-19,Senate,"Senate: Reported from Rehabilitation and Social Services (13-Y 0-N 2-A)",13,0,2,0,15
1808229,1372779,2024-01-31,Senate,"Senate: Continued to 2025 in Finance and Appropriations (15-Y 0-N)",15,0,0,0,15
1808232,1367242,2024-01-22,House,"House: Subcommittee recommends reporting (7-Y 0-N)",7,0,0,2,9
1808232,1369885,2024-01-26,House,"House: Reported from Courts of Justice (20-Y 0-N)",20,0,0,2,22
1808232,1377720,2024-02-06,House,"House: Subcommittee recommends reporting (7-Y 0-N)",7,0,0,0,7
1808232,1380125,2024-02-08,House,"House: Reported from Labor and Commerce (22-Y 0-N)",22,0,0,0,22
1808232,1383540,2024-02-13,House,"House: VOTE: Block Vote Passage (99-Y 0-N)",99,0,0,1,100
1808232,1398741,2024-02-28,Senate,"Senate: Reported from Courts of Justice (15-Y 0-N)",15,0,0,0,15
1808232,1401095,2024-03-01,Senate,"Senate: Constitutional reading dispensed (40-Y 0-N)",40,0,0,0,40
1808232,1401977,2024-03-04,Senate,"Senate: Passed Senate (39-Y 0-N)",39,0,0,1,40
1808233,1379453,2024-02-08,House,"House: Subcommittee recommends reporting with amendments (8-Y 0-N)",8,0,0,0,8
1808233,1380431,2024-02-08,House,"House: Reported from General Laws with amendment(s) (20-Y 0-N)",20,0,0,2,22
1808233,1383915,2024-02-13,House,"House: VOTE: Block Vote Passage (99-Y 0-N)",99,0,0,1,100
1808233,1390970,2024-02-21,Senate,"Senate: Reported from General Laws and Technology with amendments (15-Y 0-N)",15,0,0,0,15
1808233,1394060,2024-02-23,Senate,"Senate: Constitutional reading dispensed (38-Y 0-N)",38,0,0,2,40
1808233,1395328,2024-02-26,Senate,"Senate: Passed Senate with amendments (40-Y 0-N)",40,0,0,0,40
1808233,1398655,2024-02-28,House,"House: VOTE: Adoption (90-Y 5-N)",90,5,0,5,100
1808233,1429784,2024-04-17,House,"House: VOTE: (100-Y 0-N)",100,0,0,0,100
1808233,1429785,2024-04-17,Senate,"Senate: Senate concurred in Governor's recommendation (40-Y 0-N)",40,0,0,0,40
1808236,1366493,2024-01-18,House,"House: Subcommittee recommends laying on the table (6-Y 0-N)",6,0,0,0,6
1808237,1375626,2024-02-05,House,"House: Subcommittee recommends reporting (7-Y 1-N)",7,1,0,1,9
1808237,1378539,2024-02-07,House,"House: Reported from Finance (21-Y 0-N)",21,0,0,1,22
1808237,1382862,2024-02-13,House,"House: VOTE: Block Vote Passage (99-Y 0-N)",99,0,0,1,100
1808237,1390278,2024-02-21,Senate,"Senate: Reported from Finance and Appropriations (14-Y 0-N)",14,0,0,0,14
1808237,1391962,2024-02-22,Senate,"Senate: Constitutional reading dispensed (40-Y 0-N)",40,0,0,0,40
1808237,1393621,2024-02-23,Senate,"Senate: Passed Senate (39-Y 0-N)",39,0,0,1,40
1808238,1371097,2024-01-29,House,"House: Subcommittee recommends reporting with substitute (5-Y 3-N)",5,3,0,0,8
1808238,1374674,2024-02-02,House,"House: Reported from Privileges and Elections with substitute (12-Y 10-N)",12,10,0,0,22
1808238,1379553,2024-02-08,House,"House: VOTE: Passage (51-Y 47-N)",51,47,0,2,100
1808238,1396568,2024-02-27,Senate,"Senate: Reported from Privileges and Elections with substitute (8-Y 7-N)",8,7,0,0,15
1808238,1399642,2024-02-29,Senate,"Senate: Constitutional reading dispensed (39-Y 0-N)",39,0,0,1,40
1808238,1402205,2024-03-04,Senate,"Senate: Passed Senate with substitute (20-Y 19-N)",20,19,0,1,40
1808238,1402673,2024-03-05,House,"House: VOTE: Adoption (51-Y 49-N)",51,49,0,0,100
1808241,1377412,2024-02-06,House,"House: Subcommittee recommends reporting with substitute (6-Y 2-N)",6,2,0,0,8
1808241,1378349,2024-02-07,House,"House: Reported from Education with substitute (12-Y 10-N)",12,10,0,0,22
1808241,1382771,2024-02-13,House,"House: VOTE: Passage (42-Y 55-N)",42,55,0,3,100
1808243,1371197,2024-01-29,House,"House: Subcommittee recommends reporting (7-Y 0-N)",7,0,0,2,9
1808243,1372782,2024-01-31,House,"House: Reported from Appropriations (22-Y 0-N)",22,0,0,0,22
1808243,1377169,2024-02-06,House,"House: VOTE: Block Vote Passage (99-Y 0-N)",99,0,0,1,100
1808243,1390234,2024-02-21,Senate,"Senate: Reported from Finance and Appropriations with substitute (14-Y 0-N)",14,0,0,0,14
1808243,1391919,2024-02-22,Senate,"Senate: Constitutional reading dispensed (40-Y 0-N)",40,0,0,0,40
1808243,1393623,2024-02-23,Senate,"Senate: Passed Senate with substitute (39-Y 0-N)",39,0,0,1,40
1808243,1395958,2024-02-27,House,"House: VOTE: REJECTED (0-Y 97-N)",0,97,0,3,100
1808243,1399335,2024-02-29,Senate,"Senate: Senate insisted on substitute (39-Y 0-N)",39,0,0,1,40
1808243,1404318,2024-03-06,House,"House: VOTE: Adoption (98-Y 0-N)",98,0,0,2,100
1808243,1406764,2024-03-09,Senate,"Senate: Conference report agreed to by Senate (40-Y 0-N)",40,0,0,0,40
1808244,1369333,2024-01-25,House,"House: Subcommittee recommends reporting with substitute (8-Y 0-N)",8,0,0,0,8
1808244,1372079,2024-01-30,House,"House: Reported from Labor and Commerce with substitute (20-Y 2-N)",20,2,0,0,22
1808244,1377330,2024-02-06,House,"House: VOTE: Passage (89-Y 10-N)",89,10,0,1,100
1808244,1395123,2024-02-26,Senate,"Senate: Reported from Commerce and Labor with substitute (15-Y 0-N)",15,0,0,0,15
1808244,1398163,2024-02-28,Senate,"Senate: Constitutional reading dispensed (39-Y 0-N)",39,0,0,1,40
1808244,1399758,2024-02-29,Senate,"Senate: Passed Senate with substitute (39-Y 0-N)",39,0,0,1,40
1808244,1401534,2024-03-04,House,"House: VOTE: Adoption (90-Y 7-N)",90,7,0,3,100
1808245,1376930,2024-02-06,Senate,"Senate: Reported from Finance and Appropriations (15-Y 0-N)",15,0,0,0,15
1808245,1378605,2024-02-07,Senate,"Senate: Constitutional reading dispensed (40-Y 0-N)",40,0,0,0,40
1808245,1380108,2024-02-08,Senate,"Senate: Constitutional reading dispensed (40-Y 0-N)",40,0,0,0,40
1808245,1380109,2024-02-08,Senate,"Senate: Read third time and passed Senate (40-Y 0-N)",40,0,0,0,40
1808245,1386603,2024-02-16,House,"House: Subcommittee recommends reporting with amendments (7-Y 1-N)",7,1,0,0,8
1808245,1386604,2024-02-16,House,"House: Reported from Counties, Cities and Towns with amendment(s) (21-Y 1-N)",21,1,0,0,22
1808245,1390337,2024-02-21,House,"House: VOTE: Passage (98-Y 2-N)",98,2,0,0,100
1808245,1394038,2024-02-23,Senate,"Senate: House amendment agreed to by Senate (39-Y 0-N)",39,0,0,1,40
1808247,1372669,2024-01-31,House,"House: Subcommittee recommends reporting (8-Y 0-N)",8,0,0,0,8
1808247,1375773,2024-02-05,House,"House: Reported from Education (22-Y 0-N)",22,0,0,0,22
1808247,1380535,2024-02-09,House,"House: VOTE: Block Vote Passage (96-Y 0-N)",96,0,0,4,100
1808247,1391473,2024-02-22,Senate,"Senate: Passed by indefinitely in Education and Health (12-Y 3-N)",12,3,0,0,15
1808250,1373701,2024-02-01,Senate,"Senate: Reported from Education and Health with substitute (15-Y 0-N)",15,0,0,0,15
1808250,1377112,2024-02-06,Senate,"Senate: Read third time and passed Senate (39-Y 0-N)",39,0,0,1,40
1808250,1432069,2024-02-14,House,"House: Reported from Education (12-Y 9-N)",12,9,0,1,22
1808250,1432070,2024-02-19,House,"House: VOTE: Passage (56-Y 44-N)",56,44,0,0,100
1808254,1376297,2024-02-05,Senate,"Senate: Reported from Commerce and Labor with substitute (15-Y 0-N)",15,0,0,0,15
1808254,1380105,2024-02-08,Senate,"Senate: Reported from Finance and Appropriations (15-Y 0-N)",15,0,0,0,15
1808254,1380789,2024-02-09,Senate,"Senate: Constitutional reading dispensed (39-Y 0-N)",39,0,0,1,40
1808254,1381459,2024-02-12,Senate,"Senate: Constitutional reading dispensed (40-Y 0-N)",40,0,0,0,40
1808254,1381460,2024-02-12,Senate,"Senate: Passed Senate (40-Y 0-N)",40,0,0,0,40
1808254,1393141,2024-02-23,House,"House: Subcommittee recommends reporting (6-Y 0-N)",6,0,0,0,6
1808254,1393286,2024-02-23,House,"House: Reported from Rules (16-Y 0-N)",16,0,0,2,18
1808254,1397573,2024-02-28,House,"House: Reported from Appropriations with substitute (21-Y 1-N)",21,1,0,0,22
1808254,1401822,2024-03-04,House,"House: VOTE: Passage (97-Y 1-N)",97,1,0,2,100
1808254,1402906,2024-03-05,Senate,"Senate: House substitute agreed to by Senate (40-Y 0-N)",40,0,0,0,40
1808255,1369002,2024-01-25,Senate,"Senate: Passed by indefinitely in Education and Health (9-Y 6-N)",9,6,0,0,15
1808257,1370941,2024-01-29,House,"House: Subcommittee recommends reporting with substitute (7-Y 0-N)",7,0,0,2,9
1808257,1373092,2024-01-31,House,"House: Reported from Appropriations with substitute (22-Y 0-N)",22,0,0,0,22
1808257,1377269,2024-02-06,House,"House: VOTE: Block Vote Passage (99-Y 0-N)",99,0,0,1,100
1808257,1397494,2024-02-28,Senate,"Senate: Reported from Finance and Appropriations (15-Y 0-N)",15,0,0,0,15
1808257,1399110,2024-02-29,Senate,"Senate: Constitutional reading dispensed (39-Y 0-N)",39,0,0,1,40
1808257,1400942,2024-03-01,Senate,"Senate: Passed Senate (40-Y 0-N)",40,0,0,0,40
1808262,1373804,2024-02-01,House,"House: Subcommittee recommends reporting with amendments (7-Y 1-N)",7,1,0,0,8
1808262,1376825,2024-02-06,House,"House: Reported from Health and Human Services with substitute (12-Y 10-N)",12,10,0,0,22
1808263,1368928,2024-01-24,House,"House: Subcommittee recommends reporting (7-Y 0-N)",7,0,0,2,9
1808263,1369832,2024-01-26,House,"House: Reported from Courts of Justice (21-Y 0-N)",21,0,0,1,22
1808263,1373901,2024-02-01,House,"House: VOTE: Block Vote Passage (99-Y 0-N)",99,0,0,1,100
1808263,1384335,2024-02-14,Senate,"Senate: Reported from Courts of Justice (15-Y 0-N)",15,0,0,0,15
1808263,1386762,2024-02-16,Senate,"Senate: Constitutional reading dispensed (38-Y 0-N)",38,0,0,2,40
1808263,1388101,2024-02-19,Senate,"Senate: Passed Senate (39-Y 0-N)",39,0,0,1,40
1808267,1369451,2024-01-25,House,"House: Subcommittee recommends reporting with substitute (8-Y 0-N)",8,0,0,0,8
1808267,1372233,2024-01-30,House,"House: Reported from General Laws with substitute (22-Y 0-N)",22,0,0,0,22
1808267,1376591,2024-02-05,House,"House: VOTE: Block Vote Passage (98-Y 0-N)",98,0,0,2,100
1808267,1384478,2024-02-14,Senate,"Senate: Reported from General Laws and Technology (15-Y 0-N)",15,0,0,0,15
1808267,1386892,2024-02-16,Senate,"Senate: Constitutional reading dispensed (38-Y 0-N)",38,0,0,2,40
1808267,1387551,2024-02-19,Senate,"Senate: Passed Senate (39-Y 0-N)",39,0,0,1,40
1808269,1367620,2024-01-23,House,"House: Subcommittee recommends reporting (8-Y 0-N)",8,0,0,0,8
1808269,1369440,2024-01-25,House,"House: Reported from Transportation (21-Y 0-N)",21,0,0,1,22
1808269,1373027,2024-01-31,House,"House: VOTE: Block Vote Passage (100-Y 0-N)",100,0,0,0,100
1808269,1386879,2024-02-15,Senate,"Senate: Reported from Transportation (12-Y 0-N)",12,0,0,0,12
1808269,1390738,2024-02-21,Senate,"Senate: Reported from Finance and Appropriations (14-Y 0-N)",14,0,0,0,14
1808269,1392464,2024-02-22,Senate,"Senate: Constitutional reading dispensed (40-Y 0-N)",40,0,0,0,40
1808269,1393721,2024-02-23,Senate,"Senate: Passed Senate (39-Y 0-N)",39,0,0,1,40
1808270,1372764,2024-01-31,House,"House: Subcommittee recommends reporting with substitute (8-Y 1-N)",8,1,0,1,10
1808270,1375572,2024-02-05,House,"House: Reported from Communications, Technology and Innovation with substitute (14-Y 6-N)",14,6,2,0,22
1808270,1380981,2024-02-09,House,"House: VOTE: Passage (66-Y 27-N)",66,27,0,7,100
1808270,1394941,2024-02-26,Senate,"Senate: Rereferred from Transportation (15-Y 0-N)",15,0,0,0,15
1808270,1398792,2024-02-28,Senate,"Senate: Continued to 2025 in Courts of Justice (12-Y 0-N)",12,0,0,0,12
1808272,1372125,2024-01-30,House,"House: Subcommittee recommends reporting with amendments (6-Y 4-N)",6,4,0,0,10
1808272,1374223,2024-02-01,House,"House: Reported from Labor and Commerce with amendment(s) (11-Y 10-N)",11,10,0,1,22
1808272,1378658,2024-02-07,House,"House: VOTE: Passage (55-Y 44-N)",55,44,0,1,100
1808272,1387636,2024-02-19,Senate,"Senate: Reported from Commerce and Labor (9-Y 6-N)",9,6,0,0,15
1808272,1390028,2024-02-21,Senate,"Senate: Constitutional reading dispensed (40-Y 0-N)",40,0,0,0,40
1808272,1392414,2024-02-22,Senate,"Senate: Passed Senate (22-Y 18-N)",22,18,0,0,40
1808272,1430261,2024-04-17,House,"House: VOTE: Adoption (58-Y 42-N)",58,42,0,0,100
1808272,1430262,2024-04-17,Senate,"Senate: Senate concurred in Governor's recommendation (40-Y 0-N)",40,0,0,0,40
1808273,1373397,2024-01-31,House,"House: Subcommittee recommends reporting with substitute (8-Y 0-N)",8,0,0,1,9
1808273,1375872,2024-02-02,House,"House: Reported from Courts of Justice with substitute (20-Y 0-N)",20,0,0,2,22
1808273,1380287,2024-02-08,House,"House: VOTE: Block Vote Passage (98-Y 0-N)",98,0,0,2,100
1808273,1394692,2024-02-26,Senate,"Senate: Reported from Courts of Justice (15-Y 0-N)",15,0,0,0,15
1808273,1395849,2024-02-27,Senate,"Senate: Constitutional reading dispensed (39-Y 0-N)",39,0,0,1,40
1808273,1398716,2024-02-28,Senate,"Senate: Passed Senate (39-Y 0-N)",39,0,0,1,40
1808273,1430243,2024-04-17,House,"House: VOTE: (100-Y 0-N)",100,0,0,0,100
1808273,1430244,2024-04-17,Senate,"Senate: Senate concurred in Governor's recommendation (40-Y 0-N)",40,0,0,0,40
1808275,1367342,2024-01-22,House,"House: Subcommittee recommends reporting (8-Y 0-N)",8,0,0,1,9
1808275,1369825,2024-01-26,House,"House: Reported from Courts of Justice (21-Y 0-N)",21,0,0,1,22
1808275,1373889,2024-02-01,House,"House: VOTE: Block Vote Passage (99-Y 0-N)",99,0,0,1,100
1808275,1385058,2024-02-14,Senate,"Senate: Reported from Courts of Justice (15-Y 0-N)",15,0,0,0,15
1808275,1396203,2024-02-27,Senate,"Senate: Constitutional reading dispensed (39-Y 0-N)",39,0,0,1,40
1808275,1396204,2024-02-27,Senate,"Senate: Reported from Finance and Appropriations (15-Y 0-N)",15,0,0,0,15
1808275,1397718,2024-02-28,Senate,"Senate: Passed Senate (39-Y 0-N)",39,0,0,1,40
1808277,1367992,2024-01-23,House,"House: Reported from Health and Human Services with amendment(s) (21-Y 0-N)",21,0,0,1,22
1808277,1375763,2024-02-05,House,"House: Subcommittee recommends reporting (8-Y 0-N)",8,0,0,1,9
1808277,1375764,2024-02-05,House,"House: Reported from Appropriations (21-Y 0-N)",21,0,0,1,22
1808277,1380537,2024-02-09,House,"House: VOTE: Block Vote Passage (96-Y 0-N)",96,0,0,4,100
1808277,1392195,2024-02-22,Senate,"Senate: Reported from Education and Health with substitute (14-Y 0-N)",14,0,0,0,14
1808277,1399380,2024-02-29,Senate,"Senate: Reported from Finance and Appropriations (14-Y 0-N)",14,0,0,0,14
1808277,1402159,2024-03-04,Senate,"Senate: Constitutional reading dispensed (40-Y 0-N)",40,0,0,0,40
1808277,1403462,2024-03-05,Senate,"Senate: Passed Senate with substitute (40-Y 0-N)",40,0,0,0,40
1808277,1404591,2024-03-06,House,"House: VOTE: REJECTED (3-Y 96-N)",3,96,0,1,100
1808277,1405443,2024-03-07,Senate,"Senate: Senate receded from substitute (40-Y 0-N)",40,0,0,0,40
1808278,1372046,2024-01-30,House,"House: Subcommittee recommends laying on the table (8-Y 0-N)",8,0,0,1,9
1808281,1371433,2024-01-30,House,"House: Subcommittee recommends reporting (7-Y 1-N)",7,1,0,0,8
1808281,1372768,2024-01-31,House,"House: Reported from Education (14-Y 8-N)",14,8,0,0,22
1808281,1376334,2024-02-05,House,"House: Subcommittee recommends reporting with substitute (7-Y 1-N)",7,1,0,1,9
1808281,1378614,2024-02-07,House,"House: Reported from Appropriations with substitute (14-Y 8-N)",14,8,0,0,22
1808281,1383109,2024-02-13,House,"House: VOTE: Passage (55-Y 44-N)",55,44,0,1,100
1808281,1399090,2024-02-29,Senate,"Senate: Reported from Education and Health with substitute (15-Y 0-N)",15,0,0,0,15
1808282,1366635,2024-01-18,Senate,"Senate: Reported from Transportation with substitute (15-Y 0-N)",15,0,0,0,15
1808282,1371457,2024-01-30,Senate,"Senate: Continued to 2025 in Finance and Appropriations (9-Y 6-N)",9,6,0,0,15
1808283,1367580,2024-01-22,House,"House: Subcommittee recommends laying on the table (7-Y 1-N)",7,1,0,0,8
1808284,1371074,2024-01-29,Senate,"Senate: Reported from Commerce and Labor (9-Y 6-N)",9,6,0,0,15
1808284,1381290,2024-02-12,Senate,"Senate: Reported from Finance and Appropriations with substitute (10-Y 5-N)",10,5,0,0,15
1808284,1381580,2024-02-12,Senate,"Senate: Constitutional reading dispensed (40-Y 0-N)",40,0,0,0,40
1808284,1383839,2024-02-13,Senate,"Senate: Constitutional reading dispensed (40-Y 0-N)",40,0,0,0,40
1808284,1383840,2024-02-13,Senate,"Senate: Passed Senate (21-Y 19-N)",21,19,0,0,40
1808284,1389310,2024-02-20,House,"House: Reported from Labor and Commerce (12-Y 9-N)",12,9,0,1,22
1808284,1390706,2024-02-21,House,"House: Reported from Appropriations with substitute (12-Y 10-N)",12,10,0,0,22
1808284,1394404,2024-02-26,House,"House: VOTE: Passage (50-Y 46-N)",50,46,0,4,100
1808284,1397997,2024-02-28,Senate,"Senate: House substitute agreed to by Senate (20-Y 19-N)",20,19,0,1,40
1808284,1430276,2024-04-17,Senate,"Senate: Passed in enrolled form rejected (21-Y 19-N)",21,19,0,0,40
1808286,1368774,2024-01-24,Senate,"Senate: Reported from Courts of Justice with amendment (12-Y 0-N)",12,0,0,0,12
1808286,1369934,2024-01-26,Senate,"Senate: Constitutional reading dispensed (37-Y 0-N)",37,0,0,3,40
1808286,1371564,2024-01-30,Senate,"Senate: Read third time and passed Senate (40-Y 0-N)",40,0,0,0,40
1808286,1384663,2024-02-14,House,"House: Subcommittee recommends reporting (8-Y 0-N)",8,0,0,1,9
1808286,1386988,2024-02-16,House,"House: Reported from Courts of Justice (22-Y 0-N)",22,0,0,0,22
1808286,1389983,2024-02-21,House,"House: VOTE: Block Vote Passage (100-Y 0-N)",100,0,0,0,100
1808290,1367348,2024-01-22,House,"House: Subcommittee recommends reporting (8-Y 0-N)",8,0,0,1,9
1808290,1369881,2024-01-26,House,"House: Reported from Courts of Justice (21-Y 0-N)",21,0,0,1,22
1808291,1374951,2024-02-02,House,"House: Subcommittee recommends reporting with amendments (7-Y 0-N)",7,0,0,2,9
1808291,1378835,2024-02-07,House,"House: Reported from Courts of Justice with substitute (22-Y 0-N)",22,0,0,0,22
1808291,1382835,2024-02-13,House,"House: VOTE: Passage (86-Y 12-N)",86,12,0,2,100
1808291,1398860,2024-02-28,Senate,"Senate: Reported from Courts of Justice (10-Y 5-N)",10,5,0,0,15
1808291,1401134,2024-03-01,Senate,"Senate: Constitutional reading dispensed (40-Y 0-N)",40,0,0,0,40
1808291,1403663,2024-03-05,Senate,"Senate: Passed Senate (22-Y 18-N)",22,18,0,0,40
1808291,1430237,2024-04-17,House,"House: VOTE: Adoption (1-Y 99-N)",1,99,0,0,100
1808293,1373921,2024-02-01,House,"House: Subcommittee recommends reporting (6-Y 4-N)",6,4,0,0,10
1808293,1374719,2024-02-02,House,"House: Reported from Public Safety (12-Y 10-N)",12,10,0,0,22
1808293,1378160,2024-02-07,House,"House: Subcommittee recommends reporting (5-Y 3-N)",5,3,0,1,9
1808293,1378830,2024-02-07,House,"House: Reported from Appropriations (13-Y 9-N)",13,9,0,0,22
1808293,1382851,2024-02-13,House,"House: VOTE: Passage (52-Y 47-N)",52,47,0,1,100
1808293,1394248,2024-02-26,Senate,"Senate: Reported from Courts of Justice (9-Y 6-N)",9,6,0,0,15
1808293,1397511,2024-02-28,Senate,"Senate: Reported from Finance and Appropriations (10-Y 5-N)",10,5,0,0,15
1808293,1399230,2024-02-29,Senate,"Senate: Constitutional reading dispensed (39-Y 0-N)",39,0,0,1,40
1808293,1402780,2024-03-05,Senate,"Senate: Defeated by Senate (20-Y 20-N)",20,20,0,0,40
1808293,1402781,2024-03-05,Senate,"Senate: Reconsideration of defeated action agreed to by Senate (40-Y 0-N)",40,0,0,0,40
1808293,1402782,2024-03-05,Senate,"Senate: Passed Senate with amendment (21-Y 19-N)",21,19,0,0,40
1808293,1404121,2024-03-06,House,"House: VOTE: Adoption (50-Y 47-N)",50,47,0,3,100
1808295,1376848,2024-02-06,Senate,"Senate: Rereferred from Rules (10-Y 0-N)",10,0,0,0,10
1808295,1377888,2024-02-07,Senate,"Senate: Stricken at request of Patron in Finance and Appropriations (15-Y 0-N)",15,0,0,0,15
1808300,1364006,2024-01-10,Senate,"Senate: Rules suspended (39-Y 0-N)",39,0,0,1,40
1808300,1364007,2024-01-10,Senate,"Senate: Agreed to by Senate (39-Y 0-N)",39,0,0,1,40
1808300,1364322,2024-01-10,House,"House: VOTE: Adoption (99-Y 0-N)",99,0,0,1,100
1808302,1376021,2024-02-05,House,"House: Subcommittee recommends reporting with substitute (8-Y 0-N)",8,0,0,1,9
1808302,1378678,2024-02-07,House,"House: Reported from Appropriations with substitute (22-Y 0-N)",22,0,0,0,22
1808302,1383708,2024-02-13,House,"House: VOTE: Passage (92-Y 3-N)",92,3,0,5,100
1808302,1397810,2024-02-28,Senate,"Senate: Reported from Finance and Appropriations (15-Y 0-N)",15,0,0,0,15
1808302,1400094,2024-02-29,Senate,"Senate: Constitutional reading dispensed (39-Y 0-N)",39,0,0,1,40
1808302,1401101,2024-03-01,Senate,"Senate: Passed Senate (40-Y 0-N)",40,0,0,0,40
1808303,1377565,2024-02-06,House,"House: Subcommittee recommends reporting with amendments (7-Y 0-N)",7,0,0,1,8
1808303,1380280,2024-02-08,House,"House: Reported from General Laws with amendment(s) (20-Y 0-N)",20,0,0,2,22
1808303,1383765,2024-02-13,House,"House: VOTE: Block Vote Passage (99-Y 0-N)",99,0,0,1,100
1808303,1398268,2024-02-28,Senate,"Senate: Reported from General Laws and Technology with substitute (12-Y 0-N)",12,0,0,0,12
1808303,1401088,2024-03-01,Senate,"Senate: Constitutional reading dispensed (40-Y 0-N)",40,0,0,0,40
1808303,1402331,2024-03-04,Senate,"Senate: Passed Senate with substitute (39-Y 0-N)",39,0,0,1,40
1808303,1403642,2024-03-05,House,"House: VOTE: REJECTED (1-Y 99-N)",1,99,0,0,100
1808303,1404713,2024-03-06,Senate,"Senate: Senate insisted on substitute (40-Y 0-N)",40,0,0,0,40
1808303,1406543,2024-03-08,House,"House: VOTE: Adoption (96-Y 0-N)",96,0,0,4,100
1808303,1406763,2024-03-09,Senate,"Senate: Conference report agreed to by Senate (40-Y 0-N)",40,0,0,0,40
1808305,1379200,2024-02-08,House,"House: Reported from Rules (18-Y 0-N)",18,0,0,0,18
1808305,1382938,2024-02-13,House,"House: VOTE: Block Vote Passage (99-Y 0-N)",99,0,0,1,100
1808305,1400345,2024-03-01,Senate,"Senate: Reported from Rules (13-Y 0-N)",13,0,0,0,13
1808305,1402258,2024-03-04,Senate,"Senate: Constitutional reading dispensed (40-Y 0-N)",40,0,0,0,40
1808305,1403504,2024-03-05,Senate,"Senate: Passed Senate (40-Y 0-N)",40,0,0,0,40
1808308,1369222,2024-01-25,House,"House: Subcommittee recommends reporting with substitute (6-Y 2-N)",6,2,0,0,8
1808308,1372150,2024-01-30,House,"House: Reported from General Laws with substitute (22-Y 0-N)",22,0,0,0,22
1808308,1376250,2024-02-05,House,"House: VOTE: Block Vote Passage (98-Y 0-N)",98,0,0,2,100
1808308,1384332,2024-02-14,Senate,"Senate: Reported from General Laws and Technology (15-Y 0-N)",15,0,0,0,15
1808308,1386540,2024-02-16,Senate,"Senate: Constitutional reading dispensed (38-Y 0-N)",38,0,0,2,40
1808308,1387718,2024-02-19,Senate,"Senate: Passed Senate (39-Y 0-N)",39,0,0,1,40
1808310,1372118,2024-01-30,House,"House: Subcommittee recommends laying on the table (6-Y 4-N)",6,4,0,0,10
1808311,1373053,2024-01-31,House,"House: Subcommittee recommends laying on the table (8-Y 0-N)",8,0,0,1,9
1808312,1376172,2024-02-05,House,"House: Subcommittee recommends reporting with substitute (10-Y 0-N)",10,0,0,0,10
1808312,1377958,2024-02-07,House,"House: Reported from Education with substitute (22-Y 0-N)",22,0,0,0,22
1808312,1383811,2024-02-13,House,"House: VOTE: Block Vote Passage (99-Y 0-N)",99,0,0,1,100
1808312,1399518,2024-02-29,Senate,"Senate: Reported from Education and Health (15-Y 0-N)",15,0,0,0,15
1808312,1400643,2024-03-01,Senate,"Senate: Constitutional reading dispensed (40-Y 0-N)",40,0,0,0,40
1808312,1401709,2024-03-04,Senate,"Senate: Passed Senate (39-Y 0-N)",39,0,0,1,40
1808313,1364310,2024-01-15,Senate,"Senate: Reported from Courts of Justice (8-Y 7-N)",8,7,0,0,15
1808313,1432048,2024-01-16,Senate,"Senate: Constitutional reading dispensed (38-Y 0-N)",38,0,0,1,39
1808313,1432049,2024-01-18,Senate,"Senate: Read third time and passed Senate (21-Y 19-N)",21,19,0,0,40
1808313,1432050,2024-02-23,House,"House: Reported from Courts of Justice (11-Y 10-N)",11,10,0,1,22
1808317,1377675,2024-02-06,House,"House: Subcommittee recommends reporting with substitute (10-Y 0-N)",10,0,0,0,10
1808317,1380002,2024-02-08,House,"House: Reported from Labor and Commerce with substitute (22-Y 0-N)",22,0,0,0,22
1808317,1382971,2024-02-13,House,"House: VOTE: Block Vote Passage (99-Y 0-N)",99,0,0,1,100
1808317,1395124,2024-02-26,Senate,"Senate: Reported from Commerce and Labor (15-Y 0-N)",15,0,0,0,15
1808317,1399963,2024-02-29,Senate,"Senate: Reported from Finance and Appropriations (14-Y 0-N)",14,0,0,0,14
1808317,1401779,2024-03-04,Senate,"Senate: Constitutional reading dispensed (40-Y 0-N)",40,0,0,0,40
1808317,1402915,2024-03-05,Senate,"Senate: Passed Senate (40-Y 0-N)",40,0,0,0,40
1808317,1430104,2024-04-17,House,"House: VOTE: (100-Y 0-N)",100,0,0,0,100
1808317,1430105,2024-04-17,Senate,"Senate: Senate concurred in Governor's recommendation (40-Y 0-N)",40,0,0,0,40
1808318,1367350,2024-01-22,House,"House: Subcommittee recommends striking from docket (8-Y 0-N)",8,0,0,1,9
1808320,1377648,2024-02-06,House,"House: Subcommittee recommends reporting with amendments (6-Y 0-N)",6,0,0,1,7
1808320,1380300,2024-02-08,House,"House: Reported from Labor and Commerce with amendment(s) (22-Y 0-N)",22,0,0,0,22
1808320,1383876,2024-02-13,House,"House: VOTE: Block Vote Passage (99-Y 0-N)",99,0,0,1,100
1808320,1401787,2024-03-04,Senate,"Senate: Reported from Commerce and Labor (12-Y 0-N)",12,0,0,0,12
1808320,1403126,2024-03-05,Senate,"Senate: Constitutional reading dispensed (40-Y 0-N)",40,0,0,0,40
1808320,1404143,2024-03-06,Senate,"Senate: Passed Senate (40-Y 0-N)",40,0,0,0,40
1808323,1370863,2024-01-29,House,"House: Subcommittee recommends reporting (10-Y 0-N)",10,0,0,0,10
1808323,1372417,2024-01-31,House,"House: Reported from Agriculture, Chesapeake and Natural Resources (22-Y 0-N)",22,0,0,0,22
1808323,1377425,2024-02-06,House,"House: VOTE: Block Vote Passage (99-Y 0-N)",99,0,0,1,100
1808323,1386667,2024-02-16,Senate,"Senate: Reported from Agriculture, Conservation and Natural Resources (12-Y 0-N)",12,0,0,0,12
1808323,1399377,2024-02-29,Senate,"Senate: Reported from Finance and Appropriations (14-Y 0-N)",14,0,0,0,14
1808323,1401933,2024-03-04,Senate,"Senate: Constitutional reading dispensed (40-Y 0-N)",40,0,0,0,40
1808323,1403017,2024-03-05,Senate,"Senate: Passed Senate (40-Y 0-N)",40,0,0,0,40
1808324,1369882,2024-01-26,House,"House: Reported from Rules with substitute (17-Y 0-N)",17,0,0,1,18
1808324,1373666,2024-02-01,House,"House: Reported from Health and Human Services with substitute (22-Y 0-N)",22,0,0,0,22
1808324,1375740,2024-02-01,House,"House: Reported from Health and Human Services (22-Y 0-N)",22,0,0,0,22
1808324,1379869,2024-02-08,House,"House: VOTE: Block Vote Passage (98-Y 0-N)",98,0,0,2,100
1808324,1393532,2024-02-23,Senate,"Senate: Reported from Rules (15-Y 0-N)",15,0,0,0,15
1808324,1394670,2024-02-26,Senate,"Senate: Constitutional reading dispensed (40-Y 0-N)",40,0,0,0,40
1808324,1396058,2024-02-27,Senate,"Senate: Passed Senate (39-Y 0-N)",39,0,0,1,40
1808326,1380166,2024-02-08,House,"House: Subcommittee recommends laying on the table (8-Y 0-N)",8,0,0,0,8
1808328,1376423,2024-02-05,House,"House: Subcommittee recommends continuing to 2025 (7-Y 0-N)",7,0,0,1,8
1808329,1367659,2024-01-23,House,"House: Stricken from docket by Health and Human Services (22-Y 0-N)",22,0,0,0,22
1808330,1372245,2024-01-30,House,"House: Subcommittee recommends reporting (8-Y 0-N)",8,0,0,1,9
1808330,1374292,2024-02-01,House,"House: Reported from General Laws (22-Y 0-N)",22,0,0,0,22
1808330,1378807,2024-02-07,House,"House: VOTE: Passage (89-Y 11-N)",89,11,0,0,100
1808330,1384276,2024-02-14,Senate,"Senate: Reported from General Laws and Technology (15-Y 0-N)",15,0,0,0,15
1808330,1387104,2024-02-16,Senate,"Senate: Constitutional reading dispensed (38-Y 0-N)",38,0,0,2,40
1808330,1388085,2024-02-19,Senate,"Senate: Passed Senate (39-Y 0-N)",39,0,0,1,40
1808335,1369961,2024-01-26,House,"House: Subcommittee recommends reporting with amendments (8-Y 0-N)",8,0,0,1,9
1808335,1375570,2024-02-02,House,"House: Reported from Courts of Justice with amendment(s) (21-Y 0-N)",21,0,0,1,22
1808335,1379354,2024-02-08,House,"House: VOTE: Block Vote Passage (98-Y 0-N)",98,0,0,2,100
1808335,1387329,2024-02-19,Senate,"Senate: Reported from Courts of Justice with amendments (12-Y 0-N)",12,0,0,0,12
1808335,1389178,2024-02-20,Senate,"Senate: Constitutional reading dispensed (39-Y 0-N)",39,0,0,1,40
1808335,1390118,2024-02-21,Senate,"Senate: Passed Senate with amendments (40-Y 0-N)",40,0,0,0,40
1808335,1394007,2024-02-23,House,"House: VOTE: Adoption (95-Y 0-N)",95,0,0,5,100
1808336,1366531,2024-01-18,House,"House: Reported from Health and Human Services with substitute (22-Y 0-N)",22,0,0,0,22
1808336,1369251,2024-01-24,House,"House: VOTE: Block Vote Passage (99-Y 0-N)",99,0,0,1,100
1808336,1385848,2024-02-15,Senate,"Senate: Reported from Education and Health (13-Y 0-N)",13,0,0,0,13
1808336,1387036,2024-02-16,Senate,"Senate: Constitutional reading dispensed (38-Y 0-N)",38,0,0,2,40
1808336,1388002,2024-02-19,Senate,"Senate: Passed Senate (39-Y 0-N)",39,0,0,1,40
1808337,1374917,2024-02-02,House,"House: Subcommittee recommends reporting (8-Y 0-N)",8,0,0,0,8
1808337,1374918,2024-02-02,House,"House: Reported from Counties, Cities and Towns (19-Y 3-N)",19,3,0,0,22
1808337,1380367,2024-02-08,House,"House: VOTE: Passage (75-Y 23-N)",75,23,0,2,100
1808337,1394422,2024-02-26,Senate,"Senate: Continued to 2025 in Local Government (14-Y 0-N)",14,0,0,0,14
1808341,1367436,2024-01-22,House,"House: Subcommittee recommends reporting (7-Y 0-N)",7,0,0,2,9
1808341,1369811,2024-01-26,House,"House: Reported from Courts of Justice (21-Y 0-N)",21,0,0,1,22
1808341,1373867,2024-02-01,House,"House: VOTE: Block Vote Passage (99-Y 0-N)",99,0,0,1,100
1808341,1385013,2024-02-14,Senate,"Senate: Reported from Courts of Justice (15-Y 0-N)",15,0,0,0,15
1808341,1386621,2024-02-16,Senate,"Senate: Constitutional reading dispensed (38-Y 0-N)",38,0,0,2,40
1808341,1388147,2024-02-19,Senate,"Senate: Passed Senate (39-Y 0-N)",39,0,0,1,40
1808342,1374738,2024-02-02,House,"House: Subcommittee recommends reporting with substitute (8-Y 0-N)",8,0,0,0,8
1808342,1374739,2024-02-02,House,"House: Reported from Counties, Cities and Towns with substitute (22-Y 0-N)",22,0,0,0,22
1808342,1379986,2024-02-08,House,"House: VOTE: Block Vote Passage (98-Y 0-N)",98,0,0,2,100
1808342,1394325,2024-02-26,Senate,"Senate: Reported from Local Government (15-Y 0-N)",15,0,0,0,15
1808342,1396357,2024-02-27,Senate,"Senate: Constitutional reading dispensed (39-Y 0-N)",39,0,0,1,40
1808342,1397884,2024-02-28,Senate,"Senate: Passed Senate (39-Y 0-N)",39,0,0,1,40
1808346,1368467,2024-01-24,House,"House: Subcommittee recommends reporting (10-Y 0-N)",10,0,0,1,11
1808346,1372409,2024-01-31,House,"House: Reported from Agriculture, Chesapeake and Natural Resources (22-Y 0-N)",22,0,0,0,22
1808346,1377433,2024-02-06,House,"House: VOTE: Block Vote Passage (99-Y 0-N)",99,0,0,1,100
1808346,1388923,2024-02-20,Senate,"Senate: Reported from Agriculture, Conservation and Natural Resources (15-Y 0-N)",15,0,0,0,15
1808346,1392161,2024-02-22,Senate,"Senate: Constitutional reading dispensed (40-Y 0-N)",40,0,0,0,40
1808346,1393750,2024-02-23,Senate,"Senate: Passed Senate (39-Y 0-N)",39,0,0,1,40
1808349,1372098,2024-01-30,House,"House: Subcommittee recommends laying on the table (5-Y 4-N)",5,4,0,1,10
1808350,1371172,2024-01-29,House,"House: Subcommittee recommends striking from docket (7-Y 0-N)",7,0,0,1,8
1808351,1370609,2024-01-29,House,"House: Subcommittee recommends laying on the table (8-Y 0-N)",8,0,0,1,9
1808352,1372235,2024-01-30,House,"House: Subcommittee recommends laying on the table (5-Y 3-N)",5,3,0,1,9
1808353,1366430,2024-01-17,Senate,"Senate: Reported from General Laws and Technology (15-Y 0-N)",15,0,0,0,15
1808353,1368862,2024-01-19,Senate,"Senate: Constitutional reading dispensed (37-Y 0-N)",37,0,0,3,40
1808353,1368863,2024-01-23,Senate,"Senate: Read third time and passed Senate (39-Y 0-N)",39,0,0,1,40
1808353,1386262,2024-02-15,House,"House: Reported from General Laws (22-Y 0-N)",22,0,0,0,22
1808353,1388493,2024-02-20,House,"House: VOTE: Block Vote Passage (98-Y 0-N)",98,0,0,2,100
1808355,1369157,2024-01-25,House,"House: Subcommittee recommends reporting (8-Y 0-N)",8,0,0,1,9
1808355,1369824,2024-01-26,House,"House: Reported from Counties, Cities and Towns (19-Y 1-N)",19,1,0,2,22
1808355,1373878,2024-02-01,House,"House: VOTE: Passage (85-Y 15-N)",85,15,0,0,100
1808355,1387566,2024-02-19,Senate,"Senate: Reported from Local Government with amendments (9-Y 6-N)",9,6,0,0,15
1808355,1388914,2024-02-20,Senate,"Senate: Constitutional reading dispensed (39-Y 0-N)",39,0,0,1,40
1808355,1398610,2024-02-28,Senate,"Senate: Continued to 2025 in General Laws and Technology (15-Y 0-N)",15,0,0,0,15
1808356,1368140,2024-01-23,House,"House: Subcommittee recommends reporting with substitute (7-Y 0-N)",7,0,0,0,7
1808356,1369274,2024-01-25,House,"House: Reported from Labor and Commerce with substitute (21-Y 0-N)",21,0,0,1,22
1808356,1373115,2024-01-31,House,"House: VOTE: Block Vote Passage (100-Y 0-N)",100,0,0,0,100
1808356,1384643,2024-02-14,Senate,"Senate: Reported from General Laws and Technology with amendment (15-Y 0-N)",15,0,0,0,15
1808356,1387026,2024-02-16,Senate,"Senate: Constitutional reading dispensed (38-Y 0-N)",38,0,0,2,40
1808356,1388016,2024-02-19,Senate,"Senate: Passed Senate with amendment (39-Y 0-N)",39,0,0,1,40
1808356,1390282,2024-02-21,House,"House: VOTE: Adoption (100-Y 0-N)",100,0,0,0,100
1808357,1369309,2024-01-25,House,"House: Subcommittee recommends striking from docket (8-Y 0-N)",8,0,0,0,8
1808357,1372223,2024-01-30,House,"House: Stricken from docket by General Laws (22-Y 0-N)",22,0,0,0,22
1808358,1370994,2024-01-29,House,"House: Subcommittee recommends laying on the table (4-Y 2-N)",4,2,0,0,6
1808364,1367970,2024-01-23,House,"House: Reported from Health and Human Services (21-Y 1-N)",21,1,0,0,22
1808364,1370795,2024-01-29,House,"House: VOTE: Passage (88-Y 10-N)",88,10,0,2,100
1808364,1392468,2024-02-22,Senate,"Senate: Reported from Education and Health (15-Y 0-N)",15,0,0,0,15
1808364,1393654,2024-02-23,Senate,"Senate: Constitutional reading dispensed (38-Y 0-N)",38,0,0,2,40
1808364,1394811,2024-02-26,Senate,"Senate: Passed Senate (40-Y 0-N)",40,0,0,0,40
1808366,1370529,2024-01-29,House,"House: Subcommittee recommends reporting with amendments (5-Y 3-N)",5,3,0,1,9
1808366,1375562,2024-02-02,House,"House: Reported from Courts of Justice with amendment(s) (12-Y 9-N)",12,9,0,1,22
1808366,1378119,2024-02-07,House,"House: Subcommittee recommends reporting (5-Y 3-N)",5,3,0,1,9
1808366,1378794,2024-02-07,House,"House: Reported from Appropriations (13-Y 9-N)",13,9,0,0,22
1808366,1383726,2024-02-13,House,"House: VOTE: Passage (53-Y 46-N)",53,46,0,1,100
1808366,1391050,2024-02-21,Senate,"Senate: Reported from Courts of Justice with substitute (10-Y 5-N)",10,5,0,0,15
1808366,1397546,2024-02-28,Senate,"Senate: Reported from Finance and Appropriations with substitute (10-Y 5-N)",10,5,0,0,15
1808366,1399987,2024-02-29,Senate,"Senate: Constitutional reading dispensed (39-Y 0-N)",39,0,0,1,40
1808366,1403398,2024-03-05,Senate,"Senate: Passed Senate with substitute (21-Y 19-N)",21,19,0,0,40
1808366,1404559,2024-03-06,House,"House: VOTE: Adoption (53-Y 46-N)",53,46,0,1,100
1808370,1372071,2024-01-30,House,"House: Subcommittee recommends reporting with amendments (6-Y 1-N)",6,1,0,0,7
1808370,1374245,2024-02-01,House,"House: Reported from Labor and Commerce with amendment(s) (22-Y 0-N)",22,0,0,0,22
1808370,1378726,2024-02-07,House,"House: VOTE: Block Vote Passage (100-Y 0-N)",100,0,0,0,100
1808370,1387549,2024-02-19,Senate,"Senate: Reported from Commerce and Labor (15-Y 0-N)",15,0,0,0,15
1808370,1399362,2024-02-29,Senate,"Senate: Reported from Finance and Appropriations (14-Y 0-N)",14,0,0,0,14
1808370,1401969,2024-03-04,Senate,"Senate: Constitutional reading dispensed (40-Y 0-N)",40,0,0,0,40
1808370,1403060,2024-03-05,Senate,"Senate: Passed Senate (40-Y 0-N)",40,0,0,0,40
1808371,1368912,2024-01-24,House,"House: Subcommittee recommends reporting with substitute (8-Y 0-N)",8,0,0,1,9
1808371,1369807,2024-01-26,House,"House: Reported from Courts of Justice with substitute (21-Y 0-N)",21,0,0,1,22
1808374,1369280,2024-01-25,House,"House: Subcommittee recommends reporting with substitute (8-Y 0-N)",8,0,0,0,8
1808374,1372109,2024-01-30,House,"House: Reported from Labor and Commerce with substitute (21-Y 1-N)",21,1,0,0,22
1808374,1376025,2024-02-05,House,"House: VOTE: Passage (85-Y 13-N)",85,13,0,2,100
1808374,1384926,2024-02-14,Senate,"Senate: Rereferred from General Laws and Technology (12-Y 0-N)",12,0,0,0,12
1808374,1401909,2024-03-04,Senate,"Senate: Reported from Commerce and Labor with substitute (11-Y 0-N)",11,0,0,0,11
1808374,1403029,2024-03-05,Senate,"Senate: Constitutional reading dispensed (40-Y 0-N)",40,0,0,0,40
1808374,1404285,2024-03-06,Senate,"Senate: Passed Senate with substitute (40-Y 0-N)",40,0,0,0,40
1808374,1405153,2024-03-07,House,"House: VOTE: REJECTED (0-Y 99-N)",0,99,0,1,100
1808374,1405154,2024-03-07,Senate,"Senate: Senate insisted on substitute (40-Y 0-N)",40,0,0,0,40
1808374,1406424,2024-03-08,Senate,"Senate: Conference report agreed to by Senate (40-Y 0-N)",40,0,0,0,40
1808374,1406425,2024-03-08,House,"House: VOTE: Adoption (94-Y 1-N)",94,1,0,5,100
1808379,1369161,2024-01-25,House,"House: Subcommittee recommends reporting (4-Y 3-N)",4,3,0,1,8
1808379,1369823,2024-01-26,House,"House: Reported from Counties, Cities and Towns (11-Y 9-N)",11,9,0,2,22
1808379,1373905,2024-02-01,House,"House: VOTE: Passage (52-Y 48-N)",52,48,0,0,100
1808379,1388031,2024-02-19,Senate,"Senate: Reported from Local Government (8-Y 7-N)",8,7,0,0,15
1808379,1389386,2024-02-20,Senate,"Senate: Constitutional reading dispensed (39-Y 0-N)",39,0,0,1,40
1808379,1390943,2024-02-21,Senate,"Senate: Passed Senate (21-Y 19-N)",21,19,0,0,40
1808380,1374349,2024-02-01,House,"House: Subcommittee recommends reporting (8-Y 0-N)",8,0,0,1,9
1808380,1377296,2024-02-06,House,"House: Reported from Health and Human Services (22-Y 0-N)",22,0,0,0,22
1808380,1381747,2024-02-12,House,"House: VOTE: Block Vote Passage (100-Y 0-N)",100,0,0,0,100
1808380,1391479,2024-02-22,Senate,"Senate: Reported from Education and Health with substitute (15-Y 0-N)",15,0,0,0,15
1808380,1399953,2024-02-29,Senate,"Senate: Reported from Finance and Appropriations with amendment (14-Y 0-N)",14,0,0,0,14
1808380,1401992,2024-03-04,Senate,"Senate: Constitutional reading dispensed (40-Y 0-N)",40,0,0,0,40
1808380,1403092,2024-03-05,Senate,"Senate: Passed Senate with substitute with amendment (40-Y 0-N)",40,0,0,0,40
1808380,1404332,2024-03-06,House,"House: VOTE: Adoption (99-Y 0-N)",99,0,0,1,100
1808381,1379319,2024-02-08,House,"House: Subcommittee recommends reporting with amendments (8-Y 0-N)",8,0,0,0,8
1808381,1380428,2024-02-08,House,"House: Reported from General Laws with amendment(s) (20-Y 0-N)",20,0,0,2,22
1808381,1382915,2024-02-13,House,"House: VOTE: Block Vote Passage (99-Y 0-N)",99,0,0,1,100
1808381,1398811,2024-02-28,Senate,"Senate: Reported from General Laws and Technology with amendment (15-Y 0-N)",15,0,0,0,15
1808381,1401276,2024-03-01,Senate,"Senate: Constitutional reading dispensed (40-Y 0-N)",40,0,0,0,40
1808381,1402527,2024-03-04,Senate,"Senate: Passed Senate with amendment",39,0,0,1,40
1808381,1402954,2024-03-05,House,"House: VOTE: Adoption (99-Y 0-N)",99,0,0,1,100
1808381,1429771,2024-04-17,House,"House: VOTE: (100-Y 0-N)",100,0,0,0,100
1808381,1429772,2024-04-17,Senate,"Senate: Senate concurred in Governor's recommendation (40-Y 0-N)",40,0,0,0,40
1808384,1368187,2024-01-24,House,"House: Subcommittee failed to recommend reporting (5-Y 5-N)",5,5,0,0,10
1808386,1369414,2024-01-25,House,"House: Subcommittee recommends reporting with amendments (7-Y 4-N)",7,4,0,0,11
1808386,1369767,2024-01-26,House,"House: Reported from Public Safety with substitute (12-Y 10-N)",12,10,0,0,22
1808386,1372807,2024-01-31,House,"House: Subcommittee recommends reporting with substitute (5-Y 3-N)",5,3,0,1,9
1808386,1374598,2024-02-02,House,"House: Reported from Appropriations with substitute (12-Y 10-N)",12,10,0,0,22
1808390,1368023,2024-01-23,House,"House: Subcommittee recommends reporting (9-Y 1-N)",9,1,0,0,10
1808390,1369368,2024-01-25,House,"House: Reported from Labor and Commerce (21-Y 0-N)",21,0,0,1,22
1808390,1372958,2024-01-31,House,"House: VOTE: Block Vote Passage (100-Y 0-N)",100,0,0,0,100
1808390,1401815,2024-03-04,Senate,"Senate: Reported from Commerce and Labor (12-Y 0-N)",12,0,0,0,12
1808390,1402956,2024-03-05,Senate,"Senate: Constitutional reading dispensed (40-Y 0-N)",40,0,0,0,40
1808390,1404218,2024-03-06,Senate,"Senate: Motion to recommit to committee agreed to (22-Y 18-N)",22,18,0,0,40
1808391,1378936,2024-02-07,Senate,"Senate: Failed to report (defeated) in General Laws and Technology (5-Y 8-N 2-A)",5,8,2,0,15
1808393,1382553,2024-02-12,Senate,"Senate: Reported from Courts of Justice with substitute (6-Y 4-N)",6,4,0,0,10
1808393,1383342,2024-02-13,Senate,"Senate: Constitutional reading dispensed (40-Y 0-N)",40,0,0,0,40
1808393,1383343,2024-02-13,Senate,"Senate: Passed Senate (21-Y 19-N)",21,19,0,0,40
1808393,1383344,2024-02-13,Senate,"Senate: Constitutional reading dispensed (40-Y 0-N)",40,0,0,0,40
1808393,1391094,2024-02-21,House,"House: Subcommittee recommends reporting with substitute (5-Y 3-N)",5,3,0,1,9
1808393,1394088,2024-02-23,House,"House: Reported from Courts of Justice with substitute (11-Y 10-N)",11,10,0,1,22
1808393,1398631,2024-02-28,House,"House: VOTE: Passage (51-Y 49-N)",51,49,0,0,100
1808393,1401026,2024-03-01,Senate,"Senate: House substitute agreed to by Senate (21-Y 19-N)",21,19,0,0,40
1808394,1378994,2024-02-07,Senate,"Senate: Reported from General Laws and Technology (15-Y 0-N)",15,0,0,0,15
1808394,1381357,2024-02-12,Senate,"Senate: Reported from Finance and Appropriations (9-Y 5-N)",9,5,0,0,14
1808394,1382293,2024-02-12,Senate,"Senate: Constitutional reading dispensed (40-Y 0-N)",40,0,0,0,40
1808394,1383583,2024-02-13,Senate,"Senate: Constitutional reading dispensed (40-Y 0-N)",40,0,0,0,40
1808394,1383584,2024-02-13,Senate,"Senate: Passed Senate (40-Y 0-N)",40,0,0,0,40
1808394,1389155,2024-02-20,House,"House: Subcommittee recommends reporting (8-Y 0-N)",8,0,0,0,8
1808394,1392859,2024-02-22,House,"House: Reported from General Laws (22-Y 0-N)",22,0,0,0,22
1808394,1396473,2024-02-27,House,"House: VOTE: Block Vote Passage (97-Y 0-N)",97,0,0,3,100
1808396,1374736,2024-02-02,Senate,"Senate: Reported from Rehabilitation and Social Services with substitute (11-Y 3-N)",11,3,0,0,14
1808396,1375759,2024-02-05,Senate,"Senate: Constitutional reading dispensed (39-Y 0-N)",39,0,0,1,40
1808396,1379460,2024-02-08,Senate,"Senate: Read third time and passed Senate (30-Y 10-N)",30,10,0,0,40
1808396,1389324,2024-02-20,House,"House: Reported from Labor and Commerce (20-Y 2-N)",20,2,0,0,22
1808396,1393607,2024-02-23,House,"House: VOTE: Passage (80-Y 18-N)",80,18,0,2,100
1808397,1372214,2024-01-30,House,"House: Subcommittee recommends striking from docket (8-Y 0-N)",8,0,0,1,9
1808399,1373728,2024-02-01,House,"House: Tabled in Rules (18-Y 0-N)",18,0,0,0,18
1808400,1367116,2024-01-19,House,"House: Subcommittee recommends laying on the table (5-Y 3-N)",5,3,0,1,9
1808406,1368878,2024-01-24,Senate,"Senate: Incorporated by General Laws and Technology ",15,0,0,0,15
1808407,1367445,2024-01-22,House,"House: Subcommittee recommends reporting (7-Y 0-N)",7,0,0,2,9
1808407,1369794,2024-01-26,House,"House: Reported from Courts of Justice (21-Y 0-N)",21,0,0,1,22
1808407,1373766,2024-02-01,House,"House: VOTE: Block Vote Passage (99-Y 0-N)",99,0,0,1,100
1808407,1384552,2024-02-14,Senate,"Senate: Reported from Courts of Justice (15-Y 0-N)",15,0,0,0,15
1808407,1386726,2024-02-16,Senate,"Senate: Constitutional reading dispensed (38-Y 0-N)",38,0,0,2,40
1808407,1387463,2024-02-19,Senate,"Senate: Passed Senate (39-Y 0-N)",39,0,0,1,40
1808409,1369291,2024-01-25,House,"House: Subcommittee recommends reporting (5-Y 3-N)",5,3,0,0,8
1808409,1372077,2024-01-30,House,"House: Reported from Labor and Commerce (13-Y 9-N)",13,9,0,0,22
1808409,1376150,2024-02-05,House,"House: VOTE: Passage (50-Y 48-N)",50,48,0,2,100
1808409,1387565,2024-02-19,Senate,"Senate: Reported from Commerce and Labor with amendment (10-Y 5-N)",10,5,0,0,15
1808409,1389876,2024-02-21,Senate,"Senate: Constitutional reading dispensed (40-Y 0-N)",40,0,0,0,40
1808409,1392111,2024-02-22,Senate,"Senate: Passed Senate with amendment (21-Y 19-N)",21,19,0,0,40
1808409,1394466,2024-02-26,House,"House: VOTE: Adoption (50-Y 46-N)",50,46,0,4,100
1808412,1366171,2024-01-16,Senate,"Senate: Reported from Agriculture, Conservation and Natural Resources (14-Y 0-N)",14,0,0,0,14
1808412,1371558,2024-01-30,Senate,"Senate: Reported from Finance and Appropriations (14-Y 0-N 1-A)",14,0,1,0,15
1808412,1372945,2024-01-31,Senate,"Senate: Constitutional reading dispensed (40-Y 0-N)",40,0,0,0,40
1808412,1432184,2024-02-14,House,"House: Reported from Agriculture, Chesapeake and Natural Resources (21-Y 0-N)",21,0,0,1,22
1808412,1432185,2024-02-19,House,"House: VOTE: Block Vote Passage (99-Y 0-N)",99,0,0,1,100
1808413,1368266,2024-01-24,House,"House: Subcommittee recommends reporting (10-Y 0-N)",10,0,0,0,10
1808413,1372416,2024-01-31,House,"House: Reported from Agriculture, Chesapeake and Natural Resources (22-Y 0-N)",22,0,0,0,22
1808413,1377303,2024-02-06,House,"House: VOTE: (98-Y 0-N 1-A)",98,0,1,1,100
1808413,1386657,2024-02-16,Senate,"Senate: Reported from Agriculture, Conservation and Natural Resources (14-Y 0-N)",14,0,0,0,14
1808413,1388081,2024-02-19,Senate,"Senate: Constitutional reading dispensed (38-Y 0-N)",38,0,0,2,40
1808413,1388554,2024-02-20,Senate,"Senate: Passed Senate (36-Y 4-N)",36,4,0,0,40
1808413,1388555,2024-02-20,Senate,"Senate: Reconsideration of Senate passage agreed to by Senate (40-Y 0-N)",40,0,0,0,40
1808413,1388556,2024-02-20,Senate,"Senate: Passed Senate (37-Y 3-N)",37,3,0,0,40
1808413,1388557,2024-02-20,Senate,"Senate: Reconsideration of Senate passage agreed to by Senate (40-Y 0-N)",40,0,0,0,40
1808413,1388558,2024-02-20,Senate,"Senate: Passed Senate (37-Y 3-N)",37,3,0,0,40
1808414,1372237,2024-01-30,House,"House: Subcommittee failed to recommend reporting (4-Y 4-N)",4,4,0,1,9
1808415,1377403,2024-02-06,Senate,"Senate: Reported from Privileges and Elections with amendment (8-Y 6-N)",8,6,0,0,14
1808417,1371160,2024-01-29,House,"House: Subcommittee recommends reporting with amendments (8-Y 0-N)",8,0,0,0,8
1808417,1374673,2024-02-02,House,"House: Reported from Privileges and Elections with amendment(s) (15-Y 7-N)",15,7,0,0,22
1808417,1379811,2024-02-08,House,"House: VOTE: Passage (66-Y 32-N)",66,32,0,2,100
1808417,1388921,2024-02-20,Senate,"Senate: Reported from Privileges and Elections with amendment (14-Y 1-N)",14,1,0,0,15
1808417,1392237,2024-02-22,Senate,"Senate: Constitutional reading dispensed (40-Y 0-N)",40,0,0,0,40
1808417,1393786,2024-02-23,Senate,"Senate: Passed Senate with amendment (38-Y 0-N)",38,0,0,2,40
1808417,1395954,2024-02-27,House,"House: VOTE: Adoption (76-Y 20-N)",76,20,0,4,100
1808421,1380920,2024-02-09,House,"House: Reported from Privileges and Elections with substitute (22-Y 0-N)",22,0,0,0,22
1808421,1383062,2024-02-13,House,"House: VOTE: Block Vote Passage (99-Y 0-N)",99,0,0,1,100
1808421,1396863,2024-02-27,Senate,"Senate: Continued to 2025 in Privileges and Elections (8-Y 7-N)",8,7,0,0,15
1808423,1377712,2024-02-06,House,"House: Subcommittee recommends laying on the table (5-Y 3-N)",5,3,0,0,8
1808425,1367324,2024-01-22,House,"House: Subcommittee recommends reporting with amendments (9-Y 0-N)",9,0,0,1,10
1808425,1368251,2024-01-24,House,"House: Reported from Agriculture, Chesapeake and Natural Resources with amendment(s) (22-Y 0-N)",22,0,0,0,22
1808425,1371863,2024-01-30,House,"House: VOTE: Block Vote Passage (100-Y 0-N)",100,0,0,0,100
1808425,1386681,2024-02-16,Senate,"Senate: Reported from Agriculture, Conservation and Natural Resources (14-Y 0-N)",14,0,0,0,14
1808425,1387393,2024-02-19,Senate,"Senate: Constitutional reading dispensed (38-Y 0-N)",38,0,0,2,40
1808425,1388764,2024-02-20,Senate,"Senate: Passed Senate (40-Y 0-N)",40,0,0,0,40
1808426,1369042,2024-01-25,House,"House: Subcommittee recommends continuing to 2025 (8-Y 0-N)",8,0,0,1,9
1808431,1368988,2024-01-25,House,"House: Subcommittee recommends reporting with substitute (4-Y 2-N)",4,2,0,0,6
1808431,1374498,2024-02-02,House,"House: Reported from Public Safety with substitute (21-Y 1-N)",21,1,0,0,22
1808431,1379598,2024-02-08,House,"House: VOTE: Passage (97-Y 1-N)",97,1,0,2,100
1808431,1393157,2024-02-23,Senate,"Senate: Reported from Rehabilitation and Social Services with amendments (15-Y 0-N)",15,0,0,0,15
1808431,1394582,2024-02-26,Senate,"Senate: Constitutional reading dispensed (40-Y 0-N)",40,0,0,0,40
1808431,1395919,2024-02-27,Senate,"Senate: Passed Senate with amendments (39-Y 0-N)",39,0,0,1,40
1808431,1399165,2024-02-29,House,"House: VOTE: Adoption (97-Y 3-N)",97,3,0,0,100
1808434,1372793,2024-01-31,House,"House: Subcommittee recommends reporting with substitute (8-Y 0-N)",8,0,0,1,9
1808434,1375686,2024-02-02,House,"House: Reported from Courts of Justice with substitute (17-Y 2-N)",17,2,0,3,22
1808434,1380700,2024-02-09,House,"House: Subcommittee recommends reporting with substitute (7-Y 0-N)",7,0,0,2,9
1808434,1380702,2024-02-09,House,"House: Reported from Appropriations with substitute (20-Y 0-N)",20,0,0,2,22
1808434,1383035,2024-02-13,House,"House: VOTE: Passage (95-Y 3-N)",95,3,0,2,100
1808434,1394486,2024-02-26,Senate,"Senate: Reported from Courts of Justice (15-Y 0-N)",15,0,0,0,15
1808434,1398184,2024-02-28,Senate,"Senate: Reported from Finance and Appropriations with amendments (15-Y 0-N)",15,0,0,0,15
1808434,1399826,2024-02-29,Senate,"Senate: Constitutional reading dispensed (39-Y 0-N)",39,0,0,1,40
1808434,1400903,2024-03-01,Senate,"Senate: Passed Senate with amendments (40-Y 0-N)",40,0,0,0,40
1808434,1402091,2024-03-04,House,"House: VOTE: REJECTED (3-Y 93-N)",3,93,0,4,100
1808434,1403251,2024-03-05,Senate,"Senate: Senate insisted on amendments (40-Y 0-N)",40,0,0,0,40
1808434,1406505,2024-03-08,Senate,"Senate: Conference report agreed to by Senate (40-Y 0-N)",40,0,0,0,40
1808434,1406506,2024-03-08,House,"House: VOTE: Adoption (99-Y 0-N)",99,0,0,1,100
1808435,1368099,2024-01-23,House,"House: Subcommittee recommends reporting (8-Y 0-N)",8,0,0,0,8
1808435,1369247,2024-01-25,House,"House: Reported from General Laws (22-Y 0-N)",22,0,0,0,22
1808435,1372747,2024-01-31,House,"House: VOTE: Block Vote Passage (100-Y 0-N)",100,0,0,0,100
1808435,1384494,2024-02-14,Senate,"Senate: Reported from General Laws and Technology with substitute (14-Y 1-N)",14,1,0,0,15
1808435,1386746,2024-02-16,Senate,"Senate: Constitutional reading dispensed (38-Y 0-N)",38,0,0,2,40
1808435,1387406,2024-02-19,Senate,"Senate: Passed Senate with substitute (26-Y 12-N)",26,12,0,2,40
1808435,1390069,2024-02-21,House,"House: VOTE: Adoption (95-Y 3-N)",95,3,0,2,100
1808436,1374008,2024-02-01,House,"House: Subcommittee recommends reporting (5-Y 3-N)",5,3,0,0,8
1808436,1379535,2024-02-08,House,"House: Reported from Health and Human Services (12-Y 10-N)",12,10,0,0,22
1808438,1379123,2024-02-08,House,"House: Subcommittee recommends laying on the table (5-Y 2-N)",5,2,0,1,8
1808441,1373612,2024-02-01,Senate,"Senate: Incorporated by Education and Health ",15,0,0,0,15
1808442,1379447,2024-02-08,House,"House: Subcommittee recommends laying on the table (3-Y 2-N)",3,2,0,0,5
1808444,1366420,2024-01-17,Senate,"Senate: Reported from General Laws and Technology with amendment (15-Y 0-N)",15,0,0,0,15
1808444,1366518,2024-01-17,Senate,"Senate: Reported from General Laws and Technology with amendments (15-Y 0-N)",15,0,0,0,15
1808444,1368854,2024-01-19,Senate,"Senate: Constitutional reading dispensed (37-Y 0-N)",37,0,0,3,40
1808444,1368855,2024-01-23,Senate,"Senate: Read third time and passed Senate (39-Y 0-N)",39,0,0,1,40
1808444,1386282,2024-02-15,House,"House: Reported from General Laws (22-Y 0-N)",22,0,0,0,22
1808444,1388579,2024-02-20,House,"House: VOTE: Block Vote Passage (98-Y 0-N)",98,0,0,2,100
1808445,1375622,2024-02-05,Senate,"Senate: Reported from Courts of Justice (15-Y 0-N)",15,0,0,0,15
1808445,1377576,2024-02-06,Senate,"Senate: Constitutional reading dispensed (39-Y 0-N)",39,0,0,1,40
1808445,1378681,2024-02-07,Senate,"Senate: Constitutional reading dispensed (40-Y 0-N)",40,0,0,0,40
1808445,1378682,2024-02-07,Senate,"Senate: Passed Senate (40-Y 0-N)",40,0,0,0,40
1808445,1392538,2024-02-22,House,"House: Subcommittee recommends reporting (8-Y 0-N)",8,0,0,0,8
1808445,1396771,2024-02-27,House,"House: Reported from General Laws with amendment(s) (22-Y 0-N)",22,0,0,0,22
1808445,1400771,2024-03-01,House,"House: VOTE: Passage (85-Y 12-N)",85,12,0,3,100
1808445,1403315,2024-03-05,Senate,"Senate: House amendment rejected by Senate (1-Y 39-N)",1,39,0,0,40
1808445,1405352,2024-03-07,Senate,"Senate: Senate acceded to request (40-Y 0-N)",40,0,0,0,40
1808445,1406766,2024-03-09,House,"House: VOTE: Adoption (74-Y 24-N)",74,24,0,2,100
1808445,1406767,2024-03-09,Senate,"Senate: Conference report agreed to by Senate (40-Y 0-N)",40,0,0,0,40
1808445,1429684,2024-04-17,Senate,"Senate: Senate concurred in Governor's recommendation (40-Y 0-N)",40,0,0,0,40
1808445,1430857,2024-04-17,House,"House: VOTE: Adoption (85-Y 15-N)",85,15,0,0,100
1808446,1379069,2024-02-08,House,"House: Subcommittee recommends laying on the table (5-Y 1-N)",5,1,1,1,8
1808448,1369720,2024-01-25,Senate,"Senate: Reported from Transportation (10-Y 5-N)",10,5,0,0,15
1808448,1370421,2024-01-29,Senate,"Senate: Constitutional reading dispensed (39-Y 0-N)",39,0,0,1,40
1808448,1372699,2024-01-31,Senate,"Senate: Read third time and passed Senate (22-Y 18-N)",22,18,0,0,40
1808448,1388359,2024-02-20,House,"House: Subcommittee recommends reporting with substitute (5-Y 3-N)",5,3,0,0,8
1808448,1391512,2024-02-22,House,"House: Reported from Transportation with substitute (17-Y 5-N)",17,5,0,0,22
1808448,1398637,2024-02-28,House,"House: VOTE: Passage (73-Y 26-N)",73,26,0,1,100
1808448,1400947,2024-03-01,Senate,"Senate: House substitute agreed to by Senate (22-Y 17-N)",22,17,0,1,40
1808451,1380516,2024-02-09,House,"House: Reported from Privileges and Elections with substitute (14-Y 8-N)",14,8,0,0,22
1808451,1383132,2024-02-13,House,"House: VOTE: Passage (53-Y 45-N)",53,45,0,2,100
1808451,1396640,2024-02-27,Senate,"Senate: Reported from Privileges and Elections with amendments (8-Y 7-N)",8,7,0,0,15
1808451,1399373,2024-02-29,Senate,"Senate: Reported from Finance and Appropriations (10-Y 4-N)",10,4,0,0,14
1808451,1401867,2024-03-04,Senate,"Senate: Constitutional reading dispensed (40-Y 0-N)",40,0,0,0,40
1808451,1402904,2024-03-05,Senate,"Senate: Passed Senate with amendments (21-Y 19-N)",21,19,0,0,40
1808451,1404165,2024-03-06,House,"House: VOTE: Adoption (54-Y 45-N)",54,45,0,1,100
1808451,1429774,2024-04-17,House,"House: VOTE: Adoption (0-Y 99-N)",0,99,0,1,100
1808454,1368859,2024-01-24,House,"House: Subcommittee recommends reporting with amendments (8-Y 0-N)",8,0,0,1,9
1808454,1369803,2024-01-26,House,"House: Reported from Courts of Justice with amendment(s) (21-Y 0-N)",21,0,0,1,22
1808454,1373890,2024-02-01,House,"House: VOTE: Block Vote Passage (99-Y 0-N)",99,0,0,1,100
1808454,1387355,2024-02-19,Senate,"Senate: Reported from Courts of Justice (14-Y 0-N)",14,0,0,0,14
1808454,1389540,2024-02-20,Senate,"Senate: Constitutional reading dispensed (39-Y 0-N)",39,0,0,1,40
1808454,1389875,2024-02-21,Senate,"Senate: Passed Senate (40-Y 0-N)",40,0,0,0,40
1808455,1370888,2024-01-29,House,"House: Subcommittee recommends reporting with substitute (6-Y 2-N)",6,2,0,1,9
1808455,1375611,2024-02-02,House,"House: Reported from Courts of Justice with substitute (17-Y 4-N)",17,4,0,1,22
1808455,1379718,2024-02-08,House,"House: VOTE: Passage (73-Y 24-N)",73,24,0,3,100
1808455,1387357,2024-02-19,Senate,"Senate: Reported from Courts of Justice (11-Y 0-N)",11,0,0,0,11
1808455,1395589,2024-02-27,Senate,"Senate: Reported from Finance and Appropriations (15-Y 0-N)",15,0,0,0,15
1808455,1396944,2024-02-27,Senate,"Senate: Constitutional reading dispensed (39-Y 0-N)",39,0,0,1,40
1808455,1397867,2024-02-28,Senate,"Senate: Passed Senate (39-Y 0-N)",39,0,0,1,40
1808457,1367791,2024-01-23,House,"House: Subcommittee recommends reporting with amendments (8-Y 0-N)",8,0,0,0,8
1808457,1369463,2024-01-25,House,"House: Reported from Transportation with amendment(s) (21-Y 0-N)",21,0,0,1,22
1808457,1373167,2024-01-31,House,"House: VOTE: Block Vote Passage (100-Y 0-N)",100,0,0,0,100
1808457,1386873,2024-02-15,Senate,"Senate: Reported from Transportation (12-Y 0-N)",12,0,0,0,12
1808457,1387952,2024-02-19,Senate,"Senate: Constitutional reading dispensed (38-Y 0-N)",38,0,0,2,40
1808457,1389122,2024-02-20,Senate,"Senate: Passed Senate (40-Y 0-N)",40,0,0,0,40
1808458,1376799,2024-02-06,House,"House: Subcommittee recommends reporting with substitute (8-Y 0-N)",8,0,0,0,8
1808458,1378387,2024-02-07,House,"House: Reported from Education with substitute (13-Y 9-N)",13,9,0,0,22
1808458,1382908,2024-02-13,House,"House: VOTE: Passage (52-Y 47-N)",52,47,0,1,100
1808458,1399153,2024-02-29,Senate,"Senate: Reported from Education and Health with amendment (15-Y 0-N)",15,0,0,0,15
1808458,1400989,2024-03-01,Senate,"Senate: Constitutional reading dispensed (40-Y 0-N)",40,0,0,0,40
1808458,1401639,2024-03-04,Senate,"Senate: Passed Senate with amendment",39,0,0,1,40
1808458,1402769,2024-03-05,House,"House: VOTE: Adoption (52-Y 47-N)",52,47,0,1,100
1808462,1366519,2024-01-18,Senate,"Senate: Reported from Education and Health with substitute (15-Y 0-N)",15,0,0,0,15
1808462,1371390,2024-01-30,Senate,"Senate: Reported from Finance and Appropriations (15-Y 0-N)",15,0,0,0,15
1808462,1373275,2024-01-31,Senate,"Senate: Constitutional reading dispensed (40-Y 0-N)",40,0,0,0,40
1808462,1432046,2024-02-15,House,"House: Reported from Health and Human Services (22-Y 0-N)",22,0,0,0,22
1808462,1432047,2024-02-20,House,"House: VOTE: Block Vote Passage (98-Y 0-N)",98,0,0,2,100
1808463,1377549,2024-02-06,House,"House: Subcommittee recommends reporting (7-Y 0-N)",7,0,0,1,8
1808463,1380292,2024-02-08,House,"House: Reported from General Laws (20-Y 0-N)",20,0,0,2,22
1808463,1383943,2024-02-13,House,"House: VOTE: Block Vote Passage (99-Y 0-N)",99,0,0,1,100
1808463,1390386,2024-02-21,Senate,"Senate: Reported from General Laws and Technology (9-Y 0-N)",9,0,0,0,9
1808463,1393643,2024-02-23,Senate,"Senate: Constitutional reading dispensed (38-Y 0-N)",38,0,0,2,40
1808463,1394792,2024-02-26,Senate,"Senate: Passed Senate (40-Y 0-N)",40,0,0,0,40
1808464,1374676,2024-02-02,House,"House: Subcommittee recommends reporting (8-Y 0-N)",8,0,0,1,9
1808464,1374677,2024-02-02,House,"House: Reported from Appropriations (22-Y 0-N)",22,0,0,0,22
1808464,1379957,2024-02-08,House,"House: VOTE: Block Vote Passage (98-Y 0-N)",98,0,0,2,100
1808464,1390131,2024-02-21,Senate,"Senate: Reported from Finance and Appropriations (14-Y 0-N)",14,0,0,0,14
1808464,1392594,2024-02-22,Senate,"Senate: Constitutional reading dispensed (40-Y 0-N)",40,0,0,0,40
1808464,1394003,2024-02-23,Senate,"Senate: Passed Senate (39-Y 0-N)",39,0,0,1,40
1808466,1367194,2024-01-22,House,"House: Stricken from docket by Education (21-Y 0-N)",21,0,0,1,22
1808470,1377365,2024-02-06,House,"House: Subcommittee recommends reporting (8-Y 0-N)",8,0,0,1,9
1808470,1380126,2024-02-08,House,"House: Reported from General Laws (19-Y 0-N)",19,0,0,3,22
1808470,1383503,2024-02-13,House,"House: VOTE: Block Vote Passage (99-Y 0-N)",99,0,0,1,100
1808470,1390801,2024-02-21,Senate,"Senate: Reported from General Laws and Technology (15-Y 0-N)",15,0,0,0,15
1808470,1393788,2024-02-23,Senate,"Senate: Constitutional reading dispensed (38-Y 0-N)",38,0,0,2,40
1808470,1394563,2024-02-26,Senate,"Senate: Passed Senate (40-Y 0-N)",40,0,0,0,40
1808471,1372790,2024-01-31,House,"House: Subcommittee recommends reporting with substitute (8-Y 0-N)",8,0,0,0,8
1808471,1375610,2024-02-05,House,"House: Reported from Education with substitute (22-Y 0-N)",22,0,0,0,22
1808471,1381033,2024-02-09,House,"House: VOTE: Block Vote Passage (96-Y 0-N)",96,0,0,4,100
1808471,1385342,2024-02-15,Senate,"Senate: Reported from Education and Health (13-Y 0-N)",13,0,0,0,13
1808471,1386614,2024-02-16,Senate,"Senate: Constitutional reading dispensed (38-Y 0-N)",38,0,0,2,40
1808471,1388028,2024-02-19,Senate,"Senate: Passed Senate (39-Y 0-N)",39,0,0,1,40
1808474,1371908,2024-01-30,House,"House: Subcommittee recommends reporting with substitute (8-Y 0-N)",8,0,0,0,8
1808474,1372709,2024-01-31,House,"House: Reported from Education with substitute (21-Y 0-N)",21,0,0,1,22
1808474,1376293,2024-02-05,House,"House: Subcommittee recommends laying on the table (8-Y 0-N)",8,0,0,1,9
1808476,1375032,2024-02-02,House,"House: Subcommittee recommends reporting with substitute (8-Y 0-N)",8,0,0,1,9
1808476,1378622,2024-02-07,House,"House: Reported from Courts of Justice with substitute (22-Y 0-N)",22,0,0,0,22
1808476,1383957,2024-02-13,House,"House: VOTE: Block Vote Passage (99-Y 0-N)",99,0,0,1,100
1808476,1394479,2024-02-26,Senate,"Senate: Reported from Courts of Justice (15-Y 0-N)",15,0,0,0,15
1808476,1396044,2024-02-27,Senate,"Senate: Constitutional reading dispensed (39-Y 0-N)",39,0,0,1,40
1808476,1398758,2024-02-28,Senate,"Senate: Passed Senate (38-Y 1-N)",38,1,0,1,40
1808477,1369416,2024-01-25,House,"House: Subcommittee recommends reporting with substitute (5-Y 3-N)",5,3,0,0,8
1808477,1372068,2024-01-30,House,"House: Reported from Labor and Commerce with substitute (12-Y 10-N)",12,10,0,0,22
1808478,1369005,2024-01-25,House,"House: Subcommittee recommends reporting (5-Y 1-N)",5,1,0,0,6
1808478,1369751,2024-01-26,House,"House: Reported from Public Safety (21-Y 1-N)",21,1,0,0,22
1808478,1373807,2024-02-01,House,"House: VOTE: Passage (100-Y 0-N)",100,0,0,0,100
1808478,1400363,2024-03-01,Senate,"Senate: Reported from Rehabilitation and Social Services with amendments (14-Y 0-N)",14,0,0,0,14
1808478,1401892,2024-03-04,Senate,"Senate: Constitutional reading dispensed (40-Y 0-N)",40,0,0,0,40
1808478,1403003,2024-03-05,Senate,"Senate: Passed Senate with amendments (40-Y 0-N)",40,0,0,0,40
1808478,1404261,2024-03-06,House,"House: VOTE: Adoption (83-Y 16-N)",83,16,0,1,100
1808479,1371230,2024-01-29,House,"House: Subcommittee recommends reporting with substitute (9-Y 1-N)",9,1,0,0,10
1808479,1373129,2024-01-31,House,"House: Reported from Agriculture, Chesapeake and Natural Resources with substitute (21-Y 1-N)",21,1,0,0,22
1808479,1377483,2024-02-06,House,"House: VOTE: Passage (98-Y 1-N)",98,1,0,1,100
1808479,1386845,2024-02-16,Senate,"Senate: Reported from Agriculture, Conservation and Natural Resources (12-Y 0-N)",12,0,0,0,12
1808479,1398155,2024-02-28,Senate,"Senate: Reported from Finance and Appropriations (15-Y 0-N)",15,0,0,0,15
1808479,1399822,2024-02-29,Senate,"Senate: Constitutional reading dispensed (39-Y 0-N)",39,0,0,1,40
1808479,1400831,2024-03-01,Senate,"Senate: Passed Senate (40-Y 0-N)",40,0,0,0,40
1808481,1366485,2024-01-18,Senate,"Senate: Reported from Education and Health (15-Y 0-N)",15,0,0,0,15
1808481,1368598,2024-01-19,Senate,"Senate: Constitutional reading dispensed (37-Y 0-N)",37,0,0,3,40
1808481,1368599,2024-01-23,Senate,"Senate: Read third time and passed Senate (37-Y 0-N)",37,0,0,3,40
1808481,1388295,2024-02-20,House,"House: Subcommittee recommends reporting with substitute (8-Y 0-N)",8,0,0,0,8
1808481,1389796,2024-02-21,House,"House: Reported from Education with substitute (20-Y 2-N)",20,2,0,0,22
1808481,1394934,2024-02-26,House,"House: VOTE: Passage (88-Y 8-N)",88,8,0,4,100
1808481,1397845,2024-02-28,Senate,"Senate: House substitute rejected by Senate (0-Y 39-N)",0,39,0,1,40
1808481,1402058,2024-03-04,Senate,"Senate: Senate acceded to request (38-Y 0-N)",38,0,0,2,40
1808481,1404430,2024-03-06,House,"House: VOTE: Adoption (92-Y 6-N)",92,6,0,2,100
1808481,1405319,2024-03-07,Senate,"Senate: Conference report agreed to by Senate (39-Y 1-N)",39,1,0,0,40
1808482,1374033,2024-02-01,Senate,"Senate: Reported from Education and Health with substitute (15-Y 0-N)",15,0,0,0,15
1808482,1432186,2024-02-12,Senate,"Senate: Continued to 2025 in Finance and Appropriations (15-Y 0-N)",15,0,0,0,15
1808483,1373463,2024-01-31,House,"House: Subcommittee recommends reporting with amendments (7-Y 1-N)",7,1,0,0,8
1808483,1377117,2024-02-06,House,"House: Reported from Transportation with amendment(s) (11-Y 10-N)",11,10,0,1,22
1808483,1382449,2024-02-12,House,"House: VOTE: Passage (52-Y 47-N)",52,47,0,1,100
1808483,1400648,2024-02-29,Senate,"Senate: Failed to report (defeated) in Transportation (5-Y 9-N)",5,9,0,0,14
1808485,1373024,2024-01-31,House,"House: Subcommittee recommends reporting with substitute (8-Y 2-N)",8,2,0,0,10
1808485,1378226,2024-02-07,House,"House: Reported from Agriculture, Chesapeake and Natural Resources with substitute (20-Y 2-N)",20,2,0,0,22
1808486,1374314,2024-02-01,House,"House: Subcommittee recommends reporting with substitute (8-Y 0-N)",8,0,0,0,8
1808486,1376833,2024-02-06,House,"House: Reported from Health and Human Services with substitute (22-Y 0-N)",22,0,0,0,22
1808486,1382046,2024-02-12,House,"House: VOTE: Block Vote Passage (100-Y 0-N)",100,0,0,0,100
1808486,1400706,2024-03-01,Senate,"Senate: Reported from Rehabilitation and Social Services (14-Y 0-N)",14,0,0,0,14
1808486,1401467,2024-03-04,Senate,"Senate: Reported from Finance and Appropriations with substitute (15-Y 0-N)",15,0,0,0,15
1808486,1403322,2024-03-05,Senate,"Senate: Constitutional reading dispensed (39-Y 0-N)",39,0,0,1,40
1808486,1404245,2024-03-06,Senate,"Senate: Passed Senate with substitute (40-Y 0-N)",40,0,0,0,40
1808486,1405911,2024-03-07,House,"House: VOTE: Adoption (98-Y 1-N)",98,1,0,1,100
1808487,1374251,2024-02-01,House,"House: Subcommittee recommends reporting with substitute (8-Y 0-N)",8,0,0,0,8
1808487,1377345,2024-02-06,House,"House: Reported from Health and Human Services with substitute (22-Y 0-N)",22,0,0,0,22
1808487,1381767,2024-02-12,House,"House: VOTE: Block Vote Passage (100-Y 0-N)",100,0,0,0,100
1808487,1394371,2024-02-26,Senate,"Senate: Reported from Local Government (12-Y 3-N)",12,3,0,0,15
1808487,1396551,2024-02-27,Senate,"Senate: Constitutional reading dispensed (39-Y 0-N)",39,0,0,1,40
1808487,1397959,2024-02-28,Senate,"Senate: Defeated by Senate (19-Y 20-N)",19,20,0,1,40
1808487,1397960,2024-02-28,Senate,"Senate: Reconsideration of defeated action agreed to by Senate (38-Y 0-N)",38,0,0,2,40
1808487,1397961,2024-02-28,Senate,"Senate: Defeated by Senate (18-Y 21-N)",18,21,0,1,40
1808488,1370431,2024-01-29,House,"House: Subcommittee recommends reporting (6-Y 0-N)",6,0,0,0,6
1808488,1373681,2024-02-01,House,"House: Reported from Rules (18-Y 0-N)",18,0,0,0,18
1808488,1378332,2024-02-07,House,"House: Subcommittee recommends reporting with substitute (8-Y 0-N)",8,0,0,1,9
1808488,1378333,2024-02-07,House,"House: Reported from Appropriations with substitute (22-Y 0-N)",22,0,0,0,22
1808488,1382029,2024-02-12,House,"House: VOTE: Block vote adoption (97-Y 0-N)",97,0,0,3,100
1808488,1402218,2024-03-04,Senate,"Senate: Reading waived (40-Y 0-N)",40,0,0,0,40
1808601,1374352,2024-02-01,House,"House: Reported from Rules (18-Y 0-N)",18,0,0,0,18
1808601,1377746,2024-02-06,House,"House: VOTE: Block Vote Adoption (98-Y 0-N)",98,0,0,2,100
1808601,1394383,2024-02-26,Senate,"Senate: Reading waived (40-Y 0-N)",40,0,0,0,40
1808605,1373600,2024-02-01,House,"House: Subcommittee recommends reporting with substitute (5-Y 2-N)",5,2,0,1,8
1808605,1374903,2024-02-02,House,"House: Reported from Counties, Cities and Towns with substitute (12-Y 10-N)",12,10,0,0,22
1808605,1379985,2024-02-08,House,"House: VOTE: Passage (51-Y 47-N)",51,47,0,2,100
1808605,1394367,2024-02-26,Senate,"Senate: Reported from Local Government (8-Y 7-N)",8,7,0,0,15
1808605,1396559,2024-02-27,Senate,"Senate: Constitutional reading dispensed (39-Y 0-N)",39,0,0,1,40
1808605,1398007,2024-02-28,Senate,"Senate: Passed Senate (22-Y 17-N)",22,17,0,1,40
1808609,1371447,2024-01-30,House,"House: Referred from Transportation (22-Y 0-N)",22,0,0,0,22
1808614,1374693,2024-02-02,House,"House: Subcommittee recommends striking from docket (8-Y 0-N)",8,0,0,0,8
1808619,1368270,2024-01-24,House,"House: Subcommittee recommends reporting (10-Y 0-N)",10,0,0,0,10
1808619,1372413,2024-01-31,House,"House: Reported from Agriculture, Chesapeake and Natural Resources (22-Y 0-N)",22,0,0,0,22
1808619,1377322,2024-02-06,House,"House: VOTE: Block Vote Passage (99-Y 0-N)",99,0,0,1,100
1808619,1387371,2024-02-19,Senate,"Senate: Reported from Courts of Justice (14-Y 0-N)",14,0,0,0,14
1808619,1388607,2024-02-20,Senate,"Senate: Constitutional reading dispensed (39-Y 0-N)",39,0,0,1,40
1808619,1390527,2024-02-21,Senate,"Senate: Passed Senate (40-Y 0-N)",40,0,0,0,40
1808626,1379468,2024-02-08,House,"House: Subcommittee recommends reporting with substitute (5-Y 3-N)",5,3,0,0,8
1808626,1380425,2024-02-08,House,"House: Reported from General Laws with substitute (12-Y 8-N)",12,8,0,2,22
1808626,1382906,2024-02-13,House,"House: VOTE: Passage (51-Y 48-N)",51,48,0,1,100
1808626,1398689,2024-02-28,Senate,"Senate: Reported from General Laws and Technology (9-Y 6-N)",9,6,0,0,15
1808626,1401271,2024-03-01,Senate,"Senate: Constitutional reading dispensed (40-Y 0-N)",40,0,0,0,40
1808626,1402949,2024-03-05,Senate,"Senate: Passed Senate (21-Y 19-N)",21,19,0,0,40
1808626,1430259,2024-04-17,House,"House: VOTE: Adoption (0-Y 100-N)",0,100,0,0,100
1808631,1376313,2024-02-05,House,"House: Subcommittee recommends laying on the table (5-Y 3-N)",5,3,0,1,9
1808636,1377586,2024-02-06,House,"House: Subcommittee recommends reporting with amendments (7-Y 0-N)",7,0,0,1,8
1808636,1379960,2024-02-08,House,"House: Reported from General Laws with amendment(s) (16-Y 4-N)",16,4,0,2,22
1808636,1383146,2024-02-13,House,"House: VOTE: Passage (75-Y 23-N)",75,23,0,2,100
1808636,1398299,2024-02-28,Senate,"Senate: Reported from General Laws and Technology (15-Y 0-N)",15,0,0,0,15
1808636,1401116,2024-03-01,Senate,"Senate: Constitutional reading dispensed (40-Y 0-N)",40,0,0,0,40
1808636,1402335,2024-03-04,Senate,"Senate: Passed Senate (39-Y 0-N)",39,0,0,1,40
1808647,1370951,2024-01-29,House,"House: Subcommittee recommends laying on the table (6-Y 4-N)",6,4,0,0,10
1808658,1376417,2024-02-05,House,"House: Subcommittee recommends continuing to 2025 (7-Y 0-N)",7,0,0,1,8
1808663,1369468,2024-01-25,House,"House: Reported from Health and Human Services (22-Y 0-N)",22,0,0,0,22
1808663,1372899,2024-01-31,House,"House: VOTE: Passage (100-Y 0-N)",100,0,0,0,100
1808663,1385354,2024-02-15,Senate,"Senate: Rereferred from Education and Health (12-Y 0-N)",12,0,0,0,12
1808663,1400680,2024-03-01,Senate,"Senate: Reported from Rehabilitation and Social Services (14-Y 0-N)",14,0,0,0,14
1808663,1401834,2024-03-04,Senate,"Senate: Constitutional reading dispensed (40-Y 0-N)",40,0,0,0,40
1808663,1403155,2024-03-05,Senate,"Senate: Passed Senate (40-Y 0-N)",40,0,0,0,40
1808678,1367957,2024-01-23,House,"House: Subcommittee recommends laying on the table (8-Y 0-N)",8,0,0,1,9
1808684,1378584,2024-02-07,House,"House: Subcommittee failed to recommend reporting (3-Y 5-N)",3,5,0,0,8
1808690,1367090,2024-01-19,House,"House: Subcommittee recommends reporting (5-Y 3-N)",5,3,0,1,9
1808690,1369869,2024-01-26,House,"House: Reported from Courts of Justice (13-Y 7-N)",13,7,0,2,22
1808690,1373719,2024-02-01,House,"House: VOTE: Passage (56-Y 43-N)",56,43,0,1,100
1808690,1384368,2024-02-14,Senate,"Senate: Reported from Courts of Justice (9-Y 0-N)",9,0,0,0,9
1808690,1386655,2024-02-16,Senate,"Senate: Constitutional reading dispensed (38-Y 0-N)",38,0,0,2,40
1808690,1387386,2024-02-19,Senate,"Senate: Passed Senate (38-Y 1-N)",38,1,0,1,40
1808696,1380798,2024-02-09,House,"House: Reported from Finance with substitute (12-Y 7-N)",12,7,0,3,22
1808696,1383487,2024-02-13,House,"House: VOTE: Passage (79-Y 19-N)",79,19,0,2,100
1808696,1395852,2024-02-27,Senate,"Senate: Constitutional reading dispensed (39-Y 0-N)",39,0,0,1,40
1808696,1395853,2024-02-27,Senate,"Senate: Reported from Finance and Appropriations with substitute (15-Y 0-N)",15,0,0,0,15
1808696,1398284,2024-02-28,Senate,"Senate: Passed Senate with substitute (39-Y 0-N)",39,0,0,1,40
1808696,1398285,2024-02-28,House,"House: VOTE: Adoption (89-Y 9-N)",89,9,0,2,100
1808702,1369023,2024-01-25,House,"House: Subcommittee recommends striking from docket (8-Y 0-N)",8,0,0,1,9
1808707,1370301,2024-01-29,House,"House: Subcommittee recommends laying on the table (7-Y 1-N)",7,1,0,1,9
1808712,1374365,2024-02-01,House,"House: Subcommittee recommends striking from docket (8-Y 0-N)",8,0,0,0,8
1808712,1377699,2024-02-06,House,"House: Stricken from docket by General Laws (20-Y 0-N)",20,0,0,2,22
1808719,1370910,2024-01-29,House,"House: Subcommittee recommends reporting (8-Y 0-N)",8,0,0,1,9
1808719,1375845,2024-02-02,House,"House: Reported from Courts of Justice (20-Y 0-N)",20,0,0,2,22
1808719,1380045,2024-02-08,House,"House: VOTE: Block Vote Passage (98-Y 0-N)",98,0,0,2,100
1808719,1390865,2024-02-21,Senate,"Senate: Reported from Courts of Justice (15-Y 0-N)",15,0,0,0,15
1808719,1394035,2024-02-23,Senate,"Senate: Constitutional reading dispensed (38-Y 0-N)",38,0,0,2,40
1808719,1395279,2024-02-26,Senate,"Senate: Passed Senate (40-Y 0-N)",40,0,0,0,40
1808725,1373066,2024-01-31,House,"House: Subcommittee recommends reporting with substitute (10-Y 0-N)",10,0,0,0,10
1808725,1378833,2024-02-07,House,"House: Reported from Agriculture, Chesapeake and Natural Resources (22-Y 0-N)",22,0,0,0,22
1808725,1380663,2024-02-09,House,"House: Subcommittee recommends reporting (8-Y 0-N)",8,0,0,1,9
1808725,1380664,2024-02-09,House,"House: Reported from Appropriations (19-Y 0-N)",19,0,0,3,22
1808725,1382923,2024-02-13,House,"House: VOTE: Block Vote Passage (99-Y 0-N)",99,0,0,1,100
1808725,1396963,2024-02-27,Senate,"Senate: Reported from Agriculture, Conservation and Natural Resources with substitute (14-Y 0-N)",14,0,0,0,14
1808725,1399409,2024-02-29,Senate,"Senate: Reported from Finance and Appropriations (14-Y 0-N)",14,0,0,0,14
1808725,1401813,2024-03-04,Senate,"Senate: Constitutional reading dispensed (40-Y 0-N)",40,0,0,0,40
1808725,1403137,2024-03-05,Senate,"Senate: Passed Senate with substitute (40-Y 0-N)",40,0,0,0,40
1808725,1404321,2024-03-06,House,"House: VOTE: Adoption (98-Y 0-N)",98,0,0,2,100
1808731,1370722,2024-01-29,Senate,"Senate: Reported from Courts of Justice with substitute (9-Y 6-N)",9,6,0,0,15
1808731,1371751,2024-01-30,Senate,"Senate: Constitutional reading dispensed (40-Y 0-N)",40,0,0,0,40
1808731,1376178,2024-02-05,Senate,"Senate: Engrossment reconsidered by Senate (40-Y 0-N)",40,0,0,0,40
1808731,1376179,2024-02-05,Senate,"Senate: Committee substitute reconsidered (40-Y 0-N)",40,0,0,0,40
1808731,1376180,2024-02-05,Senate,"Senate: Constitutional reading dispensed (40-Y 0-N)",40,0,0,0,40
1808731,1376181,2024-02-05,Senate,"Senate: Passed Senate (21-Y 19-N)",21,19,0,0,40
1808731,1387008,2024-02-16,House,"House: Reported from Courts of Justice with substitute (11-Y 9-N)",11,9,0,2,22
1808731,1390040,2024-02-21,House,"House: VOTE: Passage (49-Y 48-N)",49,48,0,3,100
1808731,1393897,2024-02-23,Senate,"Senate: House substitute rejected by Senate (0-Y 39-N)",0,39,0,1,40
1808731,1398407,2024-02-28,Senate,"Senate: Senate acceded to request (20-Y 19-N)",20,19,0,1,40
1808731,1406664,2024-03-09,House,"House: VOTE: Adoption (51-Y 47-N)",51,47,0,2,100
1808731,1406665,2024-03-09,Senate,"Senate: Conference report agreed to by Senate (21-Y 19-N)",21,19,0,0,40
1808737,1375632,2024-02-05,House,"House: Subcommittee recommends laying on the table (5-Y 3-N)",5,3,0,1,9
1808741,1373553,2024-02-01,House,"House: Subcommittee recommends reporting (8-Y 0-N)",8,0,0,0,8
1808741,1377363,2024-02-06,House,"House: Reported from Health and Human Services (22-Y 0-N)",22,0,0,0,22
1808741,1382065,2024-02-12,House,"House: VOTE: Block Vote Passage (100-Y 0-N)",100,0,0,0,100
1808741,1399104,2024-02-29,Senate,"Senate: Reported from Education and Health (15-Y 0-N)",15,0,0,0,15
1808741,1400945,2024-03-01,Senate,"Senate: Constitutional reading dispensed (40-Y 0-N)",40,0,0,0,40
1808741,1402254,2024-03-04,Senate,"Senate: Passed Senate (39-Y 0-N)",39,0,0,1,40
1808753,1374336,2024-02-01,House,"House: Subcommittee recommends reporting (5-Y 0-N)",5,0,0,3,8
1808753,1377563,2024-02-06,House,"House: Reported from General Laws (20-Y 0-N)",20,0,0,2,22
1808753,1382424,2024-02-12,House,"House: VOTE: Block Vote Passage (100-Y 0-N)",100,0,0,0,100
1808753,1391152,2024-02-21,Senate,"Senate: Reported from General Laws and Technology (15-Y 0-N)",15,0,0,0,15
1808753,1394078,2024-02-23,Senate,"Senate: Constitutional reading dispensed (38-Y 0-N)",38,0,0,2,40
1808753,1395272,2024-02-26,Senate,"Senate: Passed Senate (40-Y 0-N)",40,0,0,0,40
1808758,1372104,2024-01-30,House,"House: Subcommittee recommends laying on the table (6-Y 4-N)",6,4,0,0,10
1808765,1371468,2024-01-30,House,"House: Subcommittee recommends reporting (8-Y 0-N)",8,0,0,0,8
1808765,1373819,2024-02-01,House,"House: Reported from Transportation (22-Y 0-N)",22,0,0,0,22
1808765,1378913,2024-02-07,House,"House: VOTE: Block Vote Passage (100-Y 0-N)",100,0,0,0,100
1808765,1386426,2024-02-15,Senate,"Senate: Reported from Transportation (12-Y 0-N)",12,0,0,0,12
1808765,1388012,2024-02-19,Senate,"Senate: Constitutional reading dispensed (38-Y 0-N)",38,0,0,2,40
1808765,1389393,2024-02-20,Senate,"Senate: Passed Senate (40-Y 0-N)",40,0,0,0,40
1808771,1375203,2024-02-02,House,"House: Subcommittee recommends laying on the table (8-Y 0-N)",8,0,0,1,9
1808775,1372799,2024-01-31,House,"House: Subcommittee recommends laying on the table (6-Y 4-N)",6,4,0,0,10
1808780,1373354,2024-01-31,House,"House: Subcommittee recommends laying on the table (4-Y 3-N)",4,3,0,2,9
1808799,1364004,2024-01-10,Senate,"Senate: Rules suspended (39-Y 0-N)",39,0,0,1,40
1808799,1364005,2024-01-10,Senate,"Senate: Agreed to by Senate (39-Y 0-N)",39,0,0,1,40
1808799,1364321,2024-01-10,House,"House: VOTE: Adoption (99-Y 0-N)",99,0,0,1,100
1808803,1371483,2024-01-30,House,"House: Subcommittee recommends reporting (8-Y 0-N)",8,0,0,0,8
1808803,1373786,2024-02-01,House,"House: Reported from Transportation (22-Y 0-N)",22,0,0,0,22
1808803,1378731,2024-02-07,House,"House: VOTE: Block Vote Passage (100-Y 0-N)",100,0,0,0,100
1808803,1386421,2024-02-15,Senate,"Senate: Reported from Transportation (12-Y 0-N)",12,0,0,0,12
1808803,1388326,2024-02-19,Senate,"Senate: Constitutional reading dispensed (38-Y 0-N)",38,0,0,2,40
1808803,1389444,2024-02-20,Senate,"Senate: Passed Senate (40-Y 0-N)",40,0,0,0,40
1808810,1373311,2024-01-31,House,"House: Subcommittee recommends laying on the table (6-Y 2-N)",6,2,0,1,9
1808814,1368021,2024-01-23,House,"House: Subcommittee recommends reporting (6-Y 4-N)",6,4,0,0,10
1808814,1373900,2024-02-01,House,"House: Reported from Labor and Commerce with substitute (15-Y 7-N)",15,7,0,0,22
1808814,1378249,2024-02-07,House,"House: VOTE: Passage (58-Y 39-N)",58,39,0,3,100
1808814,1395201,2024-02-26,Senate,"Senate: Reported from Commerce and Labor (9-Y 6-N)",9,6,0,0,15
1808814,1398349,2024-02-28,Senate,"Senate: Constitutional reading dispensed (39-Y 0-N)",39,0,0,1,40
1808814,1399145,2024-02-29,Senate,"Senate: Passed Senate (20-Y 19-N)",20,19,0,1,40
1808822,1367196,2024-01-22,Senate,"Senate: Reported from Courts of Justice (9-Y 6-N)",9,6,0,0,15
1808822,1372811,2024-01-31,Senate,"Senate: Reported from Finance and Appropriations (10-Y 5-N)",10,5,0,0,15
1808822,1374256,2024-02-01,Senate,"Senate: Constitutional reading dispensed (40-Y 0-N)",40,0,0,0,40
1808822,1375914,2024-02-05,Senate,"Senate: Read third time and passed Senate (21-Y 19-N)",21,19,0,0,40
1808822,1391271,2024-02-22,House,"House: Subcommittee recommends reporting (6-Y 3-N)",6,3,0,1,10
1808822,1393215,2024-02-23,House,"House: Reported from Public Safety (12-Y 9-N)",12,9,0,1,22
1808822,1398295,2024-02-28,House,"House: VOTE: Passage (52-Y 47-N)",52,47,0,1,100
1808822,1430285,2024-04-17,Senate,"Senate: Senate concurred in Governor's recommendation (40-Y 0-N)",40,0,0,0,40
1808822,1430286,2024-04-17,House,"House: VOTE: Adoption (51-Y 49-N)",51,49,0,0,100
1808828,1368865,2024-01-24,House,"House: Subcommittee recommends striking from docket (8-Y 0-N)",8,0,0,1,9
1808833,1372080,2024-01-30,House,"House: Subcommittee recommends laying on the table (7-Y 0-N)",7,0,0,0,7
1808842,1367461,2024-01-22,House,"House: Reported from Communications, Technology and Innovation (16-Y 6-N)",16,6,0,0,22
1808842,1371188,2024-01-29,House,"House: Subcommittee recommends reporting (7-Y 0-N)",7,0,0,2,9
1808842,1372776,2024-01-31,House,"House: Reported from Appropriations (22-Y 0-N)",22,0,0,0,22
1808842,1376959,2024-02-06,House,"House: VOTE: Passage (68-Y 31-N)",68,31,0,1,100
1808842,1393316,2024-02-23,Senate,"Senate: Reported from Rules (15-Y 0-N)",15,0,0,0,15
1808842,1396188,2024-02-27,Senate,"Senate: Constitutional reading dispensed (39-Y 0-N)",39,0,0,1,40
1808842,1396189,2024-02-27,Senate,"Senate: Reported from Finance and Appropriations (15-Y 0-N)",15,0,0,0,15
1808842,1397745,2024-02-28,Senate,"Senate: Passed Senate (39-Y 0-N)",39,0,0,1,40
1808848,1367489,2024-01-22,Senate,"Senate: Reported from Commerce and Labor with amendment (9-Y 6-N)",9,6,0,0,15
1808848,1372718,2024-01-31,Senate,"Senate: Reported from Finance and Appropriations with substitute (10-Y 5-N)",10,5,0,0,15
1808848,1374175,2024-02-01,Senate,"Senate: Constitutional reading dispensed (40-Y 0-N)",40,0,0,0,40
1808848,1375839,2024-02-05,Senate,"Senate: Read third time and passed Senate (21-Y 19-N)",21,19,0,0,40
1808848,1389321,2024-02-20,House,"House: Reported from Labor and Commerce (12-Y 10-N)",12,10,0,0,22
1808848,1393442,2024-02-23,House,"House: VOTE: Passage (50-Y 48-N)",50,48,0,2,100
1808848,1430108,2024-04-17,Senate,"Senate: Passed in enrolled form rejected (21-Y 19-N)",21,19,0,0,40
1808862,1371050,2024-01-29,Senate,"Senate: Rereferred from Commerce and Labor (11-Y 0-N)",11,0,0,0,11
1808862,1378609,2024-02-07,Senate,"Senate: Reported from General Laws and Technology with substitute (15-Y 0-N)",15,0,0,0,15
1808862,1379940,2024-02-08,Senate,"Senate: Constitutional reading dispensed (40-Y 0-N)",40,0,0,0,40
1808862,1380894,2024-02-09,Senate,"Senate: Constitutional reading dispensed (40-Y 0-N)",40,0,0,0,40
1808862,1380895,2024-02-09,Senate,"Senate: Passed Senate (40-Y 0-N)",40,0,0,0,40
1808862,1396155,2024-02-27,House,"House: Reported from Labor and Commerce (21-Y 0-N)",21,0,0,1,22
1808862,1400565,2024-03-01,House,"House: VOTE: Block Vote Passage (97-Y 0-N)",97,0,0,3,100
1808862,1429602,2024-04-17,Senate,"Senate: Senate rejected Governor's recommendation (19-Y 21-N)",19,21,0,0,40
1808874,1372105,2024-01-30,House,"House: Subcommittee recommends laying on the table (6-Y 2-N)",6,2,0,0,8
1808879,1370034,2024-01-26,House,"House: Subcommittee recommends reporting (8-Y 0-N)",8,0,0,1,9
1808879,1375885,2024-02-02,House,"House: Reported from Courts of Justice (21-Y 0-N)",21,0,0,1,22
1808879,1380342,2024-02-08,House,"House: VOTE: Block Vote Passage (98-Y 0-N)",98,0,0,2,100
1808879,1398976,2024-02-28,Senate,"Senate: Reported from Courts of Justice (15-Y 0-N)",15,0,0,0,15
1808879,1401233,2024-03-01,Senate,"Senate: Constitutional reading dispensed (40-Y 0-N)",40,0,0,0,40
1808879,1402445,2024-03-04,Senate,"Senate: Passed Senate (39-Y 0-N)",39,0,0,1,40
1808886,1376722,2024-02-06,House,"House: Subcommittee recommends reporting with substitute (5-Y 3-N)",5,3,0,0,8
1808886,1379160,2024-02-08,House,"House: Reported from Transportation with substitute (12-Y 10-N)",12,10,0,0,22
1808886,1383438,2024-02-13,House,"House: VOTE: Passage (55-Y 43-N)",55,43,0,2,100
1808886,1392283,2024-02-22,Senate,"Senate: Reported from Transportation (8-Y 6-N)",8,6,0,0,14
1808886,1394387,2024-02-26,Senate,"Senate: Constitutional reading dispensed (40-Y 0-N)",40,0,0,0,40
1808886,1396589,2024-02-27,Senate,"Senate: Passed Senate (21-Y 17-N)",21,17,0,2,40
1808886,1430200,2024-04-17,House,"House: VOTE: Adoption (0-Y 100-N)",0,100,0,0,100
1808890,1374233,2024-02-01,House,"House: Subcommittee recommends laying on the table (8-Y 0-N)",8,0,0,0,8
1808895,1379262,2024-02-08,Senate,"Senate: Continued to 2025 in Education and Health (15-Y 0-N)",15,0,0,0,15
1808902,1370309,2024-01-29,House,"House: Subcommittee recommends laying on the table (6-Y 4-N)",6,4,0,0,10
1808919,1377445,2024-02-06,House,"House: Subcommittee recommends reporting (7-Y 0-N)",7,0,0,1,8
1808919,1380282,2024-02-08,House,"House: Reported from General Laws (20-Y 0-N)",20,0,0,2,22
1808919,1383953,2024-02-13,House,"House: VOTE: Block Vote Passage (99-Y 0-N)",99,0,0,1,100
1808919,1399643,2024-02-28,Senate,"Senate: Reported from General Laws and Technology with amendment (15-Y 0-N)",15,0,0,0,15
1808919,1401455,2024-03-04,Senate,"Senate: Continued to 2025 in Finance and Appropriations (10-Y 5-N)",10,5,0,0,15
1808925,1367532,2024-01-22,House,"House: Subcommittee recommends laying on the table (5-Y 3-N)",5,3,0,0,8
1808929,1369302,2024-01-25,House,"House: Subcommittee recommends reporting with amendments (8-Y 0-N)",8,0,0,0,8
1808929,1371615,2024-01-30,House,"House: Reported from Health and Human Services with amendment(s) (22-Y 0-N)",22,0,0,0,22
1808929,1376224,2024-02-05,House,"House: VOTE: Passage (97-Y 0-N)",97,0,0,3,100
1808929,1386872,2024-02-16,Senate,"Senate: Reported from Rehabilitation and Social Services (12-Y 0-N)",12,0,0,0,12
1808929,1387940,2024-02-19,Senate,"Senate: Constitutional reading dispensed (38-Y 0-N)",38,0,0,2,40
1808929,1388800,2024-02-20,Senate,"Senate: Passed Senate (40-Y 0-N)",40,0,0,0,40
1808929,1430267,2024-04-17,House,"House: VOTE: (100-Y 0-N)",100,0,0,0,100
1808929,1430268,2024-04-17,Senate,"Senate: Senate concurred in Governor's recommendation (40-Y 0-N)",40,0,0,0,40
1808935,1378453,2024-02-07,House,"House: Subcommittee recommends reporting with substitute (8-Y 0-N)",8,0,0,0,8
1808935,1379063,2024-02-08,House,"House: Reported from Health and Human Services with substitute (21-Y 0-N)",21,0,1,0,22
1808935,1382997,2024-02-13,House,"House: VOTE: Passage (98-Y 1-N)",98,1,0,1,100
1808935,1399100,2024-02-29,Senate,"Senate: Reported from Education and Health (15-Y 0-N)",15,0,0,0,15
1808935,1400967,2024-03-01,Senate,"Senate: Constitutional reading dispensed (40-Y 0-N)",40,0,0,0,40
1808935,1401654,2024-03-04,Senate,"Senate: Passed Senate (39-Y 0-N)",39,0,0,1,40
1808939,1367504,2024-01-22,House,"House: Subcommittee recommends laying on the table (7-Y 1-N)",7,1,0,0,8
1808951,1373224,2024-01-31,Senate,"Senate: Reported from General Laws and Technology with substitute (14-Y 0-N 1-A)",14,0,1,0,15
1808951,1377205,2024-02-06,Senate,"Senate: Read third time and passed Senate (28-Y 11-N)",28,11,0,1,40
1808951,1432123,2024-02-22,House,"House: Subcommittee recommends reporting with substitute (5-Y 2-N)",5,2,0,1,8
1808951,1432124,2024-02-27,House,"House: Reported from Labor and Commerce with substitute (15-Y 6-N)",15,6,0,1,22
1808951,1432125,2024-03-01,House,"House: VOTE: Passage (66-Y 30-N)",66,30,0,4,100
1808951,1432126,2024-03-05,Senate,"Senate: House substitute rejected by Senate (0-Y 40-N)",0,40,0,0,40
1808951,1432127,2024-03-07,Senate,"Senate: Senate acceded to request (40-Y 0-N)",40,0,0,0,40
1808951,1432128,2024-03-09,House,"House: VOTE: REJECTED (1-Y 96-N)",1,96,0,3,100
1808951,1432129,2024-03-09,Senate,"Senate: Senate acceded to request for second conference committee (40-Y 0-N)",40,0,0,0,40
1808951,1432130,2024-03-09,Senate,"Senate: Conference report agreed to by Senate (21-Y 18-N)",21,18,0,1,40
1808951,1432233,2024-03-09,House,"House: VOTE: REJECTED (46-Y 49-N)",46,49,0,5,100
1808951,1432234,2024-03-09,House,"House: VOTE: REJECTED #2 (49-Y 49-N)",49,49,0,2,100
1808967,1369426,2024-01-25,House,"House: Subcommittee recommends reporting with amendments (6-Y 0-N)",6,0,0,2,8
1808967,1371516,2024-01-30,House,"House: Reported from Health and Human Services with amendment(s) (22-Y 0-N)",22,0,0,0,22
1808967,1374794,2024-02-02,House,"House: Subcommittee recommends laying on the table (7-Y 0-N)",7,0,0,2,9
1808978,1377719,2024-02-06,House,"House: Subcommittee recommends reporting with substitute (7-Y 0-N)",7,0,0,0,7
1808978,1380123,2024-02-08,House,"House: Reported from Labor and Commerce with substitute (22-Y 0-N)",22,0,0,0,22
1808978,1383057,2024-02-13,House,"House: VOTE: Block Vote Passage (99-Y 0-N)",99,0,0,1,100
1808978,1394637,2024-02-26,Senate,"Senate: Reported from Commerce and Labor (15-Y 0-N)",15,0,0,0,15
1808978,1398406,2024-02-28,Senate,"Senate: Constitutional reading dispensed (39-Y 0-N)",39,0,0,1,40
1808978,1399189,2024-02-29,Senate,"Senate: Passed Senate (39-Y 0-N)",39,0,0,1,40
1808983,1370968,2024-01-29,House,"House: Subcommittee recommends laying on the table (6-Y 0-N)",6,0,0,0,6
1808992,1376358,2024-02-05,House,"House: Subcommittee recommends reporting with substitute (9-Y 1-N)",9,1,0,0,10
1808992,1378375,2024-02-07,House,"House: Reported from Agriculture, Chesapeake and Natural Resources with substitute (21-Y 1-N)",21,1,0,0,22
1808992,1380640,2024-02-09,House,"House: Subcommittee recommends reporting (5-Y 3-N)",5,3,0,1,9
1808992,1380641,2024-02-09,House,"House: Reported from Appropriations (11-Y 9-N)",11,9,0,2,22
1808992,1383673,2024-02-13,House,"House: VOTE: Passage (57-Y 41-N)",57,41,0,2,100
1808992,1396727,2024-02-27,Senate,"Senate: Reported from Agriculture, Conservation and Natural Resources (14-Y 0-N)",14,0,0,0,14
1808992,1399974,2024-02-29,Senate,"Senate: Reported from Finance and Appropriations with substitute (10-Y 4-N)",10,4,0,0,14
1808992,1400583,2024-02-29,Senate,"Senate: Reported from Finance and Appropriations with amendments (10-Y 4-N)",10,4,0,0,14
1808992,1401930,2024-03-04,Senate,"Senate: Constitutional reading dispensed (40-Y 0-N)",40,0,0,0,40
1808992,1403020,2024-03-05,Senate,"Senate: Passed Senate with amendments (24-Y 16-N)",24,16,0,0,40
1808992,1404250,2024-03-06,House,"House: VOTE: Adoption (52-Y 46-N)",52,46,0,2,100
1808997,1371155,2024-01-29,House,"House: Subcommittee recommends reporting (5-Y 2-N)",5,2,0,1,8
1808997,1374639,2024-02-02,House,"House: Reported from Privileges and Elections (12-Y 10-N)",12,10,0,0,22
1808997,1376356,2024-02-05,House,"House: Subcommittee recommends reporting (5-Y 3-N)",5,3,0,1,9
1808997,1378429,2024-02-07,House,"House: Reported from Appropriations (12-Y 10-N)",12,10,0,0,22
1808997,1382953,2024-02-13,House,"House: VOTE: Passage (50-Y 48-N)",50,48,0,2,100
1808997,1388957,2024-02-20,Senate,"Senate: Reported from Privileges and Elections (8-Y 7-N)",8,7,0,0,15
1808997,1395822,2024-02-27,Senate,"Senate: Constitutional reading dispensed (39-Y 0-N)",39,0,0,1,40
1808997,1395823,2024-02-27,Senate,"Senate: Reported from Finance and Appropriations (10-Y 5-N)",10,5,0,0,15
1808997,1398183,2024-02-28,Senate,"Senate: Passed Senate (20-Y 19-N)",20,19,0,1,40
1809012,1373374,2024-01-31,House,"House: Subcommittee recommends reporting with substitute (5-Y 3-N)",5,3,0,1,9
1809012,1375688,2024-02-02,House,"House: Reported from Courts of Justice with substitute (12-Y 9-N)",12,9,0,1,22
1809012,1380111,2024-02-08,House,"House: VOTE: Passage (51-Y 46-N)",51,46,0,3,100
1809012,1387287,2024-02-19,Senate,"Senate: Reported from Courts of Justice with substitute (13-Y 0-N)",13,0,0,0,13
1809012,1389136,2024-02-20,Senate,"Senate: Constitutional reading dispensed (39-Y 0-N)",39,0,0,1,40
1809012,1390399,2024-02-21,Senate,"Senate: Passed Senate with substitute (40-Y 0-N)",40,0,0,0,40
1809012,1393507,2024-02-23,House,"House: VOTE: Adoption (54-Y 42-N)",54,42,0,4,100
1809031,1373526,2024-02-01,House,"House: Subcommittee recommends laying on the table (6-Y 0-N)",6,0,0,0,6
1809035,1370917,2024-01-29,House,"House: Subcommittee recommends laying on the table (5-Y 3-N)",5,3,0,1,9
1809040,1373194,2024-01-31,House,"House: Subcommittee recommends striking from docket (8-Y 0-N)",8,0,0,0,8
1809051,1374650,2024-02-02,House,"House: Tabled in Privileges and Elections (21-Y 1-N)",21,1,0,0,22
1809066,1374350,2024-02-01,House,"House: Subcommittee recommends reporting with substitute (3-Y 2-N)",3,2,0,3,8
1809066,1377300,2024-02-06,House,"House: Reported from General Laws with substitute (11-Y 9-N)",11,9,0,2,22
1809066,1382425,2024-02-12,House,"House: VOTE: Passage (59-Y 41-N)",59,41,0,0,100
1809066,1391039,2024-02-21,Senate,"Senate: Reported from General Laws and Technology (9-Y 6-N)",9,6,0,0,15
1809066,1396176,2024-02-27,Senate,"Senate: Constitutional reading dispensed (39-Y 0-N)",39,0,0,1,40
1809066,1396177,2024-02-27,Senate,"Senate: Reported from Finance and Appropriations (10-Y 5-N)",10,5,0,0,15
1809066,1398706,2024-02-28,Senate,"Senate: Passed Senate (21-Y 18-N)",21,18,0,1,40
1809075,1377393,2024-02-06,Senate,"Senate: Continued to 2025 in Finance and Appropriations (12-Y 3-N)",12,3,0,0,15
1809085,1375851,2024-02-05,House,"House: Subcommittee recommends laying on the table (8-Y 0-N)",8,0,0,1,9
1809089,1369649,2024-01-25,House,"House: Subcommittee recommends reporting (8-Y 0-N)",8,0,0,0,8
1809089,1372222,2024-01-30,House,"House: Reported from General Laws (22-Y 0-N)",22,0,0,0,22
1809089,1376546,2024-02-05,House,"House: VOTE: Block Vote Passage (98-Y 0-N)",98,0,0,2,100
1809089,1392212,2024-02-22,Senate,"Senate: Reported from Education and Health (15-Y 0-N)",15,0,0,0,15
1809089,1393725,2024-02-23,Senate,"Senate: Constitutional reading dispensed (38-Y 0-N)",38,0,0,2,40
1809089,1394799,2024-02-26,Senate,"Senate: Passed Senate (40-Y 0-N)",40,0,0,0,40
1809099,1380534,2024-02-09,House,"House: Passed by indefinitely in Privileges and Elections (21-Y 1-N)",21,1,0,0,22
1809104,1368000,2024-01-23,House,"House: Subcommittee recommends laying on the table (8-Y 0-N)",8,0,0,0,8
1809109,1369026,2024-01-25,House,"House: Subcommittee recommends reporting with substitute (8-Y 0-N)",8,0,0,0,8
1809109,1371492,2024-01-30,House,"House: Reported from Health and Human Services with substitute (14-Y 8-N)",14,8,0,0,22
1809109,1375736,2024-02-05,House,"House: VOTE: Passage (56-Y 42-N)",56,42,0,2,100
1809109,1375737,2024-02-05,House,"House: VOTE: Passage #2 (55-Y 43-N)",55,43,0,2,100
1809109,1385448,2024-02-15,Senate,"Senate: Reported from Education and Health (11-Y 2-N)",11,2,0,0,13
1809109,1389850,2024-02-21,Senate,"Senate: Reported from Finance and Appropriations (14-Y 0-N)",14,0,0,0,14
1809109,1392035,2024-02-22,Senate,"Senate: Constitutional reading dispensed (40-Y 0-N)",40,0,0,0,40
1809109,1393599,2024-02-23,Senate,"Senate: Passed Senate (30-Y 9-N)",30,9,0,1,40
1809109,1393600,2024-02-23,Senate,"Senate: Reconsideration of Senate passage agreed to by Senate (39-Y 0-N)",39,0,0,1,40
1809109,1394386,2024-02-26,Senate,"Senate: Passed Senate (32-Y 7-N)",32,7,0,1,40
1809109,1430198,2024-04-17,House,"House: VOTE: Adoption (0-Y 100-N)",0,100,0,0,100
1809116,1371118,2024-01-29,House,"House: Subcommittee recommends reporting (8-Y 0-N)",8,0,0,0,8
1809116,1374644,2024-02-02,House,"House: Reported from Privileges and Elections (22-Y 0-N)",22,0,0,0,22
1809116,1379885,2024-02-08,House,"House: VOTE: Block Vote Passage (98-Y 0-N)",98,0,0,2,100
1809116,1389029,2024-02-20,Senate,"Senate: Reported from Privileges and Elections (15-Y 0-N)",15,0,0,0,15
1809116,1392275,2024-02-22,Senate,"Senate: Constitutional reading dispensed (40-Y 0-N)",40,0,0,0,40
1809116,1393790,2024-02-23,Senate,"Senate: Passed Senate (39-Y 0-N)",39,0,0,1,40
1809121,1371012,2024-01-29,Senate,"Senate: Reported from Courts of Justice with substitute (14-Y 1-N)",14,1,0,0,15
1809121,1378563,2024-02-07,Senate,"Senate: Reported from Finance and Appropriations with substitute (15-Y 0-N)",15,0,0,0,15
1809121,1380023,2024-02-08,Senate,"Senate: Constitutional reading dispensed (40-Y 0-N)",40,0,0,0,40
1809121,1382325,2024-02-12,Senate,"Senate: Read third time and passed Senate (40-Y 0-N)",40,0,0,0,40
1809121,1386826,2024-02-16,House,"House: Reported from Courts of Justice with substitute (22-Y 0-N)",22,0,0,0,22
1809121,1390240,2024-02-21,House,"House: Reported from Appropriations with amendment(s) (22-Y 0-N)",22,0,0,0,22
1809121,1394802,2024-02-26,House,"House: VOTE: Block Vote Passage (96-Y 0-N)",96,0,0,4,100
1809121,1398580,2024-02-28,Senate,"Senate: House substitute with amendment rejected by Senate (0-Y 39-N)",0,39,0,1,40
1809121,1402082,2024-03-04,Senate,"Senate: Senate acceded to request (38-Y 0-N)",38,0,0,2,40
1809121,1406375,2024-03-08,Senate,"Senate: Conference report agreed to by Senate (40-Y 0-N)",40,0,0,0,40
1809121,1406376,2024-03-08,House,"House: VOTE: Adoption (97-Y 0-N 2-A)",97,0,2,1,100
1809134,1370905,2024-01-29,House,"House: Subcommittee recommends reporting with substitute (6-Y 4-N)",6,4,0,0,10
1809134,1372422,2024-01-31,House,"House: Reported from Agriculture, Chesapeake and Natural Resources with substitute (16-Y 6-N)",16,6,0,0,22
1809134,1374588,2024-02-02,House,"House: Subcommittee recommends reporting with amendments (6-Y 2-N)",6,2,0,1,9
1809134,1374589,2024-02-02,House,"House: Reported from Appropriations with amendment(s) (18-Y 4-N)",18,4,0,0,22
1809134,1379492,2024-02-08,House,"House: VOTE: Passage (62-Y 36-N)",62,36,0,2,100
1809134,1396752,2024-02-27,Senate,"Senate: Reported from Agriculture, Conservation and Natural Resources with substitute (9-Y 3-N 2-A)",9,3,2,0,14
1809134,1401412,2024-03-04,Senate,"Senate: Reported from Finance and Appropriations with substitute (14-Y 0-N 1-A)",14,0,1,0,15
1809134,1402991,2024-03-05,Senate,"Senate: Constitutional reading dispensed (39-Y 0-N)",39,0,0,1,40
1809134,1404229,2024-03-06,Senate,"Senate: Passed Senate with substitute (23-Y 16-N 1-A)",23,16,1,0,40
1809134,1405659,2024-03-07,House,"House: VOTE: Adoption (65-Y 33-N)",65,33,0,2,100
1809134,1430289,2024-04-17,House,"House: VOTE: Adoption (61-Y 30-N)",61,30,0,9,100
1809134,1430290,2024-04-17,Senate,"Senate: Senate concurred in Governor's recommendation (39-Y 0-N 1-A)",39,0,1,0,40
1809139,1371874,2024-01-30,House,"House: Subcommittee recommends laying on the table (6-Y 2-N)",6,2,0,0,8
1809143,1371442,2024-01-30,House,"House: Subcommittee recommends reporting with substitute (6-Y 2-N)",6,2,0,0,8
1809143,1373816,2024-02-01,House,"House: Reported from Transportation with substitute (14-Y 8-N)",14,8,0,0,22
1809143,1378629,2024-02-07,House,"House: VOTE: Passage (53-Y 46-N)",53,46,0,1,100
1809143,1386848,2024-02-15,Senate,"Senate: Reported from Transportation (9-Y 6-N)",9,6,0,0,15
1809143,1388020,2024-02-19,Senate,"Senate: Constitutional reading dispensed (38-Y 0-N)",38,0,0,2,40
1809143,1388854,2024-02-20,Senate,"Senate: Defeated by Senate (20-Y 20-N)",20,20,0,0,40
1809143,1388855,2024-02-20,Senate,"Senate: Reconsideration of defeated action agreed to by Senate (40-Y 0-N)",40,0,0,0,40
1809143,1391054,2024-02-21,Senate,"Senate: Passed Senate (23-Y 17-N)",23,17,0,0,40
1809143,1430749,2024-04-17,House,"House: VOTE: REJECTED (0-Y 98-N)",0,98,0,2,100
1809158,1373831,2024-02-01,House,"House: Subcommittee recommends reporting (8-Y 0-N)",8,0,0,0,8
1809158,1377663,2024-02-06,House,"House: Reported from Health and Human Services (22-Y 0-N)",22,0,0,0,22
1809158,1382459,2024-02-12,House,"House: VOTE: Block Vote Passage (100-Y 0-N)",100,0,0,0,100
1809158,1388803,2024-02-20,Senate,"Senate: Rereferred from Agriculture, Conservation and Natural Resources (12-Y 0-N)",12,0,0,0,12
1809158,1399450,2024-02-29,Senate,"Senate: Reported from Education and Health (15-Y 0-N)",15,0,0,0,15
1809158,1400702,2024-03-01,Senate,"Senate: Constitutional reading dispensed (40-Y 0-N)",40,0,0,0,40
1809158,1401891,2024-03-04,Senate,"Senate: Passed Senate (39-Y 0-N)",39,0,0,1,40
1809163,1363995,2024-01-10,Senate,"Senate: Agreed to by Senate (39-Y 0-N)",39,0,0,1,40
1809170,1380642,2024-02-09,Senate,"Senate: Continued to 2025 in Commerce and Labor (14-Y 1-N)",14,1,0,0,15
1809175,1373545,2024-02-01,House,"House: Subcommittee recommends reporting with amendments (8-Y 0-N)",8,0,0,0,8
1809175,1377384,2024-02-06,House,"House: Reported from Health and Human Services with amendment(s) (22-Y 0-N)",22,0,0,0,22
1809175,1378592,2024-02-07,House,"House: Subcommittee recommends reporting (7-Y 0-N)",7,0,0,2,9
1809175,1380699,2024-02-09,House,"House: Reported from Appropriations (20-Y 0-N)",20,0,0,2,22
1809175,1383687,2024-02-13,House,"House: VOTE: Block Vote Passage (99-Y 0-N)",99,0,0,1,100
1809175,1399206,2024-02-29,Senate,"Senate: Reported from Education and Health (15-Y 0-N)",15,0,0,0,15
1809175,1401415,2024-03-04,Senate,"Senate: Continued to 2025 in Finance and Appropriations (12-Y 3-N)",12,3,0,0,15
1809179,1367884,2024-01-23,House,"House: Subcommittee recommends reporting (8-Y 0-N)",8,0,0,0,8
1809179,1369270,2024-01-25,House,"House: Reported from General Laws (22-Y 0-N)",22,0,0,0,22
1809179,1373285,2024-01-31,House,"House: VOTE: Passage (74-Y 26-N)",74,26,0,0,100
1809179,1384447,2024-02-14,Senate,"Senate: Reported from General Laws and Technology (14-Y 0-N 1-A)",14,0,1,0,15
1809179,1386909,2024-02-16,Senate,"Senate: Constitutional reading dispensed (38-Y 0-N)",38,0,0,2,40
1809179,1387840,2024-02-19,Senate,"Senate: Passed Senate (32-Y 6-N)",32,6,0,2,40
1809179,1387841,2024-02-19,Senate,"Senate: Reconsideration of Senate passage agreed to by Senate (39-Y 0-N)",39,0,0,1,40
1809179,1387842,2024-02-19,Senate,"Senate: Passed Senate (32-Y 7-N)",32,7,0,1,40
1809186,1366096,2024-01-16,Senate,"Senate: Reported from Agriculture, Conservation and Natural Resources (11-Y 0-N 2-A)",11,0,2,0,13
1809186,1432180,2024-01-18,Senate,"Senate: Constitutional reading dispensed (40-Y 0-N)",40,0,0,0,40
1809186,1432181,2024-01-22,Senate,"Senate: Read third time and passed Senate (40-Y 0-N)",40,0,0,0,40
1809186,1432182,2024-02-14,House,"House: Reported from Agriculture, Chesapeake and Natural Resources (21-Y 0-N)",21,0,0,1,22
1809186,1432183,2024-02-19,House,"House: VOTE: Block Vote Passage (99-Y 0-N)",99,0,0,1,100
1809198,1371445,2024-01-30,House,"House: Subcommittee recommends reporting (8-Y 0-N)",8,0,0,0,8
1809198,1373790,2024-02-01,House,"House: Reported from Transportation (22-Y 0-N)",22,0,0,0,22
1809198,1378286,2024-02-07,House,"House: VOTE: Passage (100-Y 0-N)",100,0,0,0,100
1809198,1386414,2024-02-15,Senate,"Senate: Reported from Transportation (15-Y 0-N)",15,0,0,0,15
1809198,1387712,2024-02-19,Senate,"Senate: Constitutional reading dispensed (38-Y 0-N)",38,0,0,2,40
1809198,1388601,2024-02-20,Senate,"Senate: Passed Senate (40-Y 0-N)",40,0,0,0,40
1809202,1374867,2024-02-02,House,"House: Subcommittee recommends reporting with substitute (5-Y 3-N)",5,3,0,0,8
1809202,1376952,2024-02-06,House,"House: Reported from Transportation with substitute (12-Y 9-N)",12,9,0,1,22
1809202,1382481,2024-02-12,House,"House: VOTE: Passage (52-Y 48-N)",52,48,0,0,100
1809202,1392088,2024-02-22,Senate,"Senate: Reported from Transportation (11-Y 4-N)",11,4,0,0,15
1809202,1394451,2024-02-26,Senate,"Senate: Constitutional reading dispensed (40-Y 0-N)",40,0,0,0,40
1809202,1395756,2024-02-27,Senate,"Senate: Passed Senate (26-Y 12-N)",26,12,0,2,40
1809214,1367501,2024-01-22,House,"House: Subcommittee recommends laying on the table (5-Y 3-N)",5,3,0,1,9
1809219,1371448,2024-01-30,House,"House: Referred from Transportation (22-Y 0-N)",22,0,0,0,22
1809235,1374345,2024-02-01,House,"House: Subcommittee recommends laying on the table (3-Y 2-N)",3,2,0,3,8
1809241,1368500,2024-01-24,House,"House: Subcommittee recommends reporting with substitute (5-Y 3-N)",5,3,0,0,8
1809241,1371464,2024-01-30,House,"House: Reported from Transportation with substitute (18-Y 4-N)",18,4,0,0,22
1809241,1380665,2024-02-09,House,"House: Subcommittee recommends reporting (5-Y 2-N)",5,2,0,2,9
1809241,1380666,2024-02-09,House,"House: Reported from Appropriations (12-Y 8-N)",12,8,0,2,22
1809241,1382864,2024-02-13,House,"House: VOTE: Passage (55-Y 42-N)",55,42,0,3,100
1809241,1394485,2024-02-26,Senate,"Senate: Reported from Transportation (8-Y 7-N)",8,7,0,0,15
1809241,1396097,2024-02-27,Senate,"Senate: Continued to 2025 in Finance and Appropriations (12-Y 3-N)",12,3,0,0,15
1809246,1371473,2024-01-30,House,"House: Subcommittee recommends reporting (8-Y 0-N)",8,0,0,0,8
1809246,1373813,2024-02-01,House,"House: Reported from Transportation (22-Y 0-N)",22,0,0,0,22
1809246,1378148,2024-02-07,House,"House: Subcommittee recommends reporting (8-Y 0-N)",8,0,0,1,9
1809246,1378966,2024-02-07,House,"House: Reported from Appropriations (22-Y 0-N)",22,0,0,0,22
1809246,1383905,2024-02-13,House,"House: VOTE: Block Vote Passage (99-Y 0-N)",99,0,0,1,100
1809246,1392872,2024-02-22,Senate,"Senate: Reported from Transportation (15-Y 0-N)",15,0,0,0,15
1809246,1398203,2024-02-28,Senate,"Senate: Reported from Finance and Appropriations (15-Y 0-N)",15,0,0,0,15
1809246,1399814,2024-02-29,Senate,"Senate: Constitutional reading dispensed (39-Y 0-N)",39,0,0,1,40
1809246,1401033,2024-03-01,Senate,"Senate: Passed Senate (40-Y 0-N)",40,0,0,0,40
1809254,1367951,2024-01-23,House,"House: Subcommittee recommends reporting with substitute (8-Y 2-N)",8,2,0,0,10
1809254,1369353,2024-01-25,House,"House: Reported from Labor and Commerce with substitute (15-Y 6-N)",15,6,0,1,22
1809254,1372863,2024-01-31,House,"House: VOTE: Passage (76-Y 24-N)",76,24,0,0,100
1809254,1387569,2024-02-19,Senate,"Senate: Reported from Commerce and Labor with substitute (15-Y 0-N)",15,0,0,0,15
1809254,1432036,2024-02-28,Senate,"Senate: Reported from Finance and Appropriations with substitute (12-Y 3-N)",12,3,0,0,15
1809254,1432037,2024-02-29,Senate,"Senate: Constitutional reading dispensed (39-Y 0-N)",39,0,0,1,40
1809254,1432038,2024-03-01,Senate,"Senate: Passed Senate with substitute (38-Y 2-N)",38,2,0,0,40
1809254,1432039,2024-03-04,House,"House: VOTE: Adoption (78-Y 19-N)",78,19,0,3,100
1809254,1432040,2024-04-17,House,"House: VOTE: Adoption (93-Y 7-N)",93,7,0,0,100
1809254,1432041,2024-04-17,Senate,"Senate: Senate concurred in Governor's recommendation (40-Y 0-N)",40,0,0,0,40
1809260,1373547,2024-02-01,House,"House: Subcommittee recommends reporting with substitute (5-Y 3-N)",5,3,0,0,8
1809260,1374745,2024-02-02,House,"House: Reported from Counties, Cities and Towns with substitute (12-Y 10-N)",12,10,0,0,22
1809260,1380165,2024-02-08,House,"House: VOTE: Passage (52-Y 46-N)",52,46,0,2,100
1809260,1389365,2024-02-20,Senate,"Senate: Rereferred from Agriculture, Conservation and Natural Resources (14-Y 0-N)",14,0,0,0,14
1809260,1394345,2024-02-26,Senate,"Senate: Reported from Local Government (9-Y 6-N)",9,6,0,0,15
1809260,1396475,2024-02-27,Senate,"Senate: Constitutional reading dispensed (39-Y 0-N)",39,0,0,1,40
1809260,1397908,2024-02-28,Senate,"Senate: Passed Senate (23-Y 16-N)",23,16,0,1,40
1809270,1370280,2024-01-29,House,"House: Subcommittee recommends laying on the table (6-Y 4-N)",6,4,0,0,10
1809274,1377473,2024-02-06,House,"House: Tabled in Health and Human Services (14-Y 8-N)",14,8,0,0,22
1809281,1367479,2024-01-22,House,"House: Subcommittee recommends laying on the table (7-Y 1-N)",7,1,0,1,9
1809286,1374125,2024-02-01,House,"House: Subcommittee recommends reporting with substitute (5-Y 0-N)",5,0,0,3,8
1809286,1377507,2024-02-06,House,"House: Reported from General Laws with substitute (20-Y 0-N)",20,0,0,2,22
1809286,1380704,2024-02-09,House,"House: Subcommittee recommends reporting (8-Y 0-N)",8,0,0,1,9
1809286,1380705,2024-02-09,House,"House: Reported from Appropriations (20-Y 0-N)",20,0,0,2,22
1809286,1383555,2024-02-13,House,"House: VOTE: Passage (94-Y 5-N)",94,5,0,1,100
1809286,1391117,2024-02-21,Senate,"Senate: Reported from General Laws and Technology (12-Y 0-N)",12,0,0,0,12
1809286,1398216,2024-02-28,Senate,"Senate: Reported from Finance and Appropriations with substitute (14-Y 0-N)",14,0,0,0,14
1809286,1399860,2024-02-29,Senate,"Senate: Constitutional reading dispensed (39-Y 0-N)",39,0,0,1,40
1809286,1401062,2024-03-01,Senate,"Senate: Passed Senate with substitute (40-Y 0-N)",40,0,0,0,40
1809286,1402307,2024-03-04,House,"House: VOTE: REJECTED (1-Y 97-N)",1,97,0,2,100
1809286,1403607,2024-03-05,Senate,"Senate: Senate insisted on substitute (40-Y 0-N)",40,0,0,0,40
1809286,1406547,2024-03-08,Senate,"Senate: Conference report agreed to by Senate (40-Y 0-N)",40,0,0,0,40
1809286,1406548,2024-03-08,House,"House: VOTE: Adoption (94-Y 5-N)",94,5,0,1,100
1809290,1367313,2024-01-22,Senate,"Senate: Reported from Commerce and Labor with amendment (11-Y 2-N 1-A)",11,2,1,0,14
1809290,1368592,2024-01-24,Senate,"Senate: Constitutional reading dispensed (40-Y 0-N)",40,0,0,0,40
1809290,1376414,2024-02-05,Senate,"Senate: Reported from Commerce and Labor with substitute (10-Y 5-N)",10,5,0,0,15
1809290,1380025,2024-02-08,Senate,"Senate: Engrossment reconsidered by Senate (39-Y 0-N)",39,0,0,1,40
1809290,1380026,2024-02-08,Senate,"Senate: Substitute by Senator McPike reconsidered (39-Y 0-N)",39,0,0,1,40
1809290,1380027,2024-02-08,Senate,"Senate: Constitutional reading dispensed (40-Y 0-N)",40,0,0,0,40
1809290,1380028,2024-02-08,Senate,"Senate: Reconsideration of Passed by for the day agreed to (39-Y 0-N)",39,0,0,1,40
1809290,1380029,2024-02-08,Senate,"Senate: Defeated by Senate (11-Y 28-N 1-A)",11,28,1,0,40
1809300,1371458,2024-01-30,House,"House: Subcommittee recommends reporting (8-Y 0-N)",8,0,0,0,8
1809300,1373672,2024-02-01,House,"House: Reported from Transportation (22-Y 0-N)",22,0,0,0,22
1809300,1378652,2024-02-07,House,"House: VOTE: Block Vote Passage (100-Y 0-N)",100,0,0,0,100
1809300,1386600,2024-02-15,Senate,"Senate: Reported from Transportation (15-Y 0-N)",15,0,0,0,15
1809300,1387387,2024-02-19,Senate,"Senate: Constitutional reading dispensed (38-Y 0-N)",38,0,0,2,40
1809300,1388475,2024-02-20,Senate,"Senate: Passed Senate (40-Y 0-N)",40,0,0,0,40
1809309,1372072,2024-01-30,House,"House: Stricken from docket by Labor and Commerce (22-Y 0-N)",22,0,0,0,22
1809316,1369540,2024-01-25,House,"House: Subcommittee recommends laying on the table (6-Y 0-N)",6,0,1,1,8
1809320,1373103,2024-01-31,House,"House: Subcommittee recommends laying on the table (8-Y 0-N)",8,0,0,1,9
1809324,1371382,2024-01-30,House,"House: Subcommittee recommends reporting with substitute (8-Y 0-N)",8,0,0,0,8
1809324,1372758,2024-01-31,House,"House: Reported from Education with substitute (21-Y 0-N)",21,0,0,1,22
1809324,1377046,2024-02-06,House,"House: VOTE: Block Vote Passage (99-Y 0-N)",99,0,0,1,100
1809324,1391527,2024-02-22,Senate,"Senate: Reported from Education and Health (15-Y 0-N)",15,0,0,0,15
1809324,1393901,2024-02-23,Senate,"Senate: Constitutional reading dispensed (38-Y 0-N)",38,0,0,2,40
1809324,1394595,2024-02-26,Senate,"Senate: Passed Senate (40-Y 0-N)",40,0,0,0,40
1809354,1372910,2024-01-31,House,"House: Subcommittee recommends reporting (7-Y 3-N)",7,3,0,0,10
1809354,1378725,2024-02-07,House,"House: Reported from Agriculture, Chesapeake and Natural Resources (12-Y 10-N)",12,10,0,0,22
1809354,1383086,2024-02-13,House,"House: VOTE:Defeated (51-Y 48-N)",51,48,0,1,100
1809360,1368812,2024-01-24,House,"House: Subcommittee recommends reporting (7-Y 3-N)",7,3,0,1,11
1809360,1372847,2024-01-31,House,"House: Reported from Agriculture, Chesapeake and Natural Resources (14-Y 8-N)",14,8,0,0,22
1809360,1377655,2024-02-06,House,"House: VOTE: Passage (54-Y 45-N)",54,45,0,1,100
1809360,1389564,2024-02-20,Senate,"Senate: Reported from Agriculture, Conservation and Natural Resources (8-Y 7-N)",8,7,0,0,15
1809360,1392149,2024-02-22,Senate,"Senate: Constitutional reading dispensed (40-Y 0-N)",40,0,0,0,40
1809360,1393632,2024-02-23,Senate,"Senate: Passed Senate (21-Y 18-N)",21,18,0,1,40
1809365,1370285,2024-01-29,House,"House: Subcommittee recommends laying on the table (6-Y 4-N)",6,4,0,0,10
1809371,1374351,2024-02-01,House,"House: Subcommittee recommends reporting (5-Y 0-N)",5,0,0,3,8
1809371,1377470,2024-02-06,House,"House: Reported from General Laws (19-Y 0-N)",19,0,1,2,22
1809371,1382483,2024-02-12,House,"House: VOTE: Passage (100-Y 0-N)",100,0,0,0,100
1809371,1394940,2024-02-26,Senate,"Senate: Reported from Local Government (14-Y 0-N)",14,0,0,0,14
1809371,1396726,2024-02-27,Senate,"Senate: Constitutional reading dispensed (39-Y 0-N)",39,0,0,1,40
1809371,1398311,2024-02-28,Senate,"Senate: Passed Senate (39-Y 0-N)",39,0,0,1,40
1809380,1370477,2024-01-29,House,"House: Subcommittee recommends reporting (8-Y 0-N)",8,0,0,1,9
1809380,1375574,2024-02-02,House,"House: Reported from Courts of Justice (20-Y 0-N)",20,0,0,2,22
1809380,1379525,2024-02-08,House,"House: VOTE: Block Vote Passage (98-Y 0-N)",98,0,0,2,100
1809380,1387336,2024-02-19,Senate,"Senate: Reported from Courts of Justice (14-Y 0-N)",14,0,0,0,14
1809380,1388562,2024-02-20,Senate,"Senate: Constitutional reading dispensed (39-Y 0-N)",39,0,0,1,40
1809380,1390268,2024-02-21,Senate,"Senate: Passed Senate (34-Y 6-N)",34,6,0,0,40
1809387,1368243,2024-01-24,House,"House: Subcommittee recommends reporting with substitute (6-Y 2-N)",6,2,0,0,8
1809387,1372911,2024-01-31,House,"House: Reported from Education (17-Y 5-N)",17,5,0,0,22
1809392,1379441,2024-02-08,House,"House: Subcommittee recommends reporting (7-Y 0-N)",7,0,1,0,8
1809392,1380419,2024-02-08,House,"House: Reported from Labor and Commerce (21-Y 0-N)",21,0,1,0,22
1809392,1382959,2024-02-13,House,"House: VOTE: Passage (50-Y 48-N 1-A)",50,48,1,1,100
1809392,1401809,2024-03-04,Senate,"Senate: Reported from Commerce and Labor (14-Y 0-N)",14,0,0,0,14
1809392,1403139,2024-03-05,Senate,"Senate: Constitutional reading dispensed (40-Y 0-N)",40,0,0,0,40
1809392,1404306,2024-03-06,Senate,"Senate: Passed Senate (40-Y 0-N)",40,0,0,0,40
1809404,1373585,2024-02-01,House,"House: Subcommittee recommends reporting with amendments (8-Y 0-N)",8,0,0,0,8
1809404,1374925,2024-02-02,House,"House: Reported from Counties, Cities and Towns with amendment(s) (22-Y 0-N)",22,0,0,0,22
1809404,1380249,2024-02-08,House,"House: VOTE: Block Vote Passage (98-Y 0-N)",98,0,0,2,100
1809404,1387321,2024-02-19,Senate,"Senate: Reported from Local Government with substitute (14-Y 0-N)",14,0,0,0,14
1809404,1396172,2024-02-27,Senate,"Senate: Continued to 2025 in Finance and Appropriations (10-Y 5-N)",10,5,0,0,15
1809414,1369645,2024-01-25,House,"House: Subcommittee recommends reporting (4-Y 3-N)",4,3,0,1,8
1809414,1372100,2024-01-30,House,"House: Reported from Labor and Commerce (12-Y 10-N)",12,10,0,0,22
1809414,1376082,2024-02-05,House,"House: VOTE: Passage (50-Y 47-N)",50,47,0,3,100
1809414,1387644,2024-02-19,Senate,"Senate: Reported from Commerce and Labor (9-Y 5-N)",9,5,0,0,14
1809414,1395860,2024-02-27,Senate,"Senate: Constitutional reading dispensed (39-Y 0-N)",39,0,0,1,40
1809414,1395861,2024-02-27,Senate,"Senate: Reported from Finance and Appropriations (10-Y 5-N)",10,5,0,0,15
1809414,1398261,2024-02-28,Senate,"Senate: Passed Senate (20-Y 19-N)",20,19,0,1,40
1809419,1369033,2024-01-25,House,"House: Subcommittee recommends reporting (4-Y 3-N)",4,3,0,2,9
1809419,1369873,2024-01-26,House,"House: Reported from Counties, Cities and Towns (11-Y 9-N)",11,9,0,2,22
1809426,1379433,2024-02-08,House,"House: Subcommittee recommends laying on the table (4-Y 2-N)",4,2,0,0,6
1809430,1367519,2024-01-22,House,"House: Subcommittee failed to recommend reporting (3-Y 5-N)",3,5,0,0,8
1809438,1368884,2024-01-24,Senate,"Senate: Reported from General Laws and Technology with substitute (15-Y 0-N)",15,0,0,0,15
1809438,1372454,2024-01-31,Senate,"Senate: Reported from Finance and Appropriations with amendments (15-Y 0-N)",15,0,0,0,15
1809438,1374321,2024-02-01,Senate,"Senate: Constitutional reading dispensed (40-Y 0-N)",40,0,0,0,40
1809438,1376529,2024-02-05,Senate,"Senate: Read third time and passed Senate (40-Y 0-N)",40,0,0,0,40
1809438,1389537,2024-02-20,House,"House: Subcommittee recommends reporting (8-Y 0-N)",8,0,0,0,8
1809438,1392836,2024-02-22,House,"House: Reported from General Laws (22-Y 0-N)",22,0,0,0,22
1809438,1396999,2024-02-27,House,"House: VOTE: Block Vote Passage (97-Y 0-N)",97,0,0,3,100
1809444,1371449,2024-01-30,House,"House: Subcommittee recommends reporting with substitute (8-Y 0-N)",8,0,0,0,8
1809444,1373673,2024-02-01,House,"House: Reported from Transportation with substitute (22-Y 0-N)",22,0,0,0,22
1809444,1378291,2024-02-07,House,"House: VOTE: Block Vote Passage (100-Y 0-N)",100,0,0,0,100
1809444,1386427,2024-02-15,Senate,"Senate: Reported from Transportation (15-Y 0-N)",15,0,0,0,15
1809444,1388171,2024-02-19,Senate,"Senate: Constitutional reading dispensed (38-Y 0-N)",38,0,0,2,40
1809444,1388424,2024-02-20,Senate,"Senate: Passed Senate (40-Y 0-N)",40,0,0,0,40
1809448,1375726,2024-02-05,House,"House: Subcommittee recommends striking from docket (10-Y 0-N)",10,0,0,0,10
1809453,1368217,2024-01-24,House,"House: Subcommittee recommends reporting (8-Y 0-N)",8,0,0,0,8
1809453,1369774,2024-01-26,House,"House: Reported from Privileges and Elections with amendment(s) (22-Y 0-N)",22,0,0,0,22
1809453,1376317,2024-02-05,House,"House: Subcommittee recommends reporting (8-Y 0-N)",8,0,0,1,9
1809453,1378480,2024-02-07,House,"House: Reported from Appropriations (22-Y 0-N)",22,0,0,0,22
1809453,1383151,2024-02-13,House,"House: VOTE: Block Vote Passage (99-Y 0-N)",99,0,0,1,100
1809453,1388522,2024-02-20,Senate,"Senate: Reported from Privileges and Elections (14-Y 0-N)",14,0,0,0,14
1809453,1389311,2024-02-20,Senate,"Senate: Reported from Privileges and Elections (15-Y 0-N)",15,0,0,0,15
1809453,1392691,2024-02-22,Senate,"Senate: Constitutional reading dispensed (40-Y 0-N)",40,0,0,0,40
1809453,1393378,2024-02-23,Senate,"Senate: Passed Senate (39-Y 0-N)",39,0,0,1,40
1809461,1366685,2024-01-18,Senate,"Senate: Reported from Transportation with amendment (15-Y 0-N)",15,0,0,0,15
1809461,1368793,2024-01-22,Senate,"Senate: Constitutional reading dispensed (40-Y 0-N)",40,0,0,0,40
1809461,1368794,2024-01-24,Senate,"Senate: Read third time and passed Senate (40-Y 0-N)",40,0,0,0,40
1809461,1391530,2024-02-22,House,"House: Reported from Transportation (22-Y 0-N)",22,0,0,0,22
1809461,1397033,2024-02-27,House,"House: VOTE: Block Vote Passage (97-Y 0-N)",97,0,0,3,100
1809465,1377790,2024-02-06,House,"House: Subcommittee recommends reporting (7-Y 0-N)",7,0,0,0,7
1809465,1380262,2024-02-08,House,"House: Reported from Labor and Commerce (17-Y 5-N)",17,5,0,0,22
1809465,1383737,2024-02-13,House,"House: VOTE: Defeated (48-Y 51-N)",48,51,0,1,100
1809470,1367289,2024-01-22,Senate,"Senate: Continued to 2025 in Commerce and Labor (15-Y 0-N)",15,0,0,0,15
1809482,1377756,2024-02-06,House,"House: Subcommittee recommends reporting with amendments (7-Y 0-N)",7,0,0,0,7
1809482,1379938,2024-02-08,House,"House: Reported from Labor and Commerce with amendment(s) (22-Y 0-N)",22,0,0,0,22
1809482,1383591,2024-02-13,House,"House: VOTE: Block Vote Passage (99-Y 0-N)",99,0,0,1,100
1809482,1394677,2024-02-26,Senate,"Senate: Reported from Commerce and Labor with amendment (15-Y 0-N)",15,0,0,0,15
1809482,1398419,2024-02-28,Senate,"Senate: Constitutional reading dispensed (39-Y 0-N)",39,0,0,1,40
1809482,1399227,2024-02-29,Senate,"Senate: Passed Senate with amendment (39-Y 0-N)",39,0,0,1,40
1809482,1401718,2024-03-04,House,"House: VOTE: Adoption (98-Y 0-N)",98,0,0,2,100
1809487,1370306,2024-01-29,House,"House: Subcommittee recommends laying on the table (6-Y 0-N)",6,0,0,0,6
1809494,1369422,2024-01-25,House,"House: Subcommittee recommends reporting with substitute (6-Y 4-N)",6,4,0,0,10
1809494,1369746,2024-01-26,House,"House: Reported from Public Safety with substitute (12-Y 10-N)",12,10,0,0,22
1809494,1372788,2024-01-31,House,"House: Subcommittee recommends reporting (4-Y 3-N)",4,3,0,2,9
1809494,1374612,2024-02-02,House,"House: Reported from Appropriations (12-Y 10-N)",12,10,0,0,22
1809494,1379428,2024-02-08,House,"House: VOTE: Passage (51-Y 46-N)",51,46,0,3,100
1809494,1387310,2024-02-19,Senate,"Senate: Reported from Courts of Justice with substitute (8-Y 5-N)",8,5,0,0,13
1809494,1397352,2024-02-28,Senate,"Senate: Reported from Finance and Appropriations (10-Y 5-N)",10,5,0,0,15
1809494,1399674,2024-02-29,Senate,"Senate: Constitutional reading dispensed (39-Y 0-N)",39,0,0,1,40
1809494,1400898,2024-03-01,Senate,"Senate: Passed Senate with substitute (21-Y 19-N)",21,19,0,0,40
1809494,1401538,2024-03-04,House,"House: VOTE: REJECTED (0-Y 98-N)",0,98,0,2,100
1809494,1403477,2024-03-05,Senate,"Senate: Senate insisted on substitute (40-Y 0-N)",40,0,0,0,40
1809494,1405393,2024-03-07,House,"House: VOTE: Adoption (52-Y 45-N)",52,45,0,3,100
1809494,1406191,2024-03-08,Senate,"Senate: Conference report agreed to by Senate (21-Y 19-N)",21,19,0,0,40
1809498,1370794,2024-01-29,House,"House: Subcommittee recommends laying on the table (6-Y 2-N)",6,2,0,1,9
1809502,1375089,2024-02-02,House,"House: Subcommittee recommends laying on the table (5-Y 3-N)",5,3,0,1,9
1809512,1372259,2024-01-30,House,"House: Subcommittee recommends reporting with substitute (8-Y 0-N)",8,0,0,0,8
1809512,1374304,2024-02-01,House,"House: Reported from General Laws with substitute (22-Y 0-N)",22,0,0,0,22
1809512,1378704,2024-02-07,House,"House: VOTE: Block Vote Passage (100-Y 0-N)",100,0,0,0,100
1809512,1384842,2024-02-14,Senate,"Senate: Reported from General Laws and Technology (15-Y 0-N)",15,0,0,0,15
1809512,1386530,2024-02-16,Senate,"Senate: Constitutional reading dispensed (38-Y 0-N)",38,0,0,2,40
1809512,1388100,2024-02-19,Senate,"Senate: Passed Senate (39-Y 0-N)",39,0,0,1,40
1809520,1364285,2024-01-10,House,"House: VOTE: Adoption (100-Y 0-N)",100,0,0,0,100
1809524,1370942,2024-01-29,House,"House: Subcommittee recommends reporting with substitute (9-Y 1-N)",9,1,0,0,10
1809524,1372399,2024-01-31,House,"House: Reported from Agriculture, Chesapeake and Natural Resources with substitute (22-Y 0-N)",22,0,0,0,22
1809524,1378244,2024-02-07,House,"House: Subcommittee recommends reporting with substitute (8-Y 0-N)",8,0,0,1,9
1809524,1378462,2024-02-07,House,"House: Reported from Appropriations with substitute (22-Y 0-N)",22,0,0,0,22
1809524,1383191,2024-02-13,House,"House: VOTE: Block Vote Passage (99-Y 0-N)",99,0,0,1,100
1809524,1386756,2024-02-16,Senate,"Senate: Reported from Agriculture, Conservation and Natural Resources (11-Y 0-N)",11,0,0,0,11
1809524,1390062,2024-02-21,Senate,"Senate: Reported from Finance and Appropriations (14-Y 0-N)",14,0,0,0,14
1809524,1392190,2024-02-22,Senate,"Senate: Constitutional reading dispensed (40-Y 0-N)",40,0,0,0,40
1809524,1393712,2024-02-23,Senate,"Senate: Passed Senate (39-Y 0-N)",39,0,0,1,40
1809535,1369001,2024-01-25,House,"House: Subcommittee recommends reporting (4-Y 2-N)",4,2,0,0,6
1809535,1369736,2024-01-26,House,"House: Reported from Public Safety (13-Y 9-N)",13,9,0,0,22
1809535,1380668,2024-02-09,House,"House: Subcommittee recommends reporting with substitute (4-Y 3-N)",4,3,0,2,9
1809535,1380669,2024-02-09,House,"House: Reported from Appropriations with substitute (12-Y 8-N)",12,8,0,2,22
1809535,1383148,2024-02-13,House,"House: VOTE: Passage (56-Y 41-N)",56,41,0,3,100
1809535,1393179,2024-02-23,Senate,"Senate: Reported from Rehabilitation and Social Services with amendment (10-Y 5-N)",10,5,0,0,15
1809535,1394586,2024-02-26,Senate,"Senate: Constitutional reading dispensed (40-Y 0-N)",40,0,0,0,40
1809535,1395926,2024-02-27,Senate,"Senate: Passed Senate with amendment (30-Y 9-N)",30,9,0,1,40
1809535,1399081,2024-02-29,House,"House: VOTE: Adoption (63-Y 37-N)",63,37,0,0,100
1809542,1373576,2024-02-01,House,"House: Subcommittee recommends reporting (6-Y 0-N)",6,0,0,0,6
1809542,1374741,2024-02-02,House,"House: Reported from Public Safety (22-Y 0-N)",22,0,0,0,22
1809542,1379902,2024-02-08,House,"House: VOTE: Block Vote Passage (98-Y 0-N)",98,0,0,2,100
1809542,1390514,2024-02-21,Senate,"Senate: Reported from General Laws and Technology (14-Y 0-N)",14,0,0,0,14
1809542,1393392,2024-02-23,Senate,"Senate: Constitutional reading dispensed (38-Y 0-N)",38,0,0,2,40
1809542,1395086,2024-02-26,Senate,"Senate: Passed Senate (40-Y 0-N)",40,0,0,0,40
1809547,1366282,2024-01-17,Senate,"Senate: Reported from General Laws and Technology (15-Y 0-N)",15,0,0,0,15
1809547,1368923,2024-01-19,Senate,"Senate: Constitutional reading dispensed (37-Y 0-N)",37,0,0,3,40
1809547,1368924,2024-01-23,Senate,"Senate: Read third time and passed Senate (39-Y 0-N)",39,0,0,1,40
1809547,1392815,2024-02-22,House,"House: Subcommittee recommends reporting (8-Y 0-N)",8,0,0,0,8
1809547,1396702,2024-02-27,House,"House: Reported from General Laws (22-Y 0-N)",22,0,0,0,22
1809547,1400465,2024-03-01,House,"House: VOTE: Passage (79-Y 15-N 1-A)",79,15,1,5,100
1809552,1373919,2024-02-01,House,"House: Subcommittee recommends reporting with substitute (5-Y 0-N)",5,0,0,3,8
1809552,1377271,2024-02-06,House,"House: Reported from General Laws with substitute (19-Y 0-N)",19,0,1,2,22
1809552,1382082,2024-02-12,House,"House: VOTE: Passage (99-Y 0-N)",99,0,0,1,100
1809552,1394376,2024-02-26,Senate,"Senate: Reported from Local Government (14-Y 0-N)",14,0,0,0,14
1809552,1396564,2024-02-27,Senate,"Senate: Constitutional reading dispensed (39-Y 0-N)",39,0,0,1,40
1809552,1397987,2024-02-28,Senate,"Senate: Passed Senate (39-Y 0-N)",39,0,0,1,40
1809561,1369737,2024-01-26,Senate,"Senate: Reported from Rules (14-Y 0-N)",14,0,0,0,14
1809561,1371182,2024-01-29,Senate,"Senate: Constitutional reading dispensed (39-Y 0-N)",39,0,0,1,40
1809561,1372563,2024-01-31,Senate,"Senate: Read third time and passed Senate (40-Y 0-N)",40,0,0,0,40
1809561,1393164,2024-02-23,House,"House: Subcommittee recommends reporting (6-Y 0-N)",6,0,0,0,6
1809561,1393273,2024-02-23,House,"House: Reported from Rules (16-Y 0-N)",16,0,0,2,18
1809561,1398701,2024-02-28,House,"House: Reported from Appropriations (22-Y 0-N)",22,0,0,0,22
1809561,1402362,2024-03-04,House,"House: VOTE: Block Vote Passage (97-Y 0-N)",97,0,0,3,100
1809571,1368849,2024-01-24,House,"House: Subcommittee recommends reporting with substitute (8-Y 0-N)",8,0,0,1,9
1809571,1375873,2024-02-02,House,"House: Reported from Courts of Justice with substitute (21-Y 0-N)",21,0,0,1,22
1809571,1380120,2024-02-08,House,"House: VOTE: Block Vote Passage (98-Y 0-N)",98,0,0,2,100
1809571,1398656,2024-02-28,Senate,"Senate: Reported from Courts of Justice with substitute (15-Y 0-N)",15,0,0,0,15
1809571,1401248,2024-03-01,Senate,"Senate: Constitutional reading dispensed (40-Y 0-N)",40,0,0,0,40
1809571,1402500,2024-03-04,Senate,"Senate: Passed Senate with substitute (39-Y 0-N)",39,0,0,1,40
1809571,1403644,2024-03-05,House,"House: VOTE: Adoption (99-Y 1-N)",99,1,0,0,100
1809576,1372230,2024-01-30,House,"House: Subcommittee recommends laying on the table (8-Y 0-N)",8,0,0,0,8
1809581,1370802,2024-01-29,House,"House: Subcommittee recommends laying on the table (6-Y 4-N)",6,4,0,0,10
1809592,1376764,2024-02-06,House,"House: Subcommittee recommends reporting with amendments (8-Y 0-N)",8,0,0,0,8
1809592,1379226,2024-02-08,House,"House: Reported from Transportation with amendment(s) (22-Y 0-N)",22,0,0,0,22
1809592,1383045,2024-02-13,House,"House: VOTE: Block Vote Passage (99-Y 0-N)",99,0,0,1,100
1809592,1392572,2024-02-22,Senate,"Senate: Reported from Transportation (12-Y 0-N)",12,0,0,0,12
1809592,1397348,2024-02-28,Senate,"Senate: Reported from Finance and Appropriations (13-Y 0-N)",13,0,0,0,13
1809592,1399687,2024-02-29,Senate,"Senate: Constitutional reading dispensed (39-Y 0-N)",39,0,0,1,40
1809592,1400909,2024-03-01,Senate,"Senate: Passed Senate (40-Y 0-N)",40,0,0,0,40
1809598,1375330,2024-02-02,House,"House: Subcommittee recommends reporting (5-Y 3-N)",5,3,0,1,9
1809598,1378843,2024-02-07,House,"House: Reported from Courts of Justice (12-Y 10-N)",12,10,0,0,22
1809598,1380603,2024-02-09,House,"House: Subcommittee recommends reporting with substitute (4-Y 3-N)",4,3,0,2,9
1809598,1380662,2024-02-09,House,"House: Reported from Appropriations with substitute (11-Y 9-N)",11,9,0,2,22
1809598,1383665,2024-02-13,House,"House: VOTE: Passage (50-Y 46-N)",50,46,0,4,100
1809598,1391069,2024-02-21,Senate,"Senate: Reported from Courts of Justice (10-Y 5-N)",10,5,0,0,15
1809598,1395587,2024-02-27,Senate,"Senate: Reported from Finance and Appropriations (10-Y 5-N)",10,5,0,0,15
1809598,1396355,2024-02-27,Senate,"Senate: Constitutional reading dispensed (39-Y 0-N)",39,0,0,1,40
1809598,1398684,2024-02-28,Senate,"Senate: Passed Senate (21-Y 18-N)",21,18,0,1,40
1809598,1430312,2024-04-17,House,"House: VOTE: Adoption (0-Y 100-N)",0,100,0,0,100
1809605,1379050,2024-02-08,Senate,"Senate: Reported from Education and Health with substitute (15-Y 0-N)",15,0,0,0,15
1809605,1379712,2024-02-08,Senate,"Senate: Constitutional reading dispensed (40-Y 0-N)",40,0,0,0,40
1809605,1380773,2024-02-09,Senate,"Senate: Constitutional reading dispensed (40-Y 0-N)",40,0,0,0,40
1809605,1380774,2024-02-09,Senate,"Senate: Passed Senate (40-Y 0-N)",40,0,0,0,40
1809605,1388296,2024-02-20,House,"House: Subcommittee recommends reporting with substitute (8-Y 0-N)",8,0,0,0,8
1809605,1389813,2024-02-21,House,"House: Reported from Education with substitute (22-Y 0-N)",22,0,0,0,22
1809605,1394788,2024-02-26,House,"House: VOTE: Block Vote Passage (96-Y 0-N)",96,0,0,4,100
1809605,1397701,2024-02-28,Senate,"Senate: House substitute rejected by Senate (0-Y 39-N)",0,39,0,1,40
1809605,1401957,2024-03-04,Senate,"Senate: Senate acceded to request (38-Y 0-N)",38,0,0,2,40
1809605,1406700,2024-03-09,Senate,"Senate: Conference report agreed to by Senate (40-Y 0-N)",40,0,0,0,40
1809605,1406701,2024-03-09,House,"House: VOTE: Adoption (98-Y 0-N)",98,0,0,2,100
1809610,1369658,2024-01-25,House,"House: Subcommittee recommends passing by indefinitely (6-Y 4-N)",6,4,0,0,10
1809614,1373322,2024-01-31,House,"House: Subcommittee recommends laying on the table (5-Y 3-N)",5,3,0,1,9
1809621,1371923,2024-01-30,House,"House: Subcommittee recommends reporting with substitute (8-Y 0-N)",8,0,0,0,8
1809621,1372710,2024-01-31,House,"House: Reported from Education with substitute (21-Y 0-N)",21,0,0,1,22
1809621,1376332,2024-02-05,House,"House: Subcommittee recommends reporting with amendments (8-Y 0-N)",8,0,0,1,9
1809621,1378664,2024-02-07,House,"House: Reported from Appropriations with amendment(s) (22-Y 0-N)",22,0,0,0,22
1809621,1383329,2024-02-13,House,"House: VOTE: Block Vote Passage (99-Y 0-N)",99,0,0,1,100
1809621,1399184,2024-02-29,Senate,"Senate: Reported from Education and Health with substitute (15-Y 0-N)",15,0,0,0,15
1809621,1401413,2024-03-04,Senate,"Senate: Reported from Finance and Appropriations with amendment (15-Y 0-N)",15,0,0,0,15
1809621,1402970,2024-03-05,Senate,"Senate: Constitutional reading dispensed (39-Y 0-N)",39,0,0,1,40
1809621,1404177,2024-03-06,Senate,"Senate: Passed Senate with substitute with amendment (40-Y 0-N)",40,0,0,0,40
1809621,1405717,2024-03-07,House,"House: VOTE: Adoption (98-Y 0-N)",98,0,0,2,100
1809621,1405718,2024-03-07,House,"House: VOTE: REJECTED (0-Y 98-N)",0,98,0,2,100
1809621,1405719,2024-03-07,Senate,"Senate: Senate receded from amendment (40-Y 0-N)",40,0,0,0,40
1809632,1367530,2024-01-22,House,"House: Subcommittee recommends reporting with amendments (8-Y 0-N)",8,0,0,0,8
1809632,1369735,2024-01-26,House,"House: Reported from Privileges and Elections with amendment(s) (22-Y 0-N)",22,0,0,0,22
1809632,1373828,2024-02-01,House,"House: VOTE: Block Vote Passage (99-Y 0-N)",99,0,0,1,100
1809632,1396483,2024-02-27,Senate,"Senate: Reported from Privileges and Elections with amendments (12-Y 2-N)",12,2,0,0,14
1809632,1399623,2024-02-29,Senate,"Senate: Constitutional reading dispensed (39-Y 0-N)",39,0,0,1,40
1809632,1404425,2024-03-06,Senate,"Senate: Defeated by Senate (19-Y 21-N)",19,21,0,0,40
1809644,1374348,2024-02-01,House,"House: Subcommittee recommends reporting with substitute (3-Y 2-N)",3,2,0,3,8
1809644,1377694,2024-02-06,House,"House: Reported from General Laws with substitute (10-Y 9-N)",10,9,0,3,22
1809644,1382505,2024-02-12,House,"House: VOTE: Passage (50-Y 49-N)",50,49,0,1,100
1809644,1390318,2024-02-21,Senate,"Senate: Reported from General Laws and Technology (9-Y 6-N)",9,6,0,0,15
1809644,1393628,2024-02-23,Senate,"Senate: Constitutional reading dispensed (38-Y 0-N)",38,0,0,2,40
1809644,1394818,2024-02-26,Senate,"Senate: Passed Senate (24-Y 16-N)",24,16,0,0,40
1809644,1394819,2024-02-26,Senate,"Senate: Reconsideration of Senate passage agreed to by Senate (40-Y 0-N)",40,0,0,0,40
1809644,1396542,2024-02-27,Senate,"Senate: Passed Senate with substitute (24-Y 15-N)",24,15,0,1,40
1809644,1399553,2024-02-29,House,"House: VOTE: Adoption (51-Y 49-N)",51,49,0,0,100
1809650,1367569,2024-01-22,House,"House: Subcommittee recommends passing by indefinitely (8-Y 0-N)",8,0,0,1,9
1809654,1375545,2024-02-05,House,"House: Subcommittee recommends reporting with substitute (7-Y 1-N)",7,1,0,1,9
1809654,1378299,2024-02-07,House,"House: Reported from Finance with substitute (19-Y 2-N)",19,2,0,1,22
1809660,1379463,2024-02-08,House,"House: Subcommittee recommends reporting with substitute (7-Y 0-N)",7,0,0,1,8
1809660,1379855,2024-02-08,House,"House: Reported from General Laws with substitute (20-Y 0-N)",20,0,0,2,22
1809660,1383511,2024-02-13,House,"House: VOTE: Block Vote Passage (99-Y 0-N)",99,0,0,1,100
1809660,1398599,2024-02-28,Senate,"Senate: Reported from General Laws and Technology (15-Y 0-N)",15,0,0,0,15
1809660,1400711,2024-03-01,Senate,"Senate: Constitutional reading dispensed (40-Y 0-N)",40,0,0,0,40
1809660,1402106,2024-03-04,Senate,"Senate: Passed Senate (39-Y 0-N)",39,0,0,1,40
1809687,1372236,2024-01-30,House,"House: Subcommittee recommends reporting with amendments (8-Y 0-N)",8,0,0,0,8
1809694,1370258,2024-01-29,House,"House: Subcommittee recommends reporting with substitute (10-Y 0-N)",10,0,0,0,10
1809694,1375641,2024-02-05,House,"House: Reported from Communications, Technology and Innovation with substitute (22-Y 0-N)",22,0,0,0,22
1809694,1376816,2024-02-06,House,"House: Subcommittee recommends reporting (8-Y 0-N)",8,0,0,0,8
1809694,1378401,2024-02-07,House,"House: Reported from Education (22-Y 0-N)",22,0,0,0,22
1809694,1383047,2024-02-13,House,"House: VOTE: Block Vote Passage (99-Y 0-N)",99,0,0,1,100
1809694,1390797,2024-02-21,Senate,"Senate: Reported from General Laws and Technology (15-Y 0-N)",15,0,0,0,15
1809694,1395854,2024-02-27,Senate,"Senate: Constitutional reading dispensed (39-Y 0-N)",39,0,0,1,40
1809694,1395855,2024-02-27,Senate,"Senate: Reported from Finance and Appropriations with substitute (15-Y 0-N)",15,0,0,0,15
1809694,1398241,2024-02-28,Senate,"Senate: Passed Senate with substitute (39-Y 0-N)",39,0,0,1,40
1809694,1400462,2024-03-01,House,"House: VOTE: REJECTED (1-Y 94-N 1-A)",1,94,1,4,100
1809694,1403491,2024-03-05,Senate,"Senate: Senate insisted on substitute (40-Y 0-N)",40,0,0,0,40
1809694,1406650,2024-03-09,House,"House: VOTE: Adoption (98-Y 0-N)",98,0,0,2,100
1809694,1406651,2024-03-09,Senate,"Senate: Conference report agreed to by Senate (40-Y 0-N)",40,0,0,0,40
1809699,1379030,2024-02-08,House,"House: Subcommittee recommends laying on the table (7-Y 0-N)",7,0,0,1,8
1809705,1367980,2024-01-23,House,"House: Subcommittee recommends reporting with amendments (8-Y 0-N)",8,0,0,0,8
1809705,1369146,2024-01-25,House,"House: Reported from Health and Human Services with amendment(s) (22-Y 0-N)",22,0,0,0,22
1809705,1373241,2024-01-31,House,"House: VOTE: Block Vote Passage (100-Y 0-N)",100,0,0,0,100
1809705,1392460,2024-02-22,Senate,"Senate: Reported from Education and Health (15-Y 0-N)",15,0,0,0,15
1809705,1393546,2024-02-23,Senate,"Senate: Constitutional reading dispensed (38-Y 0-N)",38,0,0,2,40
1809705,1395409,2024-02-26,Senate,"Senate: Passed Senate (40-Y 0-N)",40,0,0,0,40
1809710,1373680,2024-02-01,House,"House: Continued to 2025 in Transportation (22-Y 0-N)",22,0,0,0,22
1809723,1377080,2024-02-06,House,"House: Subcommittee recommends reporting (8-Y 0-N)",8,0,0,0,8
1809723,1379566,2024-02-08,House,"House: Reported from Transportation (22-Y 0-N)",22,0,0,0,22
1809723,1383952,2024-02-13,House,"House: VOTE: Block Vote Passage (99-Y 0-N)",99,0,0,1,100
1809723,1392260,2024-02-22,Senate,"Senate: Reported from Transportation (14-Y 0-N 1-A)",14,0,1,0,15
1809723,1395292,2024-02-26,Senate,"Senate: Constitutional reading dispensed (40-Y 0-N)",40,0,0,0,40
1809723,1397016,2024-02-27,Senate,"Senate: Passed Senate (39-Y 0-N)",39,0,0,1,40
1809727,1373937,2024-02-01,House,"House: Subcommittee recommends reporting (6-Y 4-N)",6,4,0,0,10
1809727,1374761,2024-02-02,House,"House: Reported from Public Safety (12-Y 10-N)",12,10,0,0,22
1809727,1378138,2024-02-07,House,"House: Subcommittee recommends reporting (5-Y 3-N)",5,3,0,1,9
1809727,1378804,2024-02-07,House,"House: Reported from Appropriations (12-Y 10-N)",12,10,0,0,22
1809727,1382118,2024-02-12,House,"House: VOTE: Adoption (50-Y 48-N)",50,48,0,2,100
1809727,1383346,2024-02-13,House,"House: VOTE: Passage (50-Y 48-N)",50,48,0,2,100
1809727,1390884,2024-02-21,Senate,"Senate: Reported from Courts of Justice (9-Y 6-N)",9,6,0,0,15
1809727,1397373,2024-02-28,Senate,"Senate: Reported from Finance and Appropriations (10-Y 5-N)",10,5,0,0,15
1809727,1399682,2024-02-29,Senate,"Senate: Constitutional reading dispensed (39-Y 0-N)",39,0,0,1,40
1809727,1400892,2024-03-01,Senate,"Senate: Passed Senate (21-Y 19-N)",21,19,0,0,40
1809734,1369079,2024-01-25,House,"House: Subcommittee recommends reporting (8-Y 0-N)",8,0,0,1,9
1809734,1369890,2024-01-26,House,"House: Reported from Counties, Cities and Towns (17-Y 3-N)",17,3,0,2,22
1809734,1373667,2024-02-01,House,"House: VOTE: Passage (83-Y 17-N)",83,17,0,0,100
1809734,1401427,2024-03-04,Senate,"Senate: Reported from Local Government (11-Y 2-N)",11,2,0,0,13
1809734,1402961,2024-03-05,Senate,"Senate: Constitutional reading dispensed (39-Y 0-N)",39,0,0,1,40
1809734,1404192,2024-03-06,Senate,"Senate: Passed Senate (32-Y 7-N)",32,7,0,1,40
1809740,1373208,2024-01-31,House,"House: Subcommittee recommends reporting with substitute (8-Y 0-N)",8,0,0,1,9
1809740,1375584,2024-02-02,House,"House: Reported from Courts of Justice with substitute (18-Y 3-N)",18,3,0,1,22
1809740,1379946,2024-02-08,House,"House: VOTE: Passage (68-Y 28-N)",68,28,0,4,100
1809740,1398645,2024-02-28,Senate,"Senate: Reported from Courts of Justice with substitute (9-Y 2-N 4-A)",9,2,4,0,15
1809740,1401163,2024-03-01,Senate,"Senate: Constitutional reading dispensed (40-Y 0-N)",40,0,0,0,40
1809740,1404465,2024-03-06,Senate,"Senate: Passed Senate with substitute with amendment (22-Y 18-N)",22,18,0,0,40
1809740,1405428,2024-03-07,House,"House: VOTE: Adoption (69-Y 30-N)",69,30,0,1,100
1809746,1374944,2024-02-02,House,"House: Subcommittee recommends reporting with substitute (8-Y 0-N)",8,0,0,1,9
1809746,1378852,2024-02-07,House,"House: Reported from Courts of Justice with substitute (22-Y 0-N)",22,0,0,0,22
1809746,1383836,2024-02-13,House,"House: VOTE: Block Vote Passage (99-Y 0-N)",99,0,0,1,100
1809746,1391195,2024-02-21,Senate,"Senate: Reported from Courts of Justice (9-Y 0-N)",9,0,0,0,9
1809746,1398165,2024-02-28,Senate,"Senate: Reported from Finance and Appropriations (15-Y 0-N)",15,0,0,0,15
1809746,1399844,2024-02-29,Senate,"Senate: Constitutional reading dispensed (39-Y 0-N)",39,0,0,1,40
1809746,1401052,2024-03-01,Senate,"Senate: Passed Senate (40-Y 0-N)",40,0,0,0,40
1809751,1371810,2024-01-30,House,"House: Subcommittee recommends reporting (8-Y 0-N)",8,0,0,0,8
1809751,1372439,2024-01-30,House,"House: Subcommittee recommends reporting with substitute (8-Y 0-N)",8,0,0,0,8
1809751,1373958,2024-02-01,House,"House: Reported from General Laws with substitute (22-Y 0-N)",22,0,0,0,22
1809751,1376309,2024-02-05,House,"House: Subcommittee recommends reporting (8-Y 0-N)",8,0,0,1,9
1809751,1378630,2024-02-07,House,"House: Reported from Appropriations (22-Y 0-N)",22,0,0,0,22
1809751,1383638,2024-02-13,House,"House: VOTE: Block Vote Passage (99-Y 0-N)",99,0,0,1,100
1809751,1398613,2024-02-28,Senate,"Senate: Reported from General Laws and Technology with substitute (15-Y 0-N)",15,0,0,0,15
1809751,1401414,2024-03-04,Senate,"Senate: Reported from Finance and Appropriations (14-Y 0-N)",14,0,0,0,14
1809751,1402909,2024-03-05,Senate,"Senate: Constitutional reading dispensed (39-Y 0-N)",39,0,0,1,40
1809751,1404174,2024-03-06,Senate,"Senate: Passed Senate with substitute (40-Y 0-N)",40,0,0,0,40
1809751,1405620,2024-03-07,House,"House: VOTE:REJECTED (1-Y 97-N)",1,97,0,2,100
1809751,1405621,2024-03-07,Senate,"Senate: Senate insisted on substitute (40-Y 0-N)",40,0,0,0,40
1809751,1406303,2024-03-08,Senate,"Senate: Conference report agreed to by Senate (40-Y 0-N)",40,0,0,0,40
1809751,1406304,2024-03-08,House,"House: VOTE: Adoption (99-Y 0-N)",99,0,0,1,100
1809755,1375723,2024-02-05,House,"House: Subcommittee recommends reporting with substitute (9-Y 0-N)",9,0,0,1,10
1809755,1378241,2024-02-07,House,"House: Reported from Education with substitute (22-Y 0-N)",22,0,0,0,22
1809755,1383195,2024-02-13,House,"House: VOTE: Block Vote Passage (99-Y 0-N)",99,0,0,1,100
1809755,1395814,2024-02-27,Senate,"Senate: Constitutional reading dispensed (39-Y 0-N)",39,0,0,1,40
1809755,1395815,2024-02-27,Senate,"Senate: Reported from Finance and Appropriations with substitute (15-Y 0-N)",15,0,0,0,15
1809755,1398195,2024-02-28,Senate,"Senate: Passed Senate with substitute (39-Y 0-N)",39,0,0,1,40
1809755,1400472,2024-03-01,House,"House: VOTE: REJECTED (0-Y 97-N)",0,97,0,3,100
1809755,1403551,2024-03-05,Senate,"Senate: Senate insisted on substitute (40-Y 0-N)",40,0,0,0,40
1809755,1405476,2024-03-07,House,"House: VOTE: Adoption (99-Y 0-N)",99,0,0,1,100
1809755,1406201,2024-03-08,Senate,"Senate: Conference report agreed to by Senate (40-Y 0-N)",40,0,0,0,40
1809759,1368660,2024-01-24,Senate,"Senate: Reported from Courts of Justice with substitute (15-Y 0-N)",15,0,0,0,15
1809759,1377054,2024-02-06,Senate,"Senate: Reported from Finance and Appropriations (9-Y 6-N)",9,6,0,0,15
1809759,1377973,2024-02-07,Senate,"Senate: Constitutional reading dispensed (40-Y 0-N)",40,0,0,0,40
1809759,1380971,2024-02-09,Senate,"Senate: Read third time and passed Senate (33-Y 7-N)",33,7,0,0,40
1809759,1386822,2024-02-16,House,"House: Subcommittee recommends laying on the table (5-Y 3-N)",5,3,0,1,9
1809765,1376504,2024-02-05,House,"House: Subcommittee recommends continuing to 2025 with substitute (7-Y 0-N)",7,0,0,1,8
1809772,1371480,2024-01-30,House,"House: Subcommittee recommends striking from docket (8-Y 0-N)",8,0,0,0,8
1809783,1367234,2024-01-22,Senate,"Senate: Reported from Commerce and Labor with amendments (14-Y 0-N)",14,0,0,0,14
1809783,1372842,2024-01-31,Senate,"Senate: Reported from Finance and Appropriations (15-Y 0-N)",15,0,0,0,15
1809783,1374194,2024-02-01,Senate,"Senate: Constitutional reading dispensed (40-Y 0-N)",40,0,0,0,40
1809783,1376391,2024-02-05,Senate,"Senate: Read third time and passed Senate (40-Y 0-N)",40,0,0,0,40
1809783,1389329,2024-02-20,House,"House: Reported from Labor and Commerce with amendment(s) (19-Y 2-N)",19,2,0,1,22
1809783,1390704,2024-02-21,House,"House: Reported from Appropriations (22-Y 0-N)",22,0,0,0,22
1809783,1394958,2024-02-26,House,"House: VOTE: Passage (94-Y 1-N)",94,1,0,5,100
1809783,1397928,2024-02-28,Senate,"Senate: House amendment agreed to by Senate (39-Y 0-N)",39,0,0,1,40
1809787,1370319,2024-01-29,House,"House: Subcommittee recommends reporting with substitute (5-Y 3-N)",5,3,0,1,9
1809787,1373105,2024-01-31,House,"House: Reported from Finance with substitute (13-Y 9-N)",13,9,0,0,22
1809787,1374651,2024-02-02,House,"House: Subcommittee recommends reporting (8-Y 0-N)",8,0,0,1,9
1809787,1376116,2024-02-05,House,"House: Reported from Appropriations with substitute (21-Y 0-N)",21,0,0,1,22
1809787,1380647,2024-02-09,House,"House: VOTE: Passage (83-Y 13-N)",83,13,0,4,100
1809787,1395758,2024-02-27,Senate,"Senate: Constitutional reading dispensed (39-Y 0-N)",39,0,0,1,40
1809787,1395759,2024-02-27,Senate,"Senate: Reported from Finance and Appropriations (15-Y 0-N)",15,0,0,0,15
1809787,1398694,2024-02-28,Senate,"Senate: Passed Senate (39-Y 0-N)",39,0,0,1,40
1809793,1379455,2024-02-08,House,"House: Subcommittee recommends reporting with substitute (6-Y 2-N)",6,2,0,0,8
1809793,1380422,2024-02-08,House,"House: Reported from General Laws with substitute (14-Y 6-N)",14,6,0,2,22
1809793,1382881,2024-02-13,House,"House: VOTE: Passage (69-Y 29-N)",69,29,0,2,100
1809793,1398338,2024-02-28,Senate,"Senate: Reported from General Laws and Technology (12-Y 3-N)",12,3,0,0,15
1809793,1401114,2024-03-01,Senate,"Senate: Constitutional reading dispensed (40-Y 0-N)",40,0,0,0,40
1809793,1403648,2024-03-05,Senate,"Senate: Passed Senate (21-Y 19-N)",21,19,0,0,40
1809793,1429999,2024-04-17,House,"House: VOTE: Adoption (68-Y 32-N)",68,32,0,0,100
1809793,1430000,2024-04-17,Senate,"Senate: Senate concurred in Governor's recommendation (39-Y 1-N)",39,1,0,0,40
1809810,1374303,2024-02-01,House,"House: Subcommittee recommends reporting with substitute (8-Y 0-N)",8,0,0,1,9
1809810,1377515,2024-02-06,House,"House: Reported from Health and Human Services with substitute (22-Y 0-N)",22,0,0,0,22
1809810,1378826,2024-02-07,House,"House: Subcommittee recommends laying on the table (7-Y 0-N)",7,0,0,2,9
1809814,1372256,2024-01-30,House,"House: Subcommittee recommends reporting (8-Y 0-N)",8,0,0,1,9
1809814,1374294,2024-02-01,House,"House: Reported from General Laws (22-Y 0-N)",22,0,0,0,22
1809814,1378606,2024-02-07,House,"House: VOTE: Block Vote Passage (100-Y 0-N)",100,0,0,0,100
1809814,1384500,2024-02-14,Senate,"Senate: Reported from General Laws and Technology (15-Y 0-N)",15,0,0,0,15
1809814,1396158,2024-02-27,Senate,"Senate: Constitutional reading dispensed (39-Y 0-N)",39,0,0,1,40
1809814,1396159,2024-02-27,Senate,"Senate: Reported from Finance and Appropriations (15-Y 0-N)",15,0,0,0,15
1809814,1397681,2024-02-28,Senate,"Senate: Passed Senate (39-Y 0-N)",39,0,0,1,40
1809821,1370254,2024-01-29,House,"House: Reported from Communications, Technology and Innovation (21-Y 1-N)",21,1,0,0,22
1809821,1374595,2024-02-02,House,"House: VOTE: Passage (94-Y 6-N)",94,6,0,0,100
1809821,1384486,2024-02-14,Senate,"Senate: Reported from General Laws and Technology with amendment (15-Y 0-N)",15,0,0,0,15
1809821,1389836,2024-02-21,Senate,"Senate: Reported from Finance and Appropriations (14-Y 0-N)",14,0,0,0,14
1809821,1392842,2024-02-22,Senate,"Senate: Constitutional reading dispensed (40-Y 0-N)",40,0,0,0,40
1809821,1393845,2024-02-23,Senate,"Senate: Passed Senate with amendment (39-Y 0-N)",39,0,0,1,40
1809821,1397022,2024-02-27,House,"House: VOTE: Adoption (88-Y 8-N)",88,8,0,4,100
1809826,1369577,2024-01-25,House,"House: Subcommittee recommends passing by indefinitely (6-Y 4-N)",6,4,0,0,10
1809865,1370471,2024-01-29,Senate,"Senate: Reported from Courts of Justice with substitute (9-Y 6-N)",9,6,0,0,15
1809865,1378358,2024-02-07,Senate,"Senate: Reported from Finance and Appropriations (10-Y 5-N)",10,5,0,0,15
1809865,1379847,2024-02-08,Senate,"Senate: Constitutional reading dispensed (40-Y 0-N)",40,0,0,0,40
1809865,1381762,2024-02-12,Senate,"Senate: Read third time and passed Senate (21-Y 19-N)",21,19,0,0,40
1809865,1386748,2024-02-16,House,"House: Reported from Public Safety (12-Y 10-N)",12,10,0,0,22
1809865,1390757,2024-02-21,House,"House: VOTE: Passage (52-Y 48-N)",52,48,0,0,100
1809865,1430164,2024-04-17,Senate,"Senate: Passed in enrolled form rejected (21-Y 19-N)",21,19,0,0,40
1809871,1373327,2024-01-31,House,"House: Subcommittee recommends reporting (8-Y 0-N)",8,0,0,1,9
1809871,1375567,2024-02-02,House,"House: Reported from Courts of Justice (20-Y 0-N)",20,0,0,2,22
1809871,1379371,2024-02-08,House,"House: VOTE: Block Vote Passage (98-Y 0-N)",98,0,0,2,100
1809871,1398854,2024-02-28,Senate,"Senate: Reported from Courts of Justice (14-Y 0-N)",14,0,0,0,14
1809871,1401002,2024-03-01,Senate,"Senate: Constitutional reading dispensed (40-Y 0-N)",40,0,0,0,40
1809871,1401699,2024-03-04,Senate,"Senate: Passed Senate (39-Y 0-N)",39,0,0,1,40
1809875,1369224,2024-01-25,House,"House: Subcommittee recommends reporting with amendments (8-Y 0-N)",8,0,0,0,8
1809875,1372298,2024-01-30,House,"House: Reported from General Laws with amendment(s) (22-Y 0-N)",22,0,0,0,22
1809875,1378329,2024-02-07,House,"House: Subcommittee recommends reporting with substitute (8-Y 0-N)",8,0,0,1,9
1809875,1378330,2024-02-07,House,"House: Reported from Appropriations with substitute (22-Y 0-N)",22,0,0,0,22
1809875,1383492,2024-02-13,House,"House: VOTE: Passage (86-Y 13-N)",86,13,0,1,100
1809875,1398577,2024-02-28,Senate,"Senate: Reported from General Laws and Technology (15-Y 0-N)",15,0,0,0,15
1809875,1401404,2024-03-04,Senate,"Senate: Reported from Finance and Appropriations with substitute (15-Y 0-N)",15,0,0,0,15
1809875,1402933,2024-03-05,Senate,"Senate: Constitutional reading dispensed (39-Y 0-N)",39,0,0,1,40
1809875,1404189,2024-03-06,Senate,"Senate: Passed Senate with substitute (40-Y 0-N)",40,0,0,0,40
1809875,1405694,2024-03-07,House,"House: VOTE: Adoption (0-Y 96-N 1-A)",0,96,1,3,100
1809875,1405695,2024-03-07,Senate,"Senate: Senate insisted on substitute (40-Y 0-N)",40,0,0,0,40
1809880,1368168,2024-01-23,House,"House: Subcommittee recommends laying on the table (8-Y 0-N)",8,0,0,1,9
1809893,1373321,2024-01-31,House,"House: Subcommittee recommends laying on the table (8-Y 0-N)",8,0,0,1,9
1809898,1376814,2024-02-06,House,"House: Subcommittee recommends reporting (7-Y 1-N)",7,1,0,0,8
1809898,1378367,2024-02-07,House,"House: Reported from Education (17-Y 5-N)",17,5,0,0,22
1809898,1382886,2024-02-13,House,"House: VOTE: Defeated (49-Y 50-N)",49,50,0,1,100
1809904,1373963,2024-02-01,House,"House: Subcommittee recommends reporting (5-Y 2-N)",5,2,0,1,8
1809904,1377715,2024-02-06,House,"House: Reported from Labor and Commerce with substitute (12-Y 10-N)",12,10,0,0,22
1809904,1382063,2024-02-12,House,"House: VOTE: Passage (51-Y 49-N)",51,49,0,0,100
1809904,1395040,2024-02-26,Senate,"Senate: Reported from Commerce and Labor with substitute (10-Y 5-N)",10,5,0,0,15
1809904,1399360,2024-02-29,Senate,"Senate: Reported from Finance and Appropriations with substitute (14-Y 0-N)",14,0,0,0,14
1809904,1401833,2024-03-04,Senate,"Senate: Constitutional reading dispensed (40-Y 0-N)",40,0,0,0,40
1809904,1402947,2024-03-05,Senate,"Senate: Passed Senate with substitute (23-Y 17-N)",23,17,0,0,40
1809904,1404166,2024-03-06,House,"House: VOTE: REJECTED (0-Y 98-N)",0,98,0,2,100
1809904,1405627,2024-03-07,Senate,"Senate: Senate insisted on substitute (40-Y 0-N)",40,0,0,0,40
1809904,1406682,2024-03-09,House,"House: VOTE: Adoption (53-Y 45-N)",53,45,0,2,100
1809904,1406683,2024-03-09,Senate,"Senate: Conference report agreed to by Senate (22-Y 18-N)",22,18,0,0,40
1809915,1379085,2024-02-08,House,"House: Subcommittee recommends reporting with substitute (6-Y 0-N)",6,0,0,0,6
1809915,1380503,2024-02-09,House,"House: Reported from Public Safety with substitute (21-Y 0-N)",21,0,0,1,22
1809915,1382796,2024-02-13,House,"House: VOTE: Block Vote Passage (99-Y 0-N)",99,0,0,1,100
1809915,1390493,2024-02-21,Senate,"Senate: Reported from Courts of Justice with amendment (10-Y 0-N)",10,0,0,0,10
1809915,1394069,2024-02-23,Senate,"Senate: Constitutional reading dispensed (38-Y 0-N)",38,0,0,2,40
1809915,1394398,2024-02-26,Senate,"Senate: Passed Senate with amendment (40-Y 0-N)",40,0,0,0,40
1809915,1398028,2024-02-28,House,"House: VOTE: REJECTED (1-Y 99-N)",1,99,0,0,100
1809915,1400792,2024-03-01,Senate,"Senate: Senate insisted on amendment (39-Y 0-N)",39,0,0,1,40
1809915,1406707,2024-03-09,House,"House: VOTE: Adoption (98-Y 0-N)",98,0,0,2,100
1809915,1406708,2024-03-09,Senate,"Senate: Conference report agreed to by Senate (38-Y 0-N)",38,0,0,2,40
1809920,1375644,2024-02-05,House,"House: Subcommittee recommends reporting (8-Y 0-N)",8,0,0,1,9
1809920,1378818,2024-02-07,House,"House: Reported from Finance (13-Y 7-N)",13,7,0,2,22
1809920,1380930,2024-02-09,House,"House: Subcommittee recommends laying on the table (6-Y 2-N)",6,2,0,1,9
1809927,1374105,2024-02-01,House,"House: Subcommittee recommends striking from docket (8-Y 0-N)",8,0,0,0,8
1809927,1377709,2024-02-06,House,"House: Stricken from docket by General Laws (20-Y 0-N)",20,0,0,2,22
1809932,1374932,2024-02-02,House,"House: Subcommittee recommends reporting (8-Y 0-N)",8,0,0,0,8
1809932,1374933,2024-02-02,House,"House: Reported from Counties, Cities and Towns (22-Y 0-N)",22,0,0,0,22
1809932,1380366,2024-02-08,House,"House: VOTE: Block Vote Passage (98-Y 0-N)",98,0,0,2,100
1809932,1394493,2024-02-26,Senate,"Senate: Reported from Local Government (12-Y 0-N)",12,0,0,0,12
1809932,1396065,2024-02-27,Senate,"Senate: Constitutional reading dispensed (39-Y 0-N)",39,0,0,1,40
1809932,1398766,2024-02-28,Senate,"Senate: Passed Senate (39-Y 0-N)",39,0,0,1,40
1809937,1368141,2024-01-23,House,"House: Subcommittee recommends reporting (8-Y 0-N)",8,0,0,0,8
1809937,1369277,2024-01-25,House,"House: Reported from General Laws (22-Y 0-N)",22,0,0,0,22
1809937,1373173,2024-01-31,House,"House: Subcommittee recommends reporting (8-Y 0-N)",8,0,0,1,9
1809937,1375576,2024-02-02,House,"House: Reported from Courts of Justice (20-Y 0-N)",20,0,0,2,22
1809937,1380388,2024-02-08,House,"House: VOTE: Block Vote Passage (98-Y 0-N)",98,0,0,2,100
1809937,1398658,2024-02-28,Senate,"Senate: Reported from Courts of Justice (15-Y 0-N)",15,0,0,0,15
1809937,1401253,2024-03-01,Senate,"Senate: Constitutional reading dispensed (40-Y 0-N)",40,0,0,0,40
1809937,1402493,2024-03-04,Senate,"Senate: Passed Senate (39-Y 0-N)",39,0,0,1,40
1809945,1371437,2024-01-30,House,"House: Subcommittee recommends reporting (5-Y 3-N)",5,3,0,0,8
1809945,1372724,2024-01-31,House,"House: Reported from Education (12-Y 10-N)",12,10,0,0,22
1809945,1376310,2024-02-05,House,"House: Subcommittee recommends reporting (6-Y 2-N)",6,2,0,1,9
1809945,1378738,2024-02-07,House,"House: Reported from Appropriations (12-Y 10-N)",12,10,0,0,22
1809945,1383209,2024-02-13,House,"House: VOTE: Passage (53-Y 46-N)",53,46,0,1,100
1809945,1399152,2024-02-29,Senate,"Senate: Reported from Education and Health (9-Y 6-N)",9,6,0,0,15
1809945,1400979,2024-03-01,Senate,"Senate: Constitutional reading dispensed (40-Y 0-N)",40,0,0,0,40
1809945,1403559,2024-03-05,Senate,"Senate: Passed Senate (20-Y 19-N)",20,19,0,1,40
1809954,1376765,2024-02-06,House,"House: Subcommittee recommends laying on the table (5-Y 2-N)",5,2,0,1,8
1809960,1376809,2024-02-06,House,"House: Subcommittee recommends reporting with substitute (8-Y 0-N)",8,0,0,0,8
1809960,1378289,2024-02-07,House,"House: Reported from Education with substitute (22-Y 0-N)",22,0,0,0,22
1809960,1383085,2024-02-13,House,"House: VOTE: Block Vote Passage (99-Y 0-N)",99,0,0,1,100
1809960,1399194,2024-02-29,Senate,"Senate: Reported from Education and Health (15-Y 0-N)",15,0,0,0,15
1809960,1400981,2024-03-01,Senate,"Senate: Constitutional reading dispensed (40-Y 0-N)",40,0,0,0,40
1809960,1401642,2024-03-04,Senate,"Senate: Passed Senate (39-Y 0-N)",39,0,0,1,40
1809980,1367590,2024-01-22,House,"House: Subcommittee recommends laying on the table (9-Y 0-N)",9,0,0,1,10
1809984,1371243,2024-01-29,House,"House: Subcommittee recommends reporting with substitute (10-Y 0-N)",10,0,0,0,10
1809984,1372673,2024-01-31,House,"House: Reported from Agriculture, Chesapeake and Natural Resources with substitute (21-Y 1-N)",21,1,0,0,22
1809984,1374652,2024-02-02,House,"House: Subcommittee recommends reporting (8-Y 0-N)",8,0,0,1,9
1809984,1374653,2024-02-02,House,"House: Reported from Appropriations (22-Y 0-N)",22,0,0,0,22
1809984,1380106,2024-02-08,House,"House: VOTE: Passage (93-Y 5-N)",93,5,0,2,100
1809984,1393308,2024-02-23,Senate,"Senate: Reported from Rules (15-Y 0-N)",15,0,0,0,15
1809984,1394433,2024-02-26,Senate,"Senate: Constitutional reading dispensed (40-Y 0-N)",40,0,0,0,40
1809984,1395970,2024-02-27,Senate,"Senate: Passed Senate (39-Y 0-N)",39,0,0,1,40
1809988,1367533,2024-01-22,House,"House: Subcommittee recommends laying on the table (5-Y 3-N)",5,3,0,0,8
1810011,1374865,2024-02-02,House,"House: Subcommittee recommends laying on the table (5-Y 3-N)",5,3,0,1,9
1810019,1377521,2024-02-06,House,"House: Subcommittee recommends reporting (6-Y 0-N)",6,0,0,1,7
1810019,1380251,2024-02-08,House,"House: Reported from Labor and Commerce (22-Y 0-N)",22,0,0,0,22
1810019,1383686,2024-02-13,House,"House: VOTE: Block Vote Passage (99-Y 0-N)",99,0,0,1,100
1810019,1401020,2024-03-01,Senate,"Senate: Reported from Rules (13-Y 0-N)",13,0,0,0,13
1810019,1402247,2024-03-04,Senate,"Senate: Constitutional reading dispensed (40-Y 0-N)",40,0,0,0,40
1810019,1403577,2024-03-05,Senate,"Senate: Passed Senate (40-Y 0-N)",40,0,0,0,40
1810024,1373916,2024-02-01,House,"House: Subcommittee recommends reporting with substitute (4-Y 2-N)",4,2,0,2,8
1810024,1377346,2024-02-06,House,"House: Reported from Labor and Commerce with substitute (12-Y 9-N)",12,9,0,1,22
1810024,1380658,2024-02-09,House,"House: Subcommittee recommends reporting with amendments (5-Y 3-N)",5,3,0,1,9
1810024,1380659,2024-02-09,House,"House: Reported from Appropriations with amendment(s) (12-Y 8-N)",12,8,0,2,22
1810024,1383070,2024-02-13,House,"House: VOTE: Passage (49-Y 47-N)",49,47,0,4,100
1810024,1394754,2024-02-26,Senate,"Senate: Reported from Commerce and Labor with substitute (9-Y 6-N)",9,6,0,0,15
1810024,1395578,2024-02-27,Senate,"Senate: Reported from Finance and Appropriations with substitute (15-Y 0-N)",15,0,0,0,15
1810024,1396194,2024-02-27,Senate,"Senate: Constitutional reading dispensed (39-Y 0-N)",39,0,0,1,40
1810024,1398508,2024-02-28,Senate,"Senate: Passed Senate with substitute (25-Y 14-N)",25,14,0,1,40
1810024,1398509,2024-02-28,House,"House: VOTE: REJECTED (0-Y 98-N)",0,98,0,2,100
1810024,1398510,2024-02-28,Senate,"Senate: Senate insisted on substitute (39-Y 0-N)",39,0,0,1,40
1810024,1404226,2024-03-06,House,"House: VOTE: Adoption (55-Y 42-N)",55,42,0,3,100
1810024,1405679,2024-03-07,Senate,"Senate: Conference report agreed to by Senate (27-Y 12-N)",27,12,0,1,40
1810036,1373569,2024-02-01,House,"House: Subcommittee recommends reporting (4-Y 2-N)",4,2,0,0,6
1810036,1374604,2024-02-02,House,"House: Reported from Public Safety (12-Y 10-N)",12,10,0,0,22
1810036,1378124,2024-02-07,House,"House: Subcommittee recommends reporting (5-Y 3-N)",5,3,0,1,9
1810036,1378777,2024-02-07,House,"House: Reported from Appropriations (11-Y 10-N)",11,10,0,1,22
1810036,1383228,2024-02-13,House,"House: VOTE: Passage (51-Y 48-N)",51,48,0,1,100
1810036,1393143,2024-02-23,Senate,"Senate: Reported from Rehabilitation and Social Services with amendments (8-Y 7-N)",8,7,0,0,15
1810036,1398192,2024-02-28,Senate,"Senate: Reported from Finance and Appropriations (10-Y 5-N)",10,5,0,0,15
1810036,1399064,2024-02-29,Senate,"Senate: Constitutional reading dispensed (39-Y 0-N)",39,0,0,1,40
1810036,1401938,2024-03-04,Senate,"Senate: Passed Senate with amendments (20-Y 19-N)",20,19,0,1,40
1810036,1402695,2024-03-05,House,"House: VOTE: Adoption (51-Y 49-N)",51,49,0,0,100
1810040,1367453,2024-01-22,House,"House: Subcommittee recommends laying on the table (7-Y 1-N)",7,1,0,1,9
1810045,1374866,2024-02-02,House,"House: Subcommittee recommends reporting (5-Y 3-N)",5,3,0,0,8
1810045,1377240,2024-02-06,House,"House: Reported from Transportation (21-Y 1-N)",21,1,0,0,22
1810045,1382402,2024-02-12,House,"House: VOTE: Passage (93-Y 5-N 1-A)",93,5,1,1,100
1810045,1392876,2024-02-22,Senate,"Senate: Reported from Transportation (13-Y 1-N 1-A)",13,1,1,0,15
1810045,1398159,2024-02-28,Senate,"Senate: Reported from Finance and Appropriations (15-Y 0-N)",15,0,0,0,15
1810045,1399399,2024-02-29,Senate,"Senate: Constitutional reading dispensed (39-Y 0-N)",39,0,0,1,40
1810045,1402255,2024-03-04,Senate,"Senate: Passed Senate (36-Y 2-N)",36,2,0,2,40
1810055,1377522,2024-02-06,House,"House: Subcommittee recommends reporting with substitute (5-Y 2-N)",5,2,0,1,8
1810055,1379958,2024-02-08,House,"House: Reported from General Laws with substitute (13-Y 7-N)",13,7,0,2,22
1810055,1380724,2024-02-09,House,"House: Subcommittee recommends reporting with substitute (4-Y 3-N)",4,3,0,2,9
1810055,1380725,2024-02-09,House,"House: Reported from Appropriations with substitute (11-Y 9-N)",11,9,0,2,22
1810055,1383433,2024-02-13,House,"House: VOTE: Passage (51-Y 48-N)",51,48,0,1,100
1810055,1390091,2024-02-21,Senate,"Senate: Reported from General Laws and Technology (9-Y 5-N)",9,5,0,0,14
1810055,1395856,2024-02-27,Senate,"Senate: Continued to 2025 in Finance and Appropriations (15-Y 0-N)",15,0,0,0,15
1810062,1375189,2024-02-02,House,"House: Subcommittee recommends laying on the table (8-Y 0-N)",8,0,0,1,9
1810067,1377612,2024-02-06,House,"House: Subcommittee recommends reporting with substitute (7-Y 0-N)",7,0,0,0,7
1810067,1379693,2024-02-08,House,"House: Reported from Labor and Commerce with substitute (22-Y 0-N)",22,0,0,0,22
1810067,1382887,2024-02-13,House,"House: VOTE: Passage (49-Y 50-N)",49,50,0,1,100
1810070,1373373,2024-01-31,House,"House: Subcommittee recommends reporting (7-Y 1-N)",7,1,0,1,9
1810070,1375879,2024-02-02,House,"House: Reported from Courts of Justice (17-Y 4-N)",17,4,0,1,22
1810070,1380214,2024-02-08,House,"House: VOTE: Passage (62-Y 36-N)",62,36,0,2,100
1810070,1387364,2024-02-19,Senate,"Senate: Reported from Courts of Justice with amendments (8-Y 4-N)",8,4,0,0,12
1810070,1388443,2024-02-20,Senate,"Senate: Constitutional reading dispensed (39-Y 0-N)",39,0,0,1,40
1810070,1390722,2024-02-21,Senate,"Senate: Passed Senate with amendments (21-Y 19-N)",21,19,0,0,40
1810070,1393768,2024-02-23,House,"House: VOTE: Adoption (53-Y 43-N)",53,43,0,4,100
1810086,1375169,2024-02-02,House,"House: Subcommittee recommends reporting (8-Y 0-N)",8,0,0,1,9
1810086,1378706,2024-02-07,House,"House: Reported from Courts of Justice (22-Y 0-N)",22,0,0,0,22
1810086,1383175,2024-02-13,House,"House: VOTE: Block Vote Passage (99-Y 0-N)",99,0,0,1,100
1810086,1391074,2024-02-21,Senate,"Senate: Reported from Courts of Justice (15-Y 0-N)",15,0,0,0,15
1810086,1393806,2024-02-23,Senate,"Senate: Constitutional reading dispensed (38-Y 0-N)",38,0,0,2,40
1810086,1394991,2024-02-26,Senate,"Senate: Passed Senate (40-Y 0-N)",40,0,0,0,40
1810091,1372816,2024-01-31,House,"House: Subcommittee recommends laying on the table (8-Y 0-N)",8,0,0,1,9
1810096,1373830,2024-02-01,House,"House: Subcommittee recommends reporting with substitute (8-Y 0-N)",8,0,0,0,8
1810096,1377501,2024-02-06,House,"House: Reported from Health and Human Services with substitute (20-Y 2-N)",20,2,0,0,22
1810096,1382242,2024-02-12,House,"House: VOTE: Passage (97-Y 3-N)",97,3,0,0,100
1810096,1399249,2024-02-29,Senate,"Senate: Reported from Education and Health (15-Y 0-N)",15,0,0,0,15
1810096,1401251,2024-03-01,Senate,"Senate: Constitutional reading dispensed (40-Y 0-N)",40,0,0,0,40
1810096,1402508,2024-03-04,Senate,"Senate: Passed Senate (39-Y 0-N)",39,0,0,1,40
1810100,1373573,2024-02-01,House,"House: Subcommittee recommends reporting with amendments (6-Y 0-N)",6,0,0,0,6
1810100,1374496,2024-02-02,House,"House: Reported from Public Safety with amendment(s) (22-Y 0-N)",22,0,0,0,22
1810100,1379884,2024-02-08,House,"House: VOTE: Block Vote Passage (98-Y 0-N)",98,0,0,2,100
1810100,1398615,2024-02-28,Senate,"Senate: Reported from General Laws and Technology (13-Y 2-N)",13,2,0,0,15
1810100,1400766,2024-03-01,Senate,"Senate: Constitutional reading dispensed (40-Y 0-N)",40,0,0,0,40
1810100,1403301,2024-03-05,Senate,"Senate: Passed Senate (40-Y 0-N)",40,0,0,0,40
1810107,1369104,2024-01-25,House,"House: Subcommittee recommends reporting (8-Y 0-N)",8,0,0,0,8
1810107,1371472,2024-01-30,House,"House: Reported from Health and Human Services with substitute (22-Y 0-N)",22,0,0,0,22
1810107,1376400,2024-02-05,House,"House: VOTE: (96-Y 1-N)",96,1,0,3,100
1810107,1386664,2024-02-16,Senate,"Senate: Reported from Rehabilitation and Social Services with substitute (10-Y 3-N)",10,3,0,0,13
1810107,1387736,2024-02-19,Senate,"Senate: Constitutional reading dispensed (38-Y 0-N)",38,0,0,2,40
1810107,1388820,2024-02-20,Senate,"Senate: Passed Senate with substitute (30-Y 10-N)",30,10,0,0,40
1810107,1391945,2024-02-22,House,"House: VOTE: REJECTED (1-Y 98-N)",1,98,0,1,100
1810107,1394379,2024-02-26,Senate,"Senate: Senate insisted on amendment (40-Y 0-N)",40,0,0,0,40
1810107,1405386,2024-03-07,House,"House: VOTE: Adoption (93-Y 3-N)",93,3,0,4,100
1810107,1406155,2024-03-08,Senate,"Senate: Conference report agreed to by Senate (34-Y 6-N)",34,6,0,0,40
1810110,1368263,2024-01-24,House,"House: Subcommittee recommends reporting with substitute (10-Y 0-N)",10,0,0,0,10
1810110,1372421,2024-01-31,House,"House: Reported from Agriculture, Chesapeake and Natural Resources with substitute (22-Y 0-N)",22,0,0,0,22
1810117,1375269,2024-02-02,House,"House: Subcommittee recommends laying on the table (8-Y 0-N)",8,0,0,1,9
1810123,1373911,2024-02-01,House,"House: Subcommittee recommends passing by indefinitely (7-Y 1-N)",7,1,2,0,10
1810128,1373352,2024-01-31,House,"House: Subcommittee recommends reporting (8-Y 0-N)",8,0,0,1,9
1810128,1375554,2024-02-02,House,"House: Reported from Courts of Justice (21-Y 0-N)",21,0,0,1,22
1810128,1380174,2024-02-08,House,"House: VOTE: Block Vote Passage (98-Y 0-N)",98,0,0,2,100
1810128,1393228,2024-02-23,Senate,"Senate: Reported from Rehabilitation and Social Services (15-Y 0-N)",15,0,0,0,15
1810128,1397540,2024-02-28,Senate,"Senate: Reported from Finance and Appropriations (15-Y 0-N)",15,0,0,0,15
1810128,1399202,2024-02-29,Senate,"Senate: Constitutional reading dispensed (39-Y 0-N)",39,0,0,1,40
1810128,1401001,2024-03-01,Senate,"Senate: Passed Senate (40-Y 0-N)",40,0,0,0,40
1810137,1379140,2024-02-08,House,"House: Subcommittee recommends reporting with substitute (6-Y 0-N)",6,0,0,0,6
1810137,1380526,2024-02-09,House,"House: Reported from Public Safety with substitute (21-Y 0-N)",21,0,0,1,22
1810137,1380697,2024-02-09,House,"House: Subcommittee recommends reporting (7-Y 0-N)",7,0,0,2,9
1810137,1380698,2024-02-09,House,"House: Reported from Appropriations (19-Y 0-N)",19,0,0,3,22
1810137,1382856,2024-02-13,House,"House: VOTE: Block Vote Passage (99-Y 0-N)",99,0,0,1,100
1810137,1390854,2024-02-21,Senate,"Senate: Reported from Courts of Justice with amendment (10-Y 0-N)",10,0,0,0,10
1810137,1397497,2024-02-28,Senate,"Senate: Reported from Finance and Appropriations (15-Y 0-N)",15,0,0,0,15
1810137,1399157,2024-02-29,Senate,"Senate: Constitutional reading dispensed (39-Y 0-N)",39,0,0,1,40
1810137,1400956,2024-03-01,Senate,"Senate: Passed Senate with amendment (40-Y 0-N)",40,0,0,0,40
1810137,1401621,2024-03-04,House,"House: VOTE: Adoption (97-Y 0-N)",97,0,0,3,100
1810141,1372375,2024-01-31,House,"House: Subcommittee recommends laying on the table (5-Y 3-N)",5,3,0,0,8
1810148,1379459,2024-02-08,House,"House: Subcommittee recommends reporting (5-Y 3-N)",5,3,0,0,8
1810148,1380420,2024-02-08,House,"House: Reported from Labor and Commerce (22-Y 0-N)",22,0,0,0,22
1810148,1382931,2024-02-13,House,"House: VOTE: Block Vote Passage (99-Y 0-N)",99,0,0,1,100
1810148,1393283,2024-02-23,Senate,"Senate: Rereferred from Rehabilitation and Social Services (15-Y 0-N)",15,0,0,0,15
1810148,1401771,2024-03-04,Senate,"Senate: Reported from Commerce and Labor (13-Y 0-N)",13,0,0,0,13
1810148,1403111,2024-03-05,Senate,"Senate: Constitutional reading dispensed (40-Y 0-N)",40,0,0,0,40
1810148,1404276,2024-03-06,Senate,"Senate: Passed Senate (40-Y 0-N)",40,0,0,0,40
1810153,1379442,2024-02-08,House,"House: Subcommittee recommends reporting (8-Y 0-N)",8,0,0,0,8
1810153,1380418,2024-02-08,House,"House: Reported from Labor and Commerce (22-Y 0-N)",22,0,0,0,22
1810153,1383777,2024-02-13,House,"House: VOTE: Block Vote Passage (99-Y 0-N)",99,0,0,1,100
1810153,1401545,2024-03-04,Senate,"Senate: Reported from Commerce and Labor with amendments (14-Y 0-N)",14,0,0,0,14
1810153,1402841,2024-03-05,Senate,"Senate: Constitutional reading dispensed (40-Y 0-N)",40,0,0,0,40
1810153,1404086,2024-03-06,Senate,"Senate: Passed Senate with amendments (40-Y 0-N)",40,0,0,0,40
1810153,1405124,2024-03-07,House,"House: VOTE: Adoption (99-Y 0-N)",99,0,0,1,100
1810160,1371004,2024-01-29,House,"House: Subcommittee recommends reporting with substitute (8-Y 0-N)",8,0,0,1,9
1810160,1375643,2024-02-02,House,"House: Reported from Courts of Justice with substitute (21-Y 0-N)",21,0,0,1,22
1810160,1380359,2024-02-08,House,"House: VOTE: Block Vote Passage (98-Y 0-N)",98,0,0,2,100
1810160,1398850,2024-02-28,Senate,"Senate: Reported from Courts of Justice (15-Y 0-N)",15,0,0,0,15
1810160,1401066,2024-03-01,Senate,"Senate: Constitutional reading dispensed (40-Y 0-N)",40,0,0,0,40
1810160,1402281,2024-03-04,Senate,"Senate: Passed Senate (39-Y 0-N)",39,0,0,1,40
1810168,1378651,2024-02-07,House,"House: Subcommittee recommends striking from docket (8-Y 0-N)",8,0,0,0,8
1810178,1368556,2024-01-24,House,"House: Subcommittee recommends reporting with substitute (8-Y 1-N)",8,1,0,0,9
1810178,1370677,2024-01-29,House,"House: Reported from Education with substitute (20-Y 2-N)",20,2,0,0,22
1810178,1375155,2024-02-02,House,"House: VOTE: Passage (99-Y 1-N)",99,1,0,0,100
1810178,1392448,2024-02-22,Senate,"Senate: Reported from Education and Health (15-Y 0-N)",15,0,0,0,15
1810178,1393923,2024-02-23,Senate,"Senate: Constitutional reading dispensed (38-Y 0-N)",38,0,0,2,40
1810178,1395178,2024-02-26,Senate,"Senate: Passed Senate (40-Y 0-N)",40,0,0,0,40
1810190,1372114,2024-01-30,House,"House: Subcommittee recommends laying on the table (6-Y 2-N)",6,2,0,0,8
1810193,1370284,2024-01-29,House,"House: Subcommittee recommends reporting (8-Y 0-N)",8,0,0,1,9
1810193,1371202,2024-01-29,House,"House: Reported from Appropriations (21-Y 0-N)",21,0,0,1,22
1810193,1375122,2024-02-02,House,"House: VOTE: Block Vote Passage (92-Y 0-N)",92,0,0,8,100
1810193,1402119,2024-03-04,Senate,"Senate: Reported from Finance and Appropriations with amendment (14-Y 1-N)",14,1,0,0,15
1810193,1403337,2024-03-05,Senate,"Senate: Constitutional reading dispensed (39-Y 0-N)",39,0,0,1,40
1810193,1404570,2024-03-06,Senate,"Senate: Passed Senate with amendment (38-Y 2-N)",38,2,0,0,40
1810193,1405877,2024-03-07,House,"House: VOTE: Adoption (98-Y 1-N)",98,1,0,1,100
1810202,1378417,2024-02-07,House,"House: Subcommittee recommends striking from docket (8-Y 0-N)",8,0,0,0,8
1810207,1369695,2024-01-26,House,"House: Subcommittee recommends continuing to 2025 with amendment(s) (0-Y 0-N)",0,0,0,8,8
1810215,1374171,2024-02-01,House,"House: Subcommittee recommends reporting with amendments (6-Y 2-N)",6,2,0,0,8
1810215,1377711,2024-02-06,House,"House: Reported from General Laws with amendment(s) (10-Y 9-N)",10,9,0,3,22
1810215,1382125,2024-02-12,House,"House: VOTE: Passage (51-Y 48-N)",51,48,0,1,100
1810215,1390249,2024-02-21,Senate,"Senate: Reported from General Laws and Technology with amendments (9-Y 6-N)",9,6,0,0,15
1810215,1393943,2024-02-23,Senate,"Senate: Constitutional reading dispensed (38-Y 0-N)",38,0,0,2,40
1810215,1394664,2024-02-26,Senate,"Senate: Passed Senate with amendments (21-Y 19-N)",21,19,0,0,40
1810215,1398447,2024-02-28,House,"House: VOTE: Adoption (51-Y 48-N)",51,48,0,1,100
1810220,1373945,2024-02-01,House,"House: Subcommittee recommends reporting (3-Y 2-N)",3,2,0,3,8
1810220,1377376,2024-02-06,House,"House: Tabled in Labor and Commerce (11-Y 10-N)",11,10,0,1,22
1810225,1375550,2024-02-05,House,"House: Subcommittee recommends laying on the table (5-Y 3-N)",5,3,0,1,9
1810231,1374179,2024-02-01,House,"House: Subcommittee recommends reporting (7-Y 0-N)",7,0,0,1,8
1810231,1374530,2024-02-01,House,"House: Subcommittee recommends reporting (8-Y 0-N)",8,0,0,0,8
1810231,1377509,2024-02-06,House,"House: Reported from General Laws with amendment(s) (20-Y 0-N)",20,0,0,2,22
1810231,1382075,2024-02-12,House,"House: VOTE: Passage (98-Y 2-N)",98,2,0,0,100
1810231,1391090,2024-02-21,Senate,"Senate: Reported from General Laws and Technology (13-Y 0-N)",13,0,0,0,13
1810231,1393986,2024-02-23,Senate,"Senate: Constitutional reading dispensed (38-Y 0-N)",38,0,0,2,40
1810231,1394442,2024-02-26,Senate,"Senate: Passed Senate (40-Y 0-N)",40,0,0,0,40
1810234,1374266,2024-02-01,House,"House: Subcommittee recommends reporting with substitute (7-Y 1-N)",7,1,0,0,8
1810234,1377677,2024-02-06,House,"House: Reported from General Laws with substitute (20-Y 0-N)",20,0,0,2,22
1810234,1382154,2024-02-12,House,"House: VOTE: Block Vote Passage (100-Y 0-N)",100,0,0,0,100
1810234,1398619,2024-02-28,Senate,"Senate: Reported from General Laws and Technology with amendments (15-Y 0-N)",15,0,0,0,15
1810234,1400725,2024-03-01,Senate,"Senate: Constitutional reading dispensed (40-Y 0-N)",40,0,0,0,40
1810234,1402125,2024-03-04,Senate,"Senate: Passed Senate with amendments (39-Y 0-N)",39,0,0,1,40
1810234,1403280,2024-03-05,House,"House: VOTE: Adoption (100-Y 0-N)",100,0,0,0,100
1810251,1369160,2024-01-25,House,"House: Subcommittee recommends reporting (5-Y 2-N)",5,2,0,1,8
1810251,1369749,2024-01-26,House,"House: Reported from Counties, Cities and Towns (15-Y 5-N)",15,5,0,2,22
1810251,1373662,2024-02-01,House,"House: VOTE: Passage (78-Y 20-N)",78,20,0,2,100
1810251,1394650,2024-02-26,Senate,"Senate: Reported from Local Government (11-Y 4-N)",11,4,0,0,15
1810251,1396340,2024-02-27,Senate,"Senate: Constitutional reading dispensed (39-Y 0-N)",39,0,0,1,40
1810251,1398667,2024-02-28,Senate,"Senate: Passed Senate (28-Y 11-N)",28,11,0,1,40
1810251,1398668,2024-02-28,Senate,"Senate: Reconsideration of Senate passage agreed to by Senate (39-Y 0-N)",39,0,0,1,40
1810251,1398669,2024-02-28,Senate,"Senate: Passed Senate (23-Y 16-N)",23,16,0,1,40
1810254,1374049,2024-02-01,House,"House: Subcommittee recommends reporting with amendments (8-Y 0-N)",8,0,0,0,8
1810254,1377353,2024-02-06,House,"House: Reported from General Laws with amendment(s) (17-Y 3-N)",17,3,0,2,22
1810254,1382018,2024-02-12,House,"House: VOTE: Passage (68-Y 31-N)",68,31,0,1,100
1810254,1398344,2024-02-28,Senate,"Senate: Reported from General Laws and Technology (15-Y 0-N)",15,0,0,0,15
1810254,1401130,2024-03-01,Senate,"Senate: Constitutional reading dispensed (40-Y 0-N)",40,0,0,0,40
1810254,1402329,2024-03-04,Senate,"Senate: Passed Senate (39-Y 0-N)",39,0,0,1,40
1810254,1429778,2024-04-17,Senate,"Senate: Senate concurred in Governor's recommendation (40-Y 0-N)",40,0,0,0,40
1810254,1429779,2024-04-17,House,"House: VOTE: Adoption (77-Y 20-N)",77,20,0,3,100
1810260,1373432,2024-01-31,House,"House: Subcommittee recommends laying on the table (8-Y 0-N)",8,0,0,1,9
1810264,1377468,2024-02-06,House,"House: Subcommittee recommends reporting with substitute (4-Y 2-N)",4,2,0,1,7
1810264,1379952,2024-02-08,House,"House: Reported from Labor and Commerce with substitute (22-Y 0-N)",22,0,0,0,22
1810264,1383645,2024-02-13,House,"House: VOTE: Block Vote Passage (99-Y 0-N)",99,0,0,1,100
1810264,1401498,2024-03-04,Senate,"Senate: Reported from Commerce and Labor (11-Y 0-N 2-A)",11,0,2,0,13
1810264,1403589,2024-03-05,Senate,"Senate: Constitutional reading dispensed (40-Y 0-N)",40,0,0,0,40
1810264,1404676,2024-03-06,Senate,"Senate: Passed Senate (39-Y 0-N 1-A)",39,0,1,0,40
1810272,1373902,2024-02-01,House,"House: Subcommittee recommends laying on the table (6-Y 0-N)",6,0,0,2,8
1810280,1374158,2024-02-01,House,"House: Failed to report (defeated) in Labor and Commerce (9-Y 13-N)",9,13,0,0,22
1810290,1369849,2024-01-26,House,"House: Subcommittee recommends reporting with amendments (8-Y 0-N)",8,0,0,0,8
1810290,1369850,2024-01-26,House,"House: Reported from Counties, Cities and Towns with amendment(s) (20-Y 0-N)",20,0,0,2,22
1810290,1378603,2024-02-07,House,"House: VOTE: Block Vote Passage (100-Y 0-N)",100,0,0,0,100
1810290,1394467,2024-02-26,Senate,"Senate: Reported from Local Government (14-Y 0-N)",14,0,0,0,14
1810290,1396086,2024-02-27,Senate,"Senate: Constitutional reading dispensed (39-Y 0-N)",39,0,0,1,40
1810290,1397682,2024-02-28,Senate,"Senate: Passed Senate (39-Y 0-N)",39,0,0,1,40
1810306,1371225,2024-01-29,House,"House: Subcommittee recommends reporting with substitute (7-Y 0-N)",7,0,0,2,9
1810306,1373316,2024-01-31,House,"House: Reported from Appropriations with substitute (22-Y 0-N)",22,0,0,0,22
1810306,1376963,2024-02-06,House,"House: VOTE: Passage (87-Y 8-N)",87,8,0,5,100
1810320,1370475,2024-01-29,House,"House: Subcommittee recommends reporting (7-Y 1-N)",7,1,0,1,9
1810320,1380988,2024-02-09,House,"House: Reported from Courts of Justice with substitute (21-Y 1-N)",21,1,0,0,22
1810320,1383663,2024-02-13,House,"House: VOTE: Passage (98-Y 0-N)",98,0,0,2,100
1810320,1398726,2024-02-28,Senate,"Senate: Reported from Courts of Justice with substitute (15-Y 0-N)",15,0,0,0,15
1810320,1401059,2024-03-01,Senate,"Senate: Constitutional reading dispensed (40-Y 0-N)",40,0,0,0,40
1810320,1401746,2024-03-04,Senate,"Senate: Passed Senate with substitute (21-Y 16-N)",21,16,0,3,40
1810320,1402821,2024-03-05,House,"House: VOTE: Adoption (85-Y 9-N)",85,9,0,6,100
1810328,1377419,2024-02-06,House,"House: Subcommittee recommends reporting with substitute (7-Y 1-N)",7,1,0,0,8
1810328,1378047,2024-02-07,House,"House: Reported from Education with substitute (13-Y 9-N)",13,9,0,0,22
1810328,1383894,2024-02-13,House,"House: VOTE: Passage (53-Y 45-N)",53,45,0,2,100
1810328,1398968,2024-02-29,Senate,"Senate: Reported from Education and Health with substitute (14-Y 0-N)",14,0,0,0,14
1810328,1401226,2024-03-01,Senate,"Senate: Constitutional reading dispensed (40-Y 0-N)",40,0,0,0,40
1810328,1402451,2024-03-04,Senate,"Senate: Passed Senate with substitute (37-Y 1-N)",37,1,0,2,40
1810328,1403667,2024-03-05,House,"House: VOTE: Adoption (54-Y 46-N)",54,46,0,0,100
1810335,1374415,2024-02-01,House,"House: Subcommittee recommends reporting with substitute (7-Y 1-N)",7,1,0,0,8
1810335,1377502,2024-02-06,House,"House: Reported from General Laws with substitute (13-Y 7-N)",13,7,0,2,22
1810335,1382357,2024-02-12,House,"House: VOTE: Passage (58-Y 42-N)",58,42,0,0,100
1810335,1391172,2024-02-21,Senate,"Senate: Reported from General Laws and Technology (9-Y 6-N)",9,6,0,0,15
1810335,1393487,2024-02-23,Senate,"Senate: Constitutional reading dispensed (38-Y 0-N)",38,0,0,2,40
1810335,1395340,2024-02-26,Senate,"Senate: Passed Senate (21-Y 19-N)",21,19,0,0,40
1810339,1377516,2024-02-06,House,"House: Subcommittee recommends laying on the table (6-Y 2-N)",6,2,0,0,8
1810364,1369985,2024-01-26,House,"House: Subcommittee recommends reporting with amendments (5-Y 3-N)",5,3,0,1,9
1810364,1375874,2024-02-02,House,"House: Reported from Courts of Justice with amendment(s) (12-Y 9-N)",12,9,0,1,22
1810364,1380258,2024-02-08,House,"House: VOTE: Passage (50-Y 47-N)",50,47,0,3,100
1810364,1387957,2024-02-19,Senate,"Senate: Reported from Courts of Justice with substitute (8-Y 5-N)",8,5,0,0,13
1810364,1396147,2024-02-27,Senate,"Senate: Continued to 2025 in Finance and Appropriations (14-Y 1-N)",14,1,0,0,15
1810375,1376832,2024-02-06,House,"House: Subcommittee recommends laying on the table (8-Y 0-N)",8,0,0,0,8
1810379,1379462,2024-02-08,House,"House: Subcommittee recommends reporting with amendments (8-Y 0-N)",8,0,0,0,8
1810379,1380417,2024-02-08,House,"House: Reported from Labor and Commerce with amendment(s) (22-Y 0-N)",22,0,0,0,22
1810379,1383878,2024-02-13,House,"House: VOTE: Passage (89-Y 9-N)",89,9,0,2,100
1810379,1395454,2024-02-26,Senate,"Senate: Reported from Commerce and Labor with substitute (15-Y 0-N)",15,0,0,0,15
1810379,1398767,2024-02-28,Senate,"Senate: Constitutional reading dispensed (39-Y 0-N)",39,0,0,1,40
1810379,1399426,2024-02-29,Senate,"Senate: Passed Senate with substitute (39-Y 0-N)",39,0,0,1,40
1810379,1401831,2024-03-04,House,"House: VOTE: Adoption (88-Y 8-N)",88,8,0,4,100
1810383,1373544,2024-02-01,House,"House: Subcommittee recommends laying on the table (8-Y 0-N)",8,0,0,0,8
1810387,1374319,2024-02-01,House,"House: Subcommittee recommends reporting with substitute (8-Y 0-N)",8,0,0,0,8
1810387,1377520,2024-02-06,House,"House: Reported from General Laws with substitute (20-Y 0-N)",20,0,0,2,22
1810387,1382057,2024-02-12,House,"House: VOTE: Block Vote Passage (100-Y 0-N)",100,0,0,0,100
1810387,1390300,2024-02-21,Senate,"Senate: Reported from General Laws and Technology (10-Y 0-N)",10,0,0,0,10
1810387,1393618,2024-02-23,Senate,"Senate: Constitutional reading dispensed (38-Y 0-N)",38,0,0,2,40
1810387,1394441,2024-02-26,Senate,"Senate: Passed Senate (40-Y 0-N)",40,0,0,0,40
1810409,1374305,2024-02-01,House,"House: Subcommittee recommends reporting with amendments (7-Y 0-N)",7,0,0,1,8
1810409,1377832,2024-02-06,House,"House: Reported from Labor and Commerce with amendment(s) (21-Y 0-N)",21,0,0,1,22
1810415,1373186,2024-01-31,House,"House: Subcommittee recommends reporting with substitute (5-Y 3-N)",5,3,0,0,8
1810415,1377308,2024-02-06,House,"House: Reported from Transportation with substitute (11-Y 10-N)",11,10,0,1,22
1810415,1382192,2024-02-12,House,"House: VOTE: Defeated (49-Y 49-N)",49,49,0,2,100
1810415,1382193,2024-02-12,House,"House: VOTE: Passage #2 (51-Y 47-N)",51,47,0,2,100
1810415,1400446,2024-02-29,Senate,"Senate: Failed to report (defeated) in Transportation (6-Y 8-N)",6,8,0,0,14
1810418,1376829,2024-02-06,House,"House: Subcommittee recommends striking from docket (8-Y 0-N)",8,0,0,0,8
1810435,1374288,2024-02-01,House,"House: Subcommittee recommends reporting with amendments (5-Y 2-N)",5,2,0,1,8
1810435,1377735,2024-02-06,House,"House: Reported from Labor and Commerce with amendment(s) (12-Y 10-N)",12,10,0,0,22
1810435,1382050,2024-02-12,House,"House: VOTE: Passage (51-Y 47-N)",51,47,0,2,100
1810435,1395213,2024-02-26,Senate,"Senate: Reported from Commerce and Labor (9-Y 6-N)",9,6,0,0,15
1810435,1399970,2024-02-29,Senate,"Senate: Continued to 2025 in Finance and Appropriations (14-Y 0-N)",14,0,0,0,14
1810439,1370390,2024-01-29,House,"House: Subcommittee recommends laying on the table (5-Y 3-N)",5,3,0,1,9
1810445,1375011,2024-02-02,House,"House: Subcommittee recommends laying on the table (5-Y 2-N)",5,2,0,2,9
1810449,1376768,2024-02-06,House,"House: Subcommittee recommends reporting (8-Y 0-N)",8,0,0,0,8
1810449,1379150,2024-02-08,House,"House: Reported from Transportation (22-Y 0-N)",22,0,0,0,22
1810449,1383226,2024-02-13,House,"House: VOTE: Block Vote Passage (99-Y 0-N)",99,0,0,1,100
1810449,1392286,2024-02-22,Senate,"Senate: Reported from Transportation (15-Y 0-N)",15,0,0,0,15
1810449,1397481,2024-02-28,Senate,"Senate: Reported from Finance and Appropriations (15-Y 0-N)",15,0,0,0,15
1810449,1399149,2024-02-29,Senate,"Senate: Constitutional reading dispensed (39-Y 0-N)",39,0,0,1,40
1810449,1400975,2024-03-01,Senate,"Senate: Passed Senate (40-Y 0-N)",40,0,0,0,40
1810456,1374455,2024-02-01,House,"House: Subcommittee recommends laying on the table (8-Y 0-N)",8,0,0,0,8
1810461,1374307,2024-02-01,House,"House: Subcommittee recommends reporting with amendments (7-Y 0-N)",7,0,0,1,8
1810461,1374561,2024-02-01,House,"House: Subcommittee recommends reporting with amendments (8-Y 0-N)",8,0,0,0,8
1810461,1377331,2024-02-06,House,"House: Reported from General Laws with amendment(s) (20-Y 0-N)",20,0,0,2,22
1810461,1382392,2024-02-12,House,"House: VOTE: Block Vote Passage (100-Y 0-N)",100,0,0,0,100
1810461,1390123,2024-02-21,Senate,"Senate: Reported from General Laws and Technology with amendment (15-Y 0-N)",15,0,0,0,15
1810461,1393518,2024-02-23,Senate,"Senate: Constitutional reading dispensed (38-Y 0-N)",38,0,0,2,40
1810461,1395395,2024-02-26,Senate,"Senate: Passed Senate with amendment (40-Y 0-N)",40,0,0,0,40
1810461,1398707,2024-02-28,House,"House: VOTE: Adoption (96-Y 2-N)",96,2,0,2,100
1810465,1370013,2024-01-26,House,"House: Subcommittee recommends reporting with amendments (8-Y 0-N)",8,0,0,1,9
1810465,1375864,2024-02-02,House,"House: Reported from Courts of Justice with amendment(s) (21-Y 0-N)",21,0,0,1,22
1810465,1380752,2024-02-09,House,"House: Subcommittee recommends laying on the table (7-Y 0-N)",7,0,0,2,9
1810469,1369444,2024-01-25,House,"House: Subcommittee recommends reporting (8-Y 0-N)",8,0,0,0,8
1810469,1371493,2024-01-30,House,"House: Reported from Health and Human Services (22-Y 0-N)",22,0,0,0,22
1810469,1375088,2024-02-02,House,"House: Subcommittee recommends laying on the table (8-Y 0-N)",8,0,0,1,9
1810476,1375101,2024-02-02,House,"House: Subcommittee recommends reporting with substitute (7-Y 0-N)",7,0,0,2,9
1810476,1378385,2024-02-07,House,"House: Reported from Courts of Justice with substitute (22-Y 0-N)",22,0,0,0,22
1810476,1383030,2024-02-13,House,"House: VOTE: Block Vote Passage (99-Y 0-N)",99,0,0,1,100
1810476,1391067,2024-02-21,Senate,"Senate: Reported from Courts of Justice (15-Y 0-N)",15,0,0,0,15
1810476,1394096,2024-02-23,Senate,"Senate: Constitutional reading dispensed (38-Y 0-N)",38,0,0,2,40
1810476,1395042,2024-02-26,Senate,"Senate: Passed Senate (40-Y 0-N)",40,0,0,0,40
1810479,1370997,2024-01-29,House,"House: Subcommittee recommends laying on the table (4-Y 2-N)",4,2,0,0,6
1810491,1378823,2024-02-07,House,"House: Subcommittee recommends striking from docket (8-Y 0-N)",8,0,0,0,8
1810496,1377038,2024-02-06,House,"House: Subcommittee recommends reporting (7-Y 0-N)",7,0,0,1,8
1810496,1379083,2024-02-08,House,"House: Reported from Health and Human Services (22-Y 0-N)",22,0,0,0,22
1810496,1383323,2024-02-13,House,"House: VOTE: Defeated (45-Y 53-N)",45,53,0,2,100
1810496,1383324,2024-02-13,House,"House: VOTE:Defeated #2 (48-Y 50-N)",48,50,0,2,100
1810508,1377632,2024-02-06,House,"House: Subcommittee recommends laying on the table (5-Y 3-N)",5,3,0,0,8
1810517,1378372,2024-02-07,House,"House: Stricken from docket by Education (19-Y 2-N)",19,2,0,1,22
1810521,1371032,2024-01-29,House,"House: Subcommittee recommends reporting with substitute (5-Y 3-N)",5,3,0,1,9
1810521,1375749,2024-02-02,House,"House: Reported from Courts of Justice with substitute (12-Y 9-N)",12,9,0,1,22
1810521,1379688,2024-02-08,House,"House: VOTE: Passage (51-Y 47-N)",51,47,0,2,100
1810521,1388033,2024-02-19,Senate,"Senate: Reported from Courts of Justice (9-Y 5-N)",9,5,0,0,14
1810521,1395588,2024-02-27,Senate,"Senate: Reported from Finance and Appropriations (10-Y 5-N)",10,5,0,0,15
1810521,1396947,2024-02-27,Senate,"Senate: Constitutional reading dispensed (39-Y 0-N)",39,0,0,1,40
1810521,1398370,2024-02-28,Senate,"Senate: Passed Senate (22-Y 17-N)",22,17,0,1,40
1810528,1370993,2024-01-29,House,"House: Subcommittee recommends laying on the table (6-Y 0-N)",6,0,0,0,6
1810531,1370538,2024-01-29,House,"House: Subcommittee recommends reporting with substitute (8-Y 0-N)",8,0,0,1,9
1810531,1378613,2024-02-07,House,"House: Reported from Courts of Justice with substitute (22-Y 0-N)",22,0,0,0,22
1810531,1383817,2024-02-13,House,"House: VOTE: Block Vote Passage (99-Y 0-N)",99,0,0,1,100
1810531,1391080,2024-02-21,Senate,"Senate: Reported from Courts of Justice (9-Y 0-N)",9,0,0,0,9
1810531,1393776,2024-02-23,Senate,"Senate: Constitutional reading dispensed (38-Y 0-N)",38,0,0,2,40
1810531,1394596,2024-02-26,Senate,"Senate: Passed Senate (40-Y 0-N)",40,0,0,0,40
1810537,1376296,2024-02-05,House,"House: Subcommittee recommends continuing to 2025 with amendment(s) (7-Y 0-N)",7,0,0,1,8
1810547,1369448,2024-01-25,House,"House: Subcommittee recommends reporting (7-Y 1-N)",7,1,0,0,8
1810547,1371636,2024-01-30,House,"House: Reported from General Laws with amendment(s) (22-Y 0-N)",22,0,0,0,22
1810547,1375947,2024-02-05,House,"House: VOTE: Block Vote Passage (98-Y 0-N)",98,0,0,2,100
1810547,1385064,2024-02-14,Senate,"Senate: Reported from General Laws and Technology with amendments (15-Y 0-N)",15,0,0,0,15
1810547,1386628,2024-02-16,Senate,"Senate: Constitutional reading dispensed (38-Y 0-N)",38,0,0,2,40
1810547,1388035,2024-02-19,Senate,"Senate: Passed Senate with amendments (31-Y 8-N)",31,8,0,1,40
1810547,1390001,2024-02-21,House,"House: VOTE: Adoption (92-Y 5-N)",92,5,0,3,100
1810559,1371461,2024-01-30,House,"House: Subcommittee recommends reporting (7-Y 0-N)",7,0,1,0,8
1810559,1373636,2024-02-01,House,"House: Reported from Transportation (22-Y 0-N)",22,0,0,0,22
1810559,1378151,2024-02-07,House,"House: Subcommittee recommends reporting with substitute (8-Y 0-N)",8,0,0,1,9
1810559,1378895,2024-02-07,House,"House: Reported from Appropriations with substitute (22-Y 0-N)",22,0,0,0,22
1810559,1383005,2024-02-13,House,"House: VOTE: Block Vote Passage (99-Y 0-N)",99,0,0,1,100
1810559,1391898,2024-02-22,Senate,"Senate: Reported from Transportation (15-Y 0-N)",15,0,0,0,15
1810559,1397954,2024-02-28,Senate,"Senate: Reported from Finance and Appropriations (13-Y 0-N)",13,0,0,0,13
1810559,1399683,2024-02-29,Senate,"Senate: Constitutional reading dispensed (39-Y 0-N)",39,0,0,1,40
1810559,1400934,2024-03-01,Senate,"Senate: Passed Senate (40-Y 0-N)",40,0,0,0,40
1810567,1377400,2024-02-06,House,"House: Subcommittee recommends reporting with substitute (8-Y 0-N)",8,0,0,0,8
1810567,1378312,2024-02-07,House,"House: Reported from Education with substitute (22-Y 0-N)",22,0,0,0,22
1810567,1383455,2024-02-13,House,"House: VOTE: Block Vote Passage (99-Y 0-N)",99,0,0,1,100
1810567,1399138,2024-02-29,Senate,"Senate: Reported from Education and Health (12-Y 3-N)",12,3,0,0,15
1810567,1400971,2024-03-01,Senate,"Senate: Constitutional reading dispensed (40-Y 0-N)",40,0,0,0,40
1810567,1403545,2024-03-05,Senate,"Senate: Passed Senate (36-Y 4-N)",36,4,0,0,40
1810573,1378623,2024-02-07,House,"House: Subcommittee recommends striking from docket (8-Y 0-N)",8,0,0,0,8
1810579,1368033,2024-01-23,House,"House: Subcommittee recommends laying on the table (8-Y 0-N)",8,0,0,1,9
1810583,1376787,2024-02-06,House,"House: Subcommittee recommends reporting with substitute (8-Y 0-N)",8,0,0,0,8
1810583,1378077,2024-02-07,House,"House: Reported from Education with substitute (22-Y 0-N)",22,0,0,0,22
1810583,1383843,2024-02-13,House,"House: VOTE: Block Vote Passage (99-Y 0-N)",99,0,0,1,100
1810583,1399504,2024-02-29,Senate,"Senate: Reported from Education and Health with amendment (15-Y 0-N)",15,0,0,0,15
1810583,1400823,2024-03-01,Senate,"Senate: Constitutional reading dispensed (40-Y 0-N)",40,0,0,0,40
1810583,1402092,2024-03-04,Senate,"Senate: Passed Senate with amendment (39-Y 0-N)",39,0,0,1,40
1810583,1403330,2024-03-05,House,"House: VOTE: Adoption (100-Y 0-N)",100,0,0,0,100
1810598,1372078,2024-01-30,House,"House: Subcommittee recommends laying on the table (5-Y 3-N)",5,3,0,1,9
1810610,1377036,2024-02-06,House,"House: Subcommittee recommends striking from docket (8-Y 0-N)",8,0,0,0,8
1810618,1370589,2024-01-29,House,"House: Subcommittee recommends reporting (6-Y 0-N)",6,0,0,0,6
1810618,1373743,2024-02-01,House,"House: Reported from Rules (18-Y 0-N)",18,0,0,0,18
1810618,1376129,2024-02-05,House,"House: Subcommittee recommends reporting with substitute (8-Y 0-N)",8,0,0,1,9
1810618,1378753,2024-02-07,House,"House: Reported from Appropriations with substitute (22-Y 0-N)",22,0,0,0,22
1810618,1381807,2024-02-12,House,"House: VOTE: Block vote adoption (97-Y 0-N)",97,0,0,3,100
1810618,1401405,2024-03-04,Senate,"Senate: Continued to 2025 in Finance and Appropriations (15-Y 0-N)",15,0,0,0,15
1810622,1371440,2024-01-30,House,"House: Subcommittee recommends reporting (7-Y 1-N)",7,1,0,0,8
1810622,1372548,2024-01-31,House,"House: Reported from Education with substitute (17-Y 5-N)",17,5,0,0,22
1810622,1376290,2024-02-05,House,"House: Subcommittee recommends reporting with substitute (7-Y 1-N)",7,1,0,1,9
1810622,1378714,2024-02-07,House,"House: Reported from Appropriations with substitute (14-Y 8-N)",14,8,0,0,22
1810622,1382842,2024-02-13,House,"House: VOTE: Passage (58-Y 41-N)",58,41,0,1,100
1810622,1399162,2024-02-29,Senate,"Senate: Reported from Education and Health with substitute (15-Y 0-N)",15,0,0,0,15
1810622,1401416,2024-03-04,Senate,"Senate: Reported from Finance and Appropriations (14-Y 1-N)",14,1,0,0,15
1810622,1402929,2024-03-05,Senate,"Senate: Constitutional reading dispensed (39-Y 0-N)",39,0,0,1,40
1810622,1404185,2024-03-06,Senate,"Senate: Passed Senate with substitute (39-Y 1-N)",39,1,0,0,40
1810622,1405665,2024-03-07,House,"House: VOTE: REJECTED (0-Y 99-N)",0,99,0,1,100
1810622,1405666,2024-03-07,Senate,"Senate: Senate receded from substitute (40-Y 0-N)",40,0,0,0,40
1810636,1374324,2024-02-01,House,"House: Reported from Rules (18-Y 0-N)",18,0,0,0,18
1810636,1378898,2024-02-07,House,"House: VOTE: Block Vote Passage (100-Y 0-N)",100,0,0,0,100
1810636,1400344,2024-03-01,Senate,"Senate: Reported from Rules with substitute (12-Y 0-N)",12,0,0,0,12
1810636,1402284,2024-03-04,Senate,"Senate: Constitutional reading dispensed (40-Y 0-N)",40,0,0,0,40
1810636,1403586,2024-03-05,Senate,"Senate: Passed Senate with substitute (40-Y 0-N)",40,0,0,0,40
1810700,1375297,2024-02-02,House,"House: Subcommittee recommends laying on the table (5-Y 3-N)",5,3,0,1,9
1810722,1374471,2024-02-01,House,"House: Subcommittee recommends reporting with substitute (8-Y 0-N)",8,0,0,0,8
1810722,1377297,2024-02-06,House,"House: Reported from Health and Human Services with substitute (22-Y 0-N)",22,0,0,0,22
1810722,1381989,2024-02-12,House,"House: VOTE: Block Vote Passage (100-Y 0-N)",100,0,0,0,100
1810722,1391484,2024-02-22,Senate,"Senate: Reported from Education and Health (15-Y 0-N)",15,0,0,0,15
1810722,1395750,2024-02-27,Senate,"Senate: Constitutional reading dispensed (39-Y 0-N)",39,0,0,1,40
1810722,1395751,2024-02-27,Senate,"Senate: Reported from Finance and Appropriations (15-Y 0-N)",15,0,0,0,15
1810722,1397953,2024-02-28,Senate,"Senate: Passed Senate (39-Y 0-N)",39,0,0,1,40
1810732,1371912,2024-01-30,House,"House: Subcommittee recommends reporting (8-Y 0-N)",8,0,0,0,8
1810732,1372550,2024-01-31,House,"House: Reported from Education (21-Y 0-N)",21,0,0,1,22
1810732,1377535,2024-02-06,House,"House: VOTE: Block Vote Passage (99-Y 0-N)",99,0,0,1,100
1810732,1385341,2024-02-15,Senate,"Senate: Reported from Education and Health (13-Y 0-N)",13,0,0,0,13
1810732,1386624,2024-02-16,Senate,"Senate: Constitutional reading dispensed (38-Y 0-N)",38,0,0,2,40
1810732,1387734,2024-02-19,Senate,"Senate: Passed Senate (39-Y 0-N)",39,0,0,1,40
1810877,1377845,2024-02-06,House,"House: Subcommittee recommends striking from docket (10-Y 0-N)",10,0,0,0,10
1810877,1380393,2024-02-08,House,"House: Stricken from docket by Labor and Commerce (22-Y 0-N)",22,0,0,0,22
1810932,1375172,2024-02-02,House,"House: Subcommittee recommends reporting with amendments (8-Y 0-N)",8,0,0,1,9
1810932,1378297,2024-02-07,House,"House: Reported from Courts of Justice with amendment(s) (22-Y 0-N)",22,0,0,0,22
1810932,1382843,2024-02-13,House,"House: VOTE: Passage (87-Y 11-N)",87,11,0,2,100
1810932,1394523,2024-02-26,Senate,"Senate: Reported from Courts of Justice (13-Y 0-N)",13,0,0,0,13
1810932,1395846,2024-02-27,Senate,"Senate: Constitutional reading dispensed (39-Y 0-N)",39,0,0,1,40
1810932,1398202,2024-02-28,Senate,"Senate: Passed Senate (39-Y 0-N)",39,0,0,1,40
1811044,1373903,2024-02-01,House,"House: Subcommittee recommends passing by indefinitely (6-Y 3-N)",6,3,0,1,10
1811101,1373961,2024-02-01,House,"House: Subcommittee recommends passing by indefinitely (6-Y 3-N)",6,3,0,1,10
1811156,1371223,2024-01-29,House,"House: Subcommittee recommends laying on the table (6-Y 0-N)",6,0,0,3,9
1811215,1378456,2024-02-07,House,"House: Subcommittee recommends reporting with substitute (5-Y 3-N)",5,3,0,0,8
1811215,1379614,2024-02-08,House,"House: Reported from Health and Human Services with substitute (12-Y 8-N)",12,8,1,1,22
1811215,1383001,2024-02-13,House,"House: VOTE: Passage (71-Y 28-N)",71,28,0,1,100
1811215,1399236,2024-02-29,Senate,"Senate: Continued to 2025 in Education and Health (14-Y 1-N)",14,1,0,0,15
1811280,1368155,2024-01-23,Senate,"Senate: Reported from Privileges and Elections (14-Y 0-N)",14,0,0,0,14
1811280,1369096,2024-01-25,Senate,"Senate: Constitutional reading dispensed (40-Y 0-N)",40,0,0,0,40
1811280,1370286,2024-01-29,Senate,"Senate: Read third time and passed Senate (40-Y 0-N)",40,0,0,0,40
1811302,1364454,2024-01-16,Senate,"Senate: Rereferred from Privileges and Elections (14-Y 0-N)",14,0,0,0,14
1811302,1379789,2024-02-08,Senate,"Senate: Stricken at request of patron in Education and Health (15-Y 0-N)",15,0,0,0,15
1811313,1373716,2024-02-01,Senate,"Senate: Reported from Education and Health with substitute (15-Y 0-N)",15,0,0,0,15
1811313,1376986,2024-02-06,Senate,"Senate: Read third time and passed Senate (39-Y 0-N)",39,0,0,1,40
1811313,1432133,2024-02-22,House,"House: Subcommittee recommends reporting with substitute (7-Y 0-N)",7,0,1,0,8
1811313,1432134,2024-02-27,House,"House: Reported from Health and Human Services with substitute (21-Y 0-N)",21,0,0,1,22
1811313,1432135,2024-03-01,House,"House: VOTE: Block Vote Passage (97-Y 0-N)",97,0,0,3,100
1811313,1432136,2024-03-05,Senate,"Senate: House substitute agreed to by Senate (40-Y 0-N)",40,0,0,0,40
1811343,1373809,2024-01-31,Senate,"Senate: Reported from Courts of Justice with substitute (15-Y 0-N)",15,0,0,0,15
1811343,1378547,2024-02-07,Senate,"Senate: Reported from Finance and Appropriations (15-Y 0-N)",15,0,0,0,15
1811343,1380022,2024-02-08,Senate,"Senate: Constitutional reading dispensed (40-Y 0-N)",40,0,0,0,40
1811343,1381177,2024-02-09,Senate,"Senate: Constitutional reading dispensed (40-Y 0-N)",40,0,0,0,40
1811343,1381178,2024-02-09,Senate,"Senate: Passed Senate (40-Y 0-N)",40,0,0,0,40
1811343,1391060,2024-02-21,House,"House: Subcommittee recommends reporting with substitute (8-Y 0-N)",8,0,0,1,9
1811343,1394085,2024-02-23,House,"House: Reported from Courts of Justice with substitute (21-Y 0-N)",21,0,0,1,22
1811343,1397644,2024-02-28,House,"House: Reported from Appropriations (22-Y 0-N)",22,0,0,0,22
1811343,1402384,2024-03-04,House,"House: VOTE: Block Vote Passage (97-Y 0-N)",97,0,0,3,100
1811343,1403678,2024-03-05,Senate,"Senate: House substitute agreed to by Senate (29-Y 11-N)",29,11,0,0,40
1811343,1403679,2024-03-05,Senate,"Senate: Reconsideration of Senate passage agreed to by Senate (40-Y 0-N)",40,0,0,0,40
1811343,1403680,2024-03-05,Senate,"Senate: House substitute agreed to by Senate (40-Y 0-N)",40,0,0,0,40
1811355,1373433,2024-01-31,House,"House: Subcommittee recommends striking from docket (8-Y 0-N)",8,0,0,1,9
1811368,1379047,2024-02-08,Senate,"Senate: Continued to 2025 in Education and Health (15-Y 0-N)",15,0,0,0,15
1811385,1373113,2024-01-31,Senate,"Senate: Reported from General Laws and Technology (15-Y 0-N)",15,0,0,0,15
1811385,1378507,2024-02-07,Senate,"Senate: Reported from Finance and Appropriations (14-Y 1-N)",14,1,0,0,15
1811385,1379976,2024-02-08,Senate,"Senate: Constitutional reading dispensed (40-Y 0-N)",40,0,0,0,40
1811385,1382245,2024-02-12,Senate,"Senate: Read third time and passed Senate (40-Y 0-N)",40,0,0,0,40
1811385,1393288,2024-02-23,House,"House: Reported from Public Safety (21-Y 0-N)",21,0,0,1,22
1811385,1398682,2024-02-28,House,"House: VOTE: Block Vote Passage (97-Y 0-N)",97,0,0,3,100
1811397,1368757,2024-01-24,Senate,"Senate: Reported from General Laws and Technology with substitute (15-Y 0-N)",15,0,0,0,15
1811397,1369891,2024-01-26,Senate,"Senate: Constitutional reading dispensed (37-Y 0-N)",37,0,0,3,40
1811397,1371994,2024-01-30,Senate,"Senate: Read third time and passed Senate (40-Y 0-N)",40,0,0,0,40
1811397,1388466,2024-02-20,House,"House: Subcommittee recommends reporting (7-Y 0-N)",7,0,0,1,8
1811397,1392063,2024-02-22,House,"House: Reported from General Laws (22-Y 0-N)",22,0,0,0,22
1811397,1396598,2024-02-27,House,"House: VOTE: Block Vote Passage (97-Y 0-N)",97,0,0,3,100
1811410,1374671,2024-02-02,Senate,"Senate: Reported from Rules (14-Y 0-N)",14,0,0,0,14
1811410,1376444,2024-02-05,Senate,"Senate: Constitutional reading dispensed (39-Y 0-N)",39,0,0,1,40
1811410,1377226,2024-02-06,Senate,"Senate: Constitutional reading dispensed (39-Y 0-N)",39,0,0,1,40
1811410,1377227,2024-02-06,Senate,"Senate: Passed Senate (39-Y 0-N)",39,0,0,1,40
1811410,1393232,2024-02-23,House,"House: Subcommittee recommends reporting (6-Y 0-N)",6,0,0,0,6
1811410,1393233,2024-02-23,House,"House: Reported from Rules (16-Y 0-N)",16,0,0,2,18
1811410,1397637,2024-02-28,House,"House: Reported from Appropriations (22-Y 0-N)",22,0,0,0,22
1811410,1405502,2024-03-07,House,"House: VOTE: Passage (92-Y 4-N)",92,4,0,4,100
1811426,1378739,2024-02-07,Senate,"Senate: Reported from Courts of Justice with substitute (15-Y 0-N)",15,0,0,0,15
1811426,1380219,2024-02-08,Senate,"Senate: Constitutional reading dispensed (40-Y 0-N)",40,0,0,0,40
1811426,1381090,2024-02-09,Senate,"Senate: Constitutional reading dispensed (40-Y 0-N)",40,0,0,0,40
1811426,1381091,2024-02-09,Senate,"Senate: Passed Senate (40-Y 0-N)",40,0,0,0,40
1811426,1387167,2024-02-16,House,"House: Subcommittee recommends reporting (8-Y 0-N)",8,0,0,1,9
1811426,1394090,2024-02-23,House,"House: Reported from Courts of Justice (21-Y 0-N)",21,0,0,1,22
1811426,1398700,2024-02-28,House,"House: VOTE: Block Vote Passage (97-Y 0-N)",97,0,0,3,100
1811437,1378516,2024-02-07,Senate,"Senate: Passed by indefinitely in Finance and Appropriations (11-Y 4-N)",11,4,0,0,15
1811456,1380842,2024-02-09,House,"House: Reported from Privileges and Elections with amendment(s) (16-Y 6-N)",16,6,0,0,22
1811456,1383859,2024-02-13,House,"House: VOTE: Passage (78-Y 21-N)",78,21,0,1,100
1811456,1389565,2024-02-20,Senate,"Senate: Reported from Privileges and Elections (10-Y 5-N)",10,5,0,0,15
1811456,1392912,2024-02-22,Senate,"Senate: Constitutional reading dispensed (40-Y 0-N)",40,0,0,0,40
1811456,1394105,2024-02-23,Senate,"Senate: Passed Senate (29-Y 9-N)",29,9,0,2,40
1811467,1371609,2024-01-30,Senate,"Senate: Reported from Agriculture, Conservation and Natural Resources with substitite (15-Y 0-N)",15,0,0,0,15
1811467,1377527,2024-02-06,Senate,"Senate: Reported from Finance and Appropriations (15-Y 0-N)",15,0,0,0,15
1811467,1378513,2024-02-07,Senate,"Senate: Constitutional reading dispensed (40-Y 0-N)",40,0,0,0,40
1811467,1379794,2024-02-08,Senate,"Senate: Constitutional reading dispensed (40-Y 0-N)",40,0,0,0,40
1811467,1379795,2024-02-08,Senate,"Senate: Read third time and passed Senate (40-Y 0-N)",40,0,0,0,40
1811467,1393149,2024-02-23,House,"House: Subcommittee recommends reporting (6-Y 0-N)",6,0,0,0,6
1811467,1393247,2024-02-23,House,"House: Reported from Rules (16-Y 0-N)",16,0,0,2,18
1811467,1398441,2024-02-28,House,"House: Reported from Appropriations with substitute (15-Y 7-N)",15,7,0,0,22
1811467,1401708,2024-03-04,House,"House: VOTE: Passage (53-Y 44-N)",53,44,0,3,100
1811467,1402799,2024-03-05,Senate,"Senate: House substitute agreed to by Senate (37-Y 2-N)",37,2,0,1,40
1811481,1376870,2024-02-06,Senate,"Senate: Reported from Finance and Appropriations (15-Y 0-N)",15,0,0,0,15
1811481,1378551,2024-02-07,Senate,"Senate: Constitutional reading dispensed (40-Y 0-N)",40,0,0,0,40
1811481,1380009,2024-02-08,Senate,"Senate: Constitutional reading dispensed (40-Y 0-N)",40,0,0,0,40
1811481,1380010,2024-02-08,Senate,"Senate: Read third time and passed Senate (40-Y 0-N)",40,0,0,0,40
1811481,1387642,2024-02-19,House,"House: Reported from Appropriations with substitute (22-Y 0-N)",22,0,0,0,22
1811481,1392828,2024-02-22,House,"House: VOTE: Block Vote Passage (99-Y 0-N)",99,0,0,1,100
1811481,1394445,2024-02-26,Senate,"Senate: House substitute rejected by Senate (0-Y 40-N)",0,40,0,0,40
1811481,1399114,2024-02-29,Senate,"Senate: Senate acceded to request (39-Y 0-N)",39,0,0,1,40
1811481,1404126,2024-03-06,House,"House: VOTE: Adoption (97-Y 0-N)",97,0,0,3,100
1811481,1406768,2024-03-09,Senate,"Senate: Conference report agreed to by Senate (40-Y 0-N)",40,0,0,0,40
1811496,1377120,2024-02-06,Senate,"Senate: Reported from Finance and Appropriations with substitute (15-Y 0-N)",15,0,0,0,15
1811496,1377981,2024-02-07,Senate,"Senate: Constitutional reading dispensed (40-Y 0-N)",40,0,0,0,40
1811496,1380195,2024-02-08,Senate,"Senate: Constitutional reading dispensed (40-Y 0-N)",40,0,0,0,40
1811496,1380196,2024-02-08,Senate,"Senate: Read third time and passed Senate (40-Y 0-N)",40,0,0,0,40
1811509,1371767,2024-01-30,Senate,"Senate: Reported from Agriculture, Conservation and Natural Resources with substitite (15-Y 0-N)",15,0,0,0,15
1811509,1374166,2024-02-01,Senate,"Senate: Constitutional reading dispensed (40-Y 0-N)",40,0,0,0,40
1811509,1376362,2024-02-05,Senate,"Senate: Read third time and passed Senate (40-Y 0-N)",40,0,0,0,40
1811509,1390858,2024-02-21,House,"House: Subcommittee recommends reporting (9-Y 1-N)",9,1,0,0,10
1811509,1397405,2024-02-28,House,"House: Reported from Agriculture, Chesapeake and Natural Resources (22-Y 0-N)",22,0,0,0,22
1811509,1401519,2024-03-04,House,"House: VOTE: Block Vote Passage (97-Y 0-N)",97,0,0,3,100
1811526,1377458,2024-02-06,House,"House: Subcommittee recommends laying on the table (8-Y 0-N)",8,0,0,1,9
1811539,1371067,2024-01-29,Senate,"Senate: Rereferred from Commerce and Labor (11-Y 0-N)",11,0,0,0,11
1811539,1375937,2024-02-05,Senate,"Senate: Failed to report (defeated) in Local Government (7-Y 8-N)",7,8,0,0,15
1811551,1366988,2024-01-19,Senate,"Senate: Reported from Rehabilitation and Social Services (15-Y 0-N)",15,0,0,0,15
1811551,1368942,2024-01-22,Senate,"Senate: Constitutional reading dispensed (40-Y 0-N)",40,0,0,0,40
1811551,1368943,2024-01-24,Senate,"Senate: Read third time and passed Senate (40-Y 0-N)",40,0,0,0,40
1811551,1389538,2024-02-20,House,"House: Subcommittee recommends reporting with substitute (7-Y 0-N)",7,0,0,1,8
1811551,1392848,2024-02-22,House,"House: Reported from General Laws with substitute (22-Y 0-N)",22,0,0,0,22
1811551,1397958,2024-02-28,House,"House: VOTE: Passage (95-Y 4-N)",95,4,0,1,100
1811551,1400628,2024-03-01,Senate,"Senate: House substitute agreed to by Senate (38-Y 2-N)",38,2,0,0,40
1811563,1379048,2024-02-08,Senate,"Senate: Continued to 2025 in Education and Health (14-Y 1-N)",14,1,0,0,15
1811580,1370231,2024-01-29,Senate,"Senate: Reported from Local Government with substitute (14-Y 0-N 1-A)",14,0,1,0,15
1811580,1371929,2024-01-30,Senate,"Senate: Constitutional reading dispensed (40-Y 0-N)",40,0,0,0,40
1811580,1374152,2024-02-01,Senate,"Senate: Read third time and passed Senate (40-Y 0-N)",40,0,0,0,40
1811580,1386599,2024-02-16,House,"House: Reported from Counties, Cities and Towns with amendment(s) (21-Y 1-N)",21,1,0,0,22
1811580,1390578,2024-02-21,House,"House: VOTE: Passage (99-Y 1-N)",99,1,0,0,100
1811580,1393466,2024-02-23,Senate,"Senate: House amendment agreed to by Senate (38-Y 0-N)",38,0,0,2,40
1811580,1393467,2024-02-23,Senate,"Senate: Reconsideration of House amendment agreed to by Senate (39-Y 0-N)",39,0,0,1,40
1811580,1393468,2024-02-23,Senate,"Senate: House amendment agreed to by Senate (39-Y 0-N)",39,0,0,1,40
1811591,1373176,2024-01-31,Senate,"Senate: Reported from General Laws and Technology (13-Y 2-N)",13,2,0,0,15
1811591,1377131,2024-02-06,Senate,"Senate: Passed by indefinitely in Finance and Appropriations (10-Y 5-N)",10,5,0,0,15
1811603,1369758,2024-01-26,Senate,"Senate: Rereferred from Rules (15-Y 0-N)",15,0,0,0,15
1811603,1378636,2024-02-07,Senate,"Senate: Reported from General Laws and Technology with substitute (14-Y 1-N)",14,1,0,0,15
1811603,1380141,2024-02-08,Senate,"Senate: Constitutional reading dispensed (40-Y 0-N)",40,0,0,0,40
1811603,1381417,2024-02-12,Senate,"Senate: Read third time and passed Senate (23-Y 17-N)",23,17,0,0,40
1811603,1389078,2024-02-20,House,"House: Reported from General Laws (12-Y 9-N)",12,9,0,1,22
1811603,1393812,2024-02-23,House,"House: VOTE: Passage (51-Y 47-N)",51,47,0,2,100
1811603,1429491,2024-04-17,Senate,"Senate: Senate concurred in Governor's recommendation (40-Y 0-N)",40,0,0,0,40
1811603,1430300,2024-04-17,House,"House: VOTE: Adoption (52-Y 48-N)",52,48,0,0,100
1811642,1379056,2024-02-08,Senate,"Senate: Continued to 2025 in Education and Health (15-Y 0-N)",15,0,0,0,15
1811644,1373534,2024-02-01,Senate,"Senate: Continued to 2025 in Education and Health (15-Y 0-N)",15,0,0,0,15
1811646,1372938,2024-01-31,Senate,"Senate: Continued to 2025 in Finance and Appropriations (15-Y 0-N)",15,0,0,0,15
1811647,1373727,2024-02-01,Senate,"Senate: Reported from Education and Health with substitute (9-Y 6-N)",9,6,0,0,15
1811647,1381328,2024-02-12,Senate,"Senate: Continued to 2025 in Finance and Appropriations (15-Y 0-N)",15,0,0,0,15
1811649,1382525,2024-02-12,Senate,"Senate: Continued to 2025 in Courts of Justice (14-Y 0-N)",14,0,0,0,14
1811651,1382948,2024-02-12,Senate,"Senate: Reported from Courts of Justice with amendments (8-Y 3-N)",8,3,0,0,11
1811651,1383900,2024-02-13,Senate,"Senate: Constitutional reading dispensed (40-Y 0-N)",40,0,0,0,40
1811651,1383901,2024-02-13,Senate,"Senate: Passed Senate (21-Y 17-N)",21,17,0,2,40
1811651,1383902,2024-02-13,Senate,"Senate: Constitutional reading dispensed (40-Y 0-N)",40,0,0,0,40
1811651,1391180,2024-02-21,House,"House: Subcommittee recommends reporting with amendments (7-Y 1-N)",7,1,0,1,9
1811651,1394054,2024-02-23,House,"House: Reported from Courts of Justice with amendment(s) (15-Y 6-N)",15,6,0,1,22
1811651,1397816,2024-02-28,House,"House: VOTE: Passage (57-Y 42-N)",57,42,0,1,100
1811651,1400891,2024-03-01,Senate,"Senate: House amendment agreed to by Senate (21-Y 19-N)",21,19,0,0,40
1811655,1373118,2024-01-31,Senate,"Senate: Reported from General Laws and Technology (15-Y 0-N)",15,0,0,0,15
1811655,1378109,2024-02-07,Senate,"Senate: Reported from Finance and Appropriations with substitute (15-Y 0-N)",15,0,0,0,15
1811655,1379268,2024-02-08,Senate,"Senate: Constitutional reading dispensed (40-Y 0-N)",40,0,0,0,40
1811655,1381186,2024-02-09,Senate,"Senate: Constitutional reading dispensed (40-Y 0-N)",40,0,0,0,40
1811655,1381187,2024-02-09,Senate,"Senate: Passed Senate (40-Y 0-N)",40,0,0,0,40
1811655,1388388,2024-02-20,House,"House: Subcommittee recommends reporting with substitute (8-Y 0-N)",8,0,0,0,8
1811655,1391274,2024-02-22,House,"House: Reported from Health and Human Services with substitute (21-Y 0-N)",21,0,0,1,22
1811657,1369711,2024-01-25,Senate,"Senate: Reported from Transportation (10-Y 5-N)",10,5,0,0,15
1811657,1371166,2024-01-29,Senate,"Senate: Constitutional reading dispensed (39-Y 0-N)",39,0,0,1,40
1811657,1372443,2024-01-31,Senate,"Senate: Read third time and passed Senate (23-Y 17-N)",23,17,0,0,40
1811657,1391533,2024-02-22,House,"House: Reported from Transportation (14-Y 8-N)",14,8,0,0,22
1811657,1395847,2024-02-27,House,"House: VOTE: Passage (59-Y 37-N)",59,37,0,4,100
1811658,1368750,2024-01-24,Senate,"Senate: Reported from General Laws and Technology (15-Y 0-N)",15,0,0,0,15
1811658,1369912,2024-01-26,Senate,"Senate: Constitutional reading dispensed (37-Y 0-N)",37,0,0,3,40
1811658,1372015,2024-01-30,Senate,"Senate: Read third time and passed Senate (40-Y 0-N)",40,0,0,0,40
1811658,1385511,2024-02-15,House,"House: Reported from General Laws with substitute (22-Y 0-N)",22,0,0,0,22
1811658,1388819,2024-02-20,House,"House: VOTE: Passage (93-Y 4-N)",93,4,0,3,100
1811658,1392118,2024-02-22,Senate,"Senate: House substitute agreed to by Senate (40-Y 0-N)",40,0,0,0,40
1811660,1379805,2024-02-08,Senate,"Senate: Continued to 2025 in Education and Health (15-Y 0-N)",15,0,0,0,15
1811662,1368063,2024-01-23,Senate,"Senate: Continued to 2025 in Agriculture, Conservation and Natural Resources (13-Y 2-N)",13,2,0,0,15
1811664,1368903,2024-01-24,Senate,"Senate: Reported from General Laws and Technology (15-Y 0-N)",15,0,0,0,15
1811664,1372453,2024-01-31,Senate,"Senate: Stricken at request of Patron in Finance and Appropriations (15-Y 0-N)",15,0,0,0,15
1811665,1370478,2024-01-29,Senate,"Senate: Reported from Courts of Justice with amendments (9-Y 6-N)",9,6,0,0,15
1811665,1377887,2024-02-07,Senate,"Senate: Reported from Finance and Appropriations (10-Y 5-N)",10,5,0,0,15
1811665,1379909,2024-02-08,Senate,"Senate: Constitutional reading dispensed (40-Y 0-N)",40,0,0,0,40
1811665,1382039,2024-02-12,Senate,"Senate: Read third time and passed Senate (21-Y 19-N)",21,19,0,0,40
1811665,1386701,2024-02-16,House,"House: Reported from Public Safety (12-Y 10-N)",12,10,0,0,22
1811665,1390718,2024-02-21,House,"House: VOTE: Passage (51-Y 49-N)",51,49,0,0,100
1811673,1377727,2024-02-06,Senate,"Senate: Reported from Finance and Appropriations (15-Y 0-N)",15,0,0,0,15
1811673,1377979,2024-02-07,Senate,"Senate: Constitutional reading dispensed (40-Y 0-N)",40,0,0,0,40
1811673,1380050,2024-02-08,Senate,"Senate: Constitutional reading dispensed (40-Y 0-N)",40,0,0,0,40
1811673,1380051,2024-02-08,Senate,"Senate: Read third time and passed Senate (40-Y 0-N)",40,0,0,0,40
1811673,1387993,2024-02-19,House,"House: Reported from Finance (22-Y 0-N)",22,0,0,0,22
1811673,1391782,2024-02-22,House,"House: VOTE: Block Vote Passage (99-Y 0-N)",99,0,0,1,100
1811674,1378459,2024-02-07,Senate,"Senate: Reported from Courts of Justice with substitute (9-Y 5-N)",9,5,0,0,14
1811674,1380014,2024-02-08,Senate,"Senate: Constitutional reading dispensed (40-Y 0-N)",40,0,0,0,40
1811674,1383024,2024-02-13,Senate,"Senate: Read third time and defeated by Senate (20-Y 20-N)",20,20,0,0,40
1811676,1378512,2024-02-07,Senate,"Senate: Passed by indefinitely in Finance and Appropriations with letter (15-Y 0-N)",15,0,0,0,15
1811678,1370445,2024-01-29,Senate,"Senate: Reading waived (40-Y 0-N)",40,0,0,0,40
1811678,1372611,2024-01-31,Senate,"Senate: Agreed to by Senate (21-Y 19-N)",21,19,0,0,40
1811678,1372612,2024-01-31,Senate,"Senate: Reconsideration of passage agreed to by Senate (40-Y 0-N)",40,0,0,0,40
1811678,1372613,2024-01-31,Senate,"Senate: Agreed to by Senate (22-Y 18-N)",22,18,0,0,40
1811680,1369007,2024-01-25,Senate,"Senate: Passed by indefinitely in Education and Health (9-Y 6-N)",9,6,0,0,15
1811682,1368905,2024-01-24,Senate,"Senate: Incorporated by Courts of Justice ",15,0,0,0,15
1811685,1380212,2024-02-08,Senate,"Senate: Reported from Transportation with substitute (9-Y 5-N)",9,5,0,0,14
1811688,1377138,2024-02-06,Senate,"Senate: Incorporated by Finance and Appropriations ",15,0,0,0,15
1811690,1376882,2024-02-06,Senate,"Senate: Reported from Finance and Appropriations with substitute (15-Y 0-N)",15,0,0,0,15
1811690,1378068,2024-02-07,Senate,"Senate: Constitutional reading dispensed (40-Y 0-N)",40,0,0,0,40
1811690,1379283,2024-02-08,Senate,"Senate: Constitutional reading dispensed (40-Y 0-N)",40,0,0,0,40
1811690,1379284,2024-02-08,Senate,"Senate: Read third time and passed Senate (40-Y 0-N)",40,0,0,0,40
1811690,1387679,2024-02-19,House,"House: Reported from Appropriations with substitute (22-Y 0-N)",22,0,0,0,22
1811690,1391712,2024-02-22,House,"House: VOTE: Block Vote Passage (99-Y 0-N)",99,0,0,1,100
1811690,1394412,2024-02-26,Senate,"Senate: House substitute rejected by Senate (0-Y 40-N)",0,40,0,0,40
1811690,1399948,2024-02-29,Senate,"Senate: Senate acceded to request (39-Y 0-N)",39,0,0,1,40
1811690,1404407,2024-03-06,House,"House: VOTE: Adoption (98-Y 0-N)",98,0,0,2,100
1811690,1406645,2024-03-09,Senate,"Senate: Conference report agreed to by Senate (39-Y 0-N)",39,0,0,1,40
1811692,1377540,2024-02-06,Senate,"Senate: Continued to 2025 in Finance and Appropriations (15-Y 0-N)",15,0,0,0,15
1811694,1368897,2024-01-24,Senate,"Senate: Reported from General Laws and Technology with substitute (15-Y 0-N)",15,0,0,0,15
1811694,1369913,2024-01-26,Senate,"Senate: Constitutional reading dispensed (37-Y 0-N)",37,0,0,3,40
1811694,1371551,2024-01-30,Senate,"Senate: Read third time and passed Senate (40-Y 0-N)",40,0,0,0,40
1811694,1386275,2024-02-15,House,"House: Reported from General Laws (22-Y 0-N)",22,0,0,0,22
1811694,1389149,2024-02-20,House,"House: VOTE: Block Vote Passage (98-Y 0-N)",98,0,0,2,100
1811697,1368885,2024-01-24,Senate,"Senate: Stricken at request of Patron in General Laws and Technology (15-Y 0-N)",15,0,0,0,15
1811703,1378846,2024-02-07,Senate,"Senate: Reported from Courts of Justice with substitute (9-Y 0-N 6-A)",9,0,6,0,15
1811703,1380298,2024-02-08,Senate,"Senate: Constitutional reading dispensed (40-Y 0-N)",40,0,0,0,40
1811703,1382236,2024-02-12,Senate,"Senate: Read third time and passed Senate (29-Y 10-N)",29,10,0,1,40
1811703,1382237,2024-02-12,Senate,"Senate: Reconsideration of passage agreed to by Senate (40-Y 0-N)",40,0,0,0,40
1811703,1382238,2024-02-12,Senate,"Senate: Passed Senate (31-Y 9-N)",31,9,0,0,40
1811703,1387176,2024-02-16,House,"House: Subcommittee recommends reporting with amendments (6-Y 2-N)",6,2,0,1,9
1811703,1394082,2024-02-23,House,"House: Reported from Courts of Justice with amendment(s) (21-Y 0-N)",21,0,0,1,22
1811703,1398795,2024-02-28,House,"House: VOTE: Block Vote Passage (97-Y 0-N)",97,0,0,3,100
1811703,1400803,2024-03-01,Senate,"Senate: House amendment agreed to by Senate (40-Y 0-N)",40,0,0,0,40
1811705,1380953,2024-02-09,Senate,"Senate: Reported from Rules (14-Y 0-N 1-A)",14,0,1,0,15
1811705,1380954,2024-02-09,Senate,"Senate: Constitutional reading dispensed (39-Y 0-N)",39,0,0,1,40
1811705,1383872,2024-02-13,Senate,"Senate: Read third time and passed Senate (40-Y 0-N)",40,0,0,0,40
1811705,1393249,2024-02-23,House,"House: Subcommittee recommends reporting (6-Y 0-N)",6,0,0,0,6
1811705,1393250,2024-02-23,House,"House: Reported from Rules (16-Y 0-N)",16,0,0,2,18
1811705,1398630,2024-02-28,House,"House: Reported from Appropriations (22-Y 0-N)",22,0,0,0,22
1811705,1402490,2024-03-04,House,"House: VOTE: Block Vote Passage (97-Y 0-N)",97,0,0,3,100
1811706,1380807,2024-02-09,Senate,"Senate: Reported from Commerce and Labor with substitute (8-Y 7-N)",8,7,0,0,15
1811706,1380808,2024-02-09,Senate,"Senate: Constitutional reading dispensed (39-Y 0-N)",39,0,0,1,40
1811706,1383133,2024-02-13,Senate,"Senate: Read third time and passed Senate (20-Y 16-N)",20,16,0,4,40
1811706,1396275,2024-02-27,House,"House: Reported from Labor and Commerce with substitute (14-Y 7-N)",14,7,0,1,22
1811706,1404211,2024-03-06,House,"House: VOTE: Passage (52-Y 44-N 1-A)",52,44,1,3,100
1811706,1405672,2024-03-07,Senate,"Senate: House amendments agreed to by Senate (26-Y 14-N)",26,14,0,0,40
1811706,1429874,2024-04-17,Senate,"Senate: Senate concurred in Governor's recommendation (27-Y 13-N)",27,13,0,0,40
1811706,1429875,2024-04-17,House,"House: VOTE: Adoption (68-Y 27-N 1-A)",68,27,1,4,100
1811709,1374059,2024-02-01,Senate,"Senate: Reported from Education and Health with substitute (15-Y 0-N)",15,0,0,0,15
1811709,1376125,2024-02-05,Senate,"Senate: Reported from Courts of Justice (15-Y 0-N)",15,0,0,0,15
1811709,1378045,2024-02-07,Senate,"Senate: Reported from Finance and Appropriations (15-Y 0-N)",15,0,0,0,15
1811709,1379252,2024-02-08,Senate,"Senate: Constitutional reading dispensed (40-Y 0-N)",40,0,0,0,40
1811709,1381172,2024-02-09,Senate,"Senate: Constitutional reading dispensed (40-Y 0-N)",40,0,0,0,40
1811709,1381173,2024-02-09,Senate,"Senate: Passed Senate (40-Y 0-N)",40,0,0,0,40
1811709,1386682,2024-02-16,House,"House: Reported from Courts of Justice (22-Y 0-N)",22,0,0,0,22
1811709,1390242,2024-02-21,House,"House: Reported from Appropriations (22-Y 0-N)",22,0,0,0,22
1811709,1394972,2024-02-26,House,"House: VOTE: Block Vote Passage (96-Y 0-N)",96,0,0,4,100
1811711,1366612,2024-01-18,Senate,"Senate: Reported from Transportation with amendment (15-Y 0-N)",15,0,0,0,15
1811711,1368919,2024-01-22,Senate,"Senate: Constitutional reading dispensed (40-Y 0-N)",40,0,0,0,40
1811711,1368920,2024-01-24,Senate,"Senate: Read third time and passed Senate (40-Y 0-N)",40,0,0,0,40
1811711,1391478,2024-02-22,House,"House: Reported from Transportation with amendment(s) (22-Y 0-N)",22,0,0,0,22
1811711,1395098,2024-02-26,House,"House: Reported from Appropriations (22-Y 0-N)",22,0,0,0,22
1811711,1398453,2024-02-28,House,"House: VOTE: Block Vote Passage (97-Y 0-N)",97,0,0,3,100
1811711,1401250,2024-03-01,Senate,"Senate: House amendment agreed to by Senate (40-Y 0-N)",40,0,0,0,40
1811713,1379844,2024-02-08,Senate,"Senate: Reported from Education and Health with substitute (15-Y 0-N)",15,0,0,0,15
1811713,1379845,2024-02-08,Senate,"Senate: Constitutional reading dispensed (40-Y 0-N)",40,0,0,0,40
1811713,1380625,2024-02-09,Senate,"Senate: Constitutional reading dispensed (40-Y 0-N)",40,0,0,0,40
1811713,1380626,2024-02-09,Senate,"Senate: Read third time and passed Senate (40-Y 0-N)",40,0,0,0,40
1811714,1378746,2024-02-07,Senate,"Senate: Reported from General Laws and Technology with amendments (13-Y 1-N 1-A)",13,1,1,0,15
1811714,1380211,2024-02-08,Senate,"Senate: Constitutional reading dispensed (40-Y 0-N)",40,0,0,0,40
1811714,1382179,2024-02-12,Senate,"Senate: Read third time and passed Senate (22-Y 17-N)",22,17,0,1,40
1811714,1392043,2024-02-22,House,"House: Subcommittee recommends reporting (6-Y 2-N)",6,2,0,0,8
1811714,1396720,2024-02-27,House,"House: Reported from General Laws (13-Y 9-N)",13,9,0,0,22
1811714,1400776,2024-03-01,House,"House: VOTE: Passage (52-Y 44-N)",52,44,0,4,100
1811714,1430324,2024-04-17,Senate,"Senate: Senate concurred in Governor's recommendation (20-Y 20-N)",20,20,0,0,40
1811714,1430325,2024-04-17,Senate,"Senate: Reconsideration of Governor's recommendation agreed to (40-Y 0-N)",40,0,0,0,40
1811714,1430326,2024-04-17,Senate,"Senate: Senate rejected Governor's recommendation (19-Y 21-N)",19,21,0,0,40
1811716,1377996,2024-02-07,Senate,"Senate: Reported from Finance and Appropriations with substitute (13-Y 2-N)",13,2,0,0,15
1811716,1380140,2024-02-08,Senate,"Senate: Constitutional reading dispensed (40-Y 0-N)",40,0,0,0,40
1811716,1382228,2024-02-12,Senate,"Senate: Read third time and passed Senate (40-Y 0-N)",40,0,0,0,40
1811716,1387809,2024-02-19,House,"House: Reported from Finance (16-Y 6-N)",16,6,0,0,22
1811716,1394786,2024-02-26,House,"House: Reported from Appropriations with amendment(s) (19-Y 3-N)",19,3,0,0,22
1811716,1397690,2024-02-28,Senate,"Senate: House amendment rejected by Senate (0-Y 39-N)",0,39,0,1,40
1811716,1397691,2024-02-28,Senate,"Senate: Senate acceded to request (39-Y 0-N)",39,0,0,1,40
1811716,1398783,2024-02-28,House,"House: VOTE: Passage (73-Y 25-N)",73,25,0,2,100
1811716,1404525,2024-03-06,House,"House: VOTE: Adoption (80-Y 18-N)",80,18,0,2,100
1811716,1405546,2024-03-07,Senate,"Senate: Conference report agreed to by Senate (39-Y 1-N)",39,1,0,0,40
1811718,1378689,2024-02-07,Senate,"Senate: Reported from General Laws and Technology with substitute (15-Y 0-N)",15,0,0,0,15
1811718,1381395,2024-02-12,Senate,"Senate: Reported from Finance and Appropriations (11-Y 4-N)",11,4,0,0,15
1811718,1382114,2024-02-12,Senate,"Senate: Constitutional reading dispensed (40-Y 0-N)",40,0,0,0,40
1811718,1383193,2024-02-13,Senate,"Senate: Constitutional reading dispensed (40-Y 0-N)",40,0,0,0,40
1811718,1383194,2024-02-13,Senate,"Senate: Passed Senate (21-Y 18-N)",21,18,0,1,40
1811718,1392631,2024-02-22,House,"House: Subcommittee recommends reporting (6-Y 2-N)",6,2,0,0,8
1811718,1396504,2024-02-27,House,"House: Reported from General Laws (13-Y 9-N)",13,9,0,0,22
1811718,1400756,2024-03-01,House,"House: VOTE: Passage (50-Y 47-N)",50,47,0,3,100
1811719,1378288,2024-02-07,Senate,"Senate: Passed by indefinitely in Finance and Appropriations (15-Y 0-N)",15,0,0,0,15
1811722,1379358,2024-02-08,Senate,"Senate: Reported from Education and Health with amendment (15-Y 0-N)",15,0,0,0,15
1811722,1379359,2024-02-08,Senate,"Senate: Constitutional reading dispensed (40-Y 0-N)",40,0,0,0,40
1811722,1381200,2024-02-09,Senate,"Senate: Constitutional reading dispensed (40-Y 0-N)",40,0,0,0,40
1811722,1381201,2024-02-09,Senate,"Senate: Passed Senate (40-Y 0-N)",40,0,0,0,40
1811722,1386713,2024-02-16,House,"House: Reported from Courts of Justice with substitute (22-Y 0-N)",22,0,0,0,22
1811722,1390815,2024-02-21,House,"House: VOTE: Block Vote Passage (100-Y 0-N)",100,0,0,0,100
1811722,1393680,2024-02-23,Senate,"Senate: House substitute agreed to by Senate (39-Y 0-N)",39,0,0,1,40
1811724,1377886,2024-02-07,Senate,"Senate: Reported from Finance and Appropriations with substitute (15-Y 0-N)",15,0,0,0,15
1811724,1379919,2024-02-08,Senate,"Senate: Constitutional reading dispensed (40-Y 0-N)",40,0,0,0,40
1811724,1380881,2024-02-09,Senate,"Senate: Constitutional reading dispensed (40-Y 0-N)",40,0,0,0,40
1811724,1380882,2024-02-09,Senate,"Senate: Passed Senate (40-Y 0-N)",40,0,0,0,40
1811724,1387804,2024-02-19,House,"House: Subcommittee recommends reporting with substitute (10-Y 0-N)",10,0,0,0,10
1811724,1390031,2024-02-21,House,"House: Reported from Agriculture, Chesapeake and Natural Resources with substitute (22-Y 0-N)",22,0,0,0,22
1811724,1398390,2024-02-28,House,"House: VOTE: Passage (90-Y 10-N)",90,10,0,0,100
1811724,1401035,2024-03-01,Senate,"Senate: House substitute agreed to by Senate (40-Y 0-N)",40,0,0,0,40
1811726,1371047,2024-01-29,Senate,"Senate: Reported from Commerce and Labor with substitute (15-Y 0-N)",15,0,0,0,15
1811726,1378306,2024-02-07,Senate,"Senate: Reported from Finance and Appropriations (15-Y 0-N)",15,0,0,0,15
1811726,1379330,2024-02-08,Senate,"Senate: Constitutional reading dispensed (40-Y 0-N)",40,0,0,0,40
1811726,1381047,2024-02-09,Senate,"Senate: Constitutional reading dispensed (40-Y 0-N)",40,0,0,0,40
1811726,1381048,2024-02-09,Senate,"Senate: Passed Senate (40-Y 0-N)",40,0,0,0,40
1811726,1389175,2024-02-20,House,"House: Reported from Labor and Commerce with substitute (17-Y 5-N)",17,5,0,0,22
1811726,1393746,2024-02-23,House,"House: VOTE: Passage (77-Y 21-N)",77,21,0,2,100
1811726,1395881,2024-02-27,Senate,"Senate: House substitute agreed to by Senate (37-Y 1-N)",37,1,0,2,40
1811726,1430245,2024-04-17,Senate,"Senate: Senate concurred in Governor's recommendation (40-Y 0-N)",40,0,0,0,40
1811726,1430246,2024-04-17,House,"House: VOTE: Adoption (89-Y 11-N)",89,11,0,0,100
1811727,1371206,2024-01-29,Senate,"Senate: Reported from Commerce and Labor (12-Y 3-N)",12,3,0,0,15
1811727,1378003,2024-02-07,Senate,"Senate: Reported from Finance and Appropriations (10-Y 5-N)",10,5,0,0,15
1811727,1379231,2024-02-08,Senate,"Senate: Constitutional reading dispensed (40-Y 0-N)",40,0,0,0,40
1811727,1382006,2024-02-12,Senate,"Senate: Read third time and passed Senate (27-Y 13-N)",27,13,0,0,40
1811727,1392864,2024-02-22,House,"House: Subcommittee recommends reporting (5-Y 3-N)",5,3,0,0,8
1811727,1397047,2024-02-27,House,"House: Reported from Labor and Commerce (14-Y 7-N)",14,7,0,1,22
1811727,1401140,2024-03-01,House,"House: VOTE: Passage (52-Y 44-N)",52,44,0,4,100
1811729,1379631,2024-02-08,Senate,"Senate: Reported from Education and Health (15-Y 0-N)",15,0,0,0,15
1811729,1379632,2024-02-08,Senate,"Senate: Constitutional reading dispensed (40-Y 0-N)",40,0,0,0,40
1811729,1381082,2024-02-09,Senate,"Senate: Constitutional reading dispensed (40-Y 0-N)",40,0,0,0,40
1811729,1381083,2024-02-09,Senate,"Senate: Passed Senate (40-Y 0-N)",40,0,0,0,40
1811729,1395633,2024-02-27,House,"House: Subcommittee recommends reporting with amendments (8-Y 0-N)",8,0,0,0,8
1811729,1397285,2024-02-28,House,"House: Reported from Education with amendment(s) (22-Y 0-N)",22,0,0,0,22
1811729,1401978,2024-03-04,House,"House: VOTE: Block Vote Passage (97-Y 0-N)",97,0,0,3,100
1811729,1403069,2024-03-05,Senate,"Senate: House amendment agreed to by Senate (40-Y 0-N)",40,0,0,0,40
1811733,1380532,2024-02-09,Senate,"Senate: Reported from Rules with amendments (15-Y 0-N)",15,0,0,0,15
1811733,1380874,2024-02-09,Senate,"Senate: Constitutional reading dispensed (39-Y 0-N)",39,0,0,1,40
1811733,1382383,2024-02-12,Senate,"Senate: Constitutional reading dispensed (40-Y 0-N)",40,0,0,0,40
1811733,1382384,2024-02-12,Senate,"Senate: Passed Senate (40-Y 0-N)",40,0,0,0,40
1811733,1393263,2024-02-23,House,"House: Subcommittee recommends reporting (6-Y 0-N)",6,0,0,0,6
1811733,1393264,2024-02-23,House,"House: Reported from Rules (16-Y 0-N)",16,0,0,2,18
1811734,1369706,2024-01-26,Senate,"Senate: Stricken at request of Patron in Rehabilitation and Social Services (10-Y 0-N)",10,0,0,0,10
1811738,1373691,2024-02-01,Senate,"Senate: Reported from Education and Health (15-Y 0-N)",15,0,0,0,15
1811738,1377405,2024-02-06,Senate,"Senate: Read third time and passed Senate (39-Y 0-N)",39,0,0,1,40
1811738,1432057,2024-02-14,House,"House: Reported from Education (20-Y 1-N)",20,1,0,1,22
1811738,1432058,2024-02-19,House,"House: VOTE: Passage (99-Y 1-N)",99,1,0,0,100
1811740,1369757,2024-01-26,Senate,"Senate: Passed by indefinitely in Rehabilitation and Social Services (8-Y 7-N)",8,7,0,0,15
1811742,1379400,2024-02-08,Senate,"Senate: Reported from Education and Health with substitute (15-Y 0-N)",15,0,0,0,15
1811742,1381289,2024-02-12,Senate,"Senate: Reported from Finance and Appropriations with substitute (15-Y 0-N)",15,0,0,0,15
1811742,1381619,2024-02-12,Senate,"Senate: Constitutional reading dispensed (40-Y 0-N)",40,0,0,0,40
1811742,1383821,2024-02-13,Senate,"Senate: Constitutional reading dispensed (39-Y 0-N)",39,0,0,1,40
1811742,1383822,2024-02-13,Senate,"Senate: Passed Senate (40-Y 0-N)",40,0,0,0,40
1811742,1389257,2024-02-20,House,"House: Subcommittee recommends reporting (7-Y 0-N)",7,0,0,1,8
1811742,1391967,2024-02-22,House,"House: Reported from Labor and Commerce (22-Y 0-N)",22,0,0,0,22
1811742,1398434,2024-02-28,House,"House: Tabled in Appropriations (22-Y 0-N)",22,0,0,0,22
1811744,1378686,2024-02-07,Senate,"Senate: Reported from General Laws and Technology with substitute (15-Y 0-N)",15,0,0,0,15
1811744,1381294,2024-02-12,Senate,"Senate: Reported from Finance and Appropriations with amendment (15-Y 0-N)",15,0,0,0,15
1811744,1381791,2024-02-12,Senate,"Senate: Constitutional reading dispensed (40-Y 0-N)",40,0,0,0,40
1811744,1383173,2024-02-13,Senate,"Senate: Constitutional reading dispensed (39-Y 0-N)",39,0,0,1,40
1811744,1383174,2024-02-13,Senate,"Senate: Passed Senate (40-Y 0-N)",40,0,0,0,40
1811744,1392795,2024-02-22,House,"House: Subcommittee recommends reporting with substitute (6-Y 0-N)",6,0,0,2,8
1811744,1396492,2024-02-27,House,"House: Reported from General Laws with substitute (22-Y 0-N)",22,0,0,0,22
1811744,1400434,2024-03-01,House,"House: VOTE: Passage (84-Y 11-N)",84,11,0,5,100
1811744,1403324,2024-03-05,Senate,"Senate: House substitute rejected by Senate (0-Y 40-N)",0,40,0,0,40
1811744,1405364,2024-03-07,Senate,"Senate: Senate acceded to request (40-Y 0-N)",40,0,0,0,40
1811744,1406149,2024-03-08,Senate,"Senate: Conference report agreed to by Senate (39-Y 1-N)",39,1,0,0,40
1811744,1406503,2024-03-08,House,"House: VOTE: Adoption (86-Y 10-N)",86,10,0,4,100
1811746,1375609,2024-02-05,Senate,"Senate: Continued to 2025 in Courts of Justice (15-Y 0-N)",15,0,0,0,15
1811748,1382471,2024-02-12,Senate,"Senate: Reported from Courts of Justice with substitute (15-Y 0-N)",15,0,0,0,15
1811748,1383888,2024-02-13,Senate,"Senate: Constitutional reading dispensed (40-Y 0-N)",40,0,0,0,40
1811748,1383889,2024-02-13,Senate,"Senate: Passed Senate (40-Y 0-N)",40,0,0,0,40
1811748,1383890,2024-02-13,Senate,"Senate: Constitutional reading dispensed (40-Y 0-N)",40,0,0,0,40
1811748,1394056,2024-02-23,House,"House: Reported from Courts of Justice (21-Y 0-N)",21,0,0,1,22
1811748,1398780,2024-02-28,House,"House: VOTE: Block Vote Passage (97-Y 0-N)",97,0,0,3,100
1811751,1373175,2024-01-31,Senate,"Senate: Reported from General Laws and Technology (15-Y 0-N)",15,0,0,0,15
1811751,1377607,2024-02-06,Senate,"Senate: Read third time and passed Senate (39-Y 0-N)",39,0,0,1,40
1811751,1432152,2024-02-15,House,"House: Reported from General Laws (22-Y 0-N)",22,0,0,0,22
1811751,1432153,2024-02-20,House,"House: VOTE: Block Vote Passage (98-Y 0-N)",98,0,0,2,100
1811756,1367419,2024-01-22,Senate,"Senate: Passed by indefinitely in Courts of Justice (9-Y 6-N)",9,6,0,0,15
1811758,1373838,2024-01-31,Senate,"Senate: Reported from Courts of Justice with substitute (9-Y 6-N)",9,6,0,0,15
1811758,1378479,2024-02-07,Senate,"Senate: Reported from Finance and Appropriations with amendment (10-Y 5-N)",10,5,0,0,15
1811758,1379963,2024-02-08,Senate,"Senate: Constitutional reading dispensed (40-Y 0-N)",40,0,0,0,40
1811758,1381531,2024-02-12,Senate,"Senate: Read third time and passed Senate (22-Y 18-N)",22,18,0,0,40
1811758,1393874,2024-02-23,House,"House: Reported from Courts of Justice (11-Y 10-N)",11,10,0,1,22
1811758,1397628,2024-02-28,House,"House: Reported from Appropriations with substitute (13-Y 9-N)",13,9,0,0,22
1811758,1401989,2024-03-04,House,"House: VOTE: Passage (51-Y 47-N)",51,47,0,2,100
1811759,1375755,2024-02-05,Senate,"Senate: Reported from Courts of Justice (8-Y 4-N 3-A)",8,4,3,0,15
1811759,1380295,2024-02-08,Senate,"Senate: Failed to report (defeated) in Finance and Appropriations (6-Y 9-N)",6,9,0,0,15
1811761,1367352,2024-01-22,Senate,"Senate: Reported from Local Government with substitute (10-Y 4-N 1-A)",10,4,1,0,15
1811761,1368412,2024-01-23,Senate,"Senate: Constitutional reading dispensed (39-Y 0-N)",39,0,0,1,40
1811761,1369322,2024-01-25,Senate,"Senate: Read third time and passed Senate (28-Y 12-N)",28,12,0,0,40
1811761,1386588,2024-02-16,House,"House: Reported from Counties, Cities and Towns with amendment(s) (14-Y 8-N)",14,8,0,0,22
1811761,1390321,2024-02-21,House,"House: VOTE: Passage (52-Y 47-N)",52,47,0,1,100
1811761,1394032,2024-02-23,Senate,"Senate: House amendment agreed to by Senate (25-Y 13-N)",25,13,0,2,40
1811764,1374060,2024-02-01,Senate,"Senate: Reported from Education and Health with substitute (15-Y 0-N)",15,0,0,0,15
1811764,1377594,2024-02-06,Senate,"Senate: Read third time and passed Senate (39-Y 0-N)",39,0,0,1,40
1811764,1432141,2024-02-20,House,"House: Subcommittee recommends reporting with substitute (8-Y 0-N)",8,0,0,0,8
1811764,1432142,2024-02-21,House,"House: Reported from Education with substitute (22-Y 0-N)",22,0,0,0,22
1811764,1432143,2024-02-26,House,"House: VOTE: Block Vote Passage (96-Y 0-N)",96,0,0,4,100
1811764,1432144,2024-02-28,Senate,"Senate: House substitute rejected by Senate (0-Y 39-N)",0,39,0,1,40
1811764,1432145,2024-03-04,Senate,"Senate: Senate acceded to request (38-Y 0-N)",38,0,0,2,40
1811764,1432146,2024-03-06,House,"House: VOTE: Adoption (98-Y 0-N)",98,0,0,2,100
1811764,1432147,2024-03-07,Senate,"Senate: Conference report agreed to by Senate (40-Y 0-N)",40,0,0,0,40
1811764,1432148,2024-04-17,Senate,"Senate: Senate concurred in Governor's recommendation (40-Y 0-N)",40,0,0,0,40
1811764,1433234,2024-04-17,House,"House: VOTE: REJECTED (42-Y 57-N)",42,57,0,1,100
1811769,1371727,2024-01-30,Senate,"Senate: Continued to 2025 in Agriculture, Conservation and Natural Resources (15-Y 0-N)",15,0,0,0,15
1811771,1367807,2024-01-23,Senate,"Senate: Failed to report (defeated) in Privileges and Elections (7-Y 7-N)",7,7,0,0,14
1811773,1379041,2024-02-08,Senate,"Senate: Passed by indefinitely in Education and Health (9-Y 6-N)",9,6,0,0,15
1811775,1368844,2024-01-24,Senate,"Senate: Reported from General Laws and Technology (13-Y 2-N)",13,2,0,0,15
1811775,1377684,2024-02-06,Senate,"Senate: Reported from Finance and Appropriations with substitute (15-Y 0-N)",15,0,0,0,15
1811775,1378376,2024-02-07,Senate,"Senate: Constitutional reading dispensed (40-Y 0-N)",40,0,0,0,40
1811775,1381149,2024-02-09,Senate,"Senate: Read third time and passed Senate (29-Y 10-N)",29,10,0,1,40
1811775,1388728,2024-02-20,House,"House: Subcommittee recommends reporting with amendments (6-Y 1-N)",6,1,0,1,8
1811775,1392740,2024-02-22,House,"House: Reported from General Laws with amendment(s) (17-Y 4-N)",17,4,0,1,22
1811775,1401984,2024-03-04,House,"House: Reported from Appropriations with amendment(s) (21-Y 0-N)",21,0,0,1,22
1811775,1402585,2024-03-04,House,"House: Reported from Appropriations (21-Y 0-N)",21,0,0,1,22
1811775,1405189,2024-03-07,House,"House: VOTE: Passage (78-Y 18-N)",78,18,0,4,100
1811775,1405190,2024-03-07,Senate,"Senate: House amendment agreed to by Senate (24-Y 16-N)",24,16,0,0,40
1811775,1429803,2024-04-17,Senate,"Senate: Senate concurred in Governor's recommendation (32-Y 8-N)",32,8,0,0,40
1811775,1429804,2024-04-17,House,"House: VOTE: Adoption (80-Y 19-N)",80,19,0,1,100
1811777,1377053,2024-02-06,Senate,"Senate: Continued to 2025 in Finance and Appropriations (14-Y 1-N)",14,1,0,0,15
1811779,1379983,2024-02-08,Senate,"Senate: Reported from Education and Health with substitute (15-Y 0-N)",15,0,0,0,15
1811779,1379984,2024-02-08,Senate,"Senate: Constitutional reading dispensed (40-Y 0-N)",40,0,0,0,40
1811779,1381164,2024-02-09,Senate,"Senate: Constitutional reading dispensed (40-Y 0-N)",40,0,0,0,40
1811779,1381165,2024-02-09,Senate,"Senate: Passed Senate (40-Y 0-N)",40,0,0,0,40
1811779,1388294,2024-02-20,House,"House: Subcommittee recommends reporting with substitute (8-Y 0-N)",8,0,0,0,8
1811779,1389752,2024-02-21,House,"House: Reported from Education with substitute (22-Y 0-N)",22,0,0,0,22
1811779,1395324,2024-02-26,House,"House: VOTE: Block Vote Passage (96-Y 0-N)",96,0,0,4,100
1811779,1398642,2024-02-28,Senate,"Senate: House substitute rejected by Senate (0-Y 39-N)",0,39,0,1,40
1811779,1402502,2024-03-04,Senate,"Senate: Senate acceded to request (38-Y 0-N)",38,0,0,2,40
1811779,1404739,2024-03-06,House,"House: VOTE: Adoption (99-Y 0-N)",99,0,0,1,100
1811779,1405401,2024-03-07,Senate,"Senate: Conference report agreed to by Senate (40-Y 0-N)",40,0,0,0,40
1811780,1367207,2024-01-22,Senate,"Senate: Reported from Courts of Justice (9-Y 6-N)",9,6,0,0,15
1811780,1372821,2024-01-31,Senate,"Senate: Reported from Finance and Appropriations (10-Y 5-N)",10,5,0,0,15
1811780,1374183,2024-02-01,Senate,"Senate: Constitutional reading dispensed (40-Y 0-N)",40,0,0,0,40
1811780,1376168,2024-02-05,Senate,"Senate: Read third time and passed Senate (21-Y 19-N)",21,19,0,0,40
1811780,1393145,2024-02-23,House,"House: Reported from Public Safety with substitute (12-Y 9-N)",12,9,0,1,22
1811780,1398030,2024-02-28,House,"House: VOTE: Passage (51-Y 49-N)",51,49,0,0,100
1811780,1400852,2024-03-01,Senate,"Senate: House substitute rejected by Senate (0-Y 40-N)",0,40,0,0,40
1811780,1403360,2024-03-05,Senate,"Senate: Senate acceded to request (40-Y 0-N)",40,0,0,0,40
1811784,1366689,2024-01-18,Senate,"Senate: Rereferred from Transportation (13-Y 0-N)",13,0,0,0,13
1811784,1374072,2024-02-01,Senate,"Senate: Reported from Education and Health with amendments (15-Y 0-N)",15,0,0,0,15
1811784,1378007,2024-02-07,Senate,"Senate: Continued to 2025 in Finance and Appropriations (14-Y 1-N)",14,1,0,0,15
1811786,1376931,2024-02-06,House,"House: Subcommittee recommends reporting (8-Y 0-N)",8,0,0,0,8
1811786,1380110,2024-02-08,House,"House: Reported from Transportation (22-Y 0-N)",22,0,0,0,22
1811786,1383825,2024-02-13,House,"House: VOTE: Block Vote Passage (99-Y 0-N)",99,0,0,1,100
1811786,1391071,2024-02-21,Senate,"Senate: Reported from Courts of Justice (13-Y 0-N)",13,0,0,0,13
1811786,1394095,2024-02-23,Senate,"Senate: Constitutional reading dispensed (38-Y 0-N)",38,0,0,2,40
1811786,1395359,2024-02-26,Senate,"Senate: Passed Senate (40-Y 0-N)",40,0,0,0,40
1811788,1376387,2024-02-05,Senate,"Senate: Reported from Commerce and Labor with substitute (15-Y 0-N)",15,0,0,0,15
1811788,1379713,2024-02-08,Senate,"Senate: Reported from Finance and Appropriations (15-Y 0-N)",15,0,0,0,15
1811788,1381073,2024-02-09,Senate,"Senate: Constitutional reading dispensed (39-Y 0-N)",39,0,0,1,40
1811788,1381901,2024-02-12,Senate,"Senate: Constitutional reading dispensed (40-Y 0-N)",40,0,0,0,40
1811788,1381902,2024-02-12,Senate,"Senate: Passed Senate (40-Y 0-N)",40,0,0,0,40
1811788,1389297,2024-02-20,House,"House: Reported from Labor and Commerce with amendment(s) (22-Y 0-N)",22,0,0,0,22
1811788,1393385,2024-02-23,House,"House: VOTE: Block Vote Passage (98-Y 0-N)",98,0,0,2,100
1811788,1396329,2024-02-27,Senate,"Senate: House amendments agreed to by Senate (39-Y 0-N)",39,0,0,1,40
1811790,1379166,2024-02-08,Senate,"Senate: Continued to 2025 in Education and Health (15-Y 0-N)",15,0,0,0,15
1811791,1379748,2024-02-08,Senate,"Senate: Reported from Finance and Appropriations with substitute (15-Y 0-N)",15,0,0,0,15
1811791,1380816,2024-02-09,Senate,"Senate: Constitutional reading dispensed (39-Y 0-N)",39,0,0,1,40
1811791,1382122,2024-02-12,Senate,"Senate: Constitutional reading dispensed (40-Y 0-N)",40,0,0,0,40
1811791,1382123,2024-02-12,Senate,"Senate: Passed Senate (40-Y 0-N)",40,0,0,0,40
1811791,1389064,2024-02-20,House,"House: Reported from General Laws with substitute (21-Y 0-N)",21,0,0,1,22
1811791,1393807,2024-02-23,House,"House: VOTE: Passage (85-Y 13-N)",85,13,0,2,100
1811791,1395938,2024-02-27,Senate,"Senate: House substitute rejected by Senate (1-Y 38-N)",1,38,0,1,40
1811791,1398360,2024-02-28,Senate,"Senate: Senate acceded to request (39-Y 0-N)",39,0,0,1,40
1811791,1406223,2024-03-08,Senate,"Senate: Conference report agreed to by Senate (24-Y 16-N)",24,16,0,0,40
1811791,1406224,2024-03-08,House,"House: VOTE: Adoption (89-Y 10-N)",89,10,0,1,100
1811791,1429628,2024-04-17,Senate,"Senate: Senate concurred in Governor's recommendation (37-Y 3-N)",37,3,0,0,40
1811791,1430322,2024-04-17,House,"House: VOTE: Adoption (83-Y 14-N)",83,14,0,3,100
1811796,1382554,2024-02-12,Senate,"Senate: Reported from Courts of Justice with substitute (5-Y 4-N)",5,4,0,0,9
1811796,1383579,2024-02-13,Senate,"Senate: Constitutional reading dispensed (40-Y 0-N)",40,0,0,0,40
1811796,1383580,2024-02-13,Senate,"Senate: Passed Senate (25-Y 15-N)",25,15,0,0,40
1811796,1383581,2024-02-13,Senate,"Senate: Constitutional reading dispensed (40-Y 0-N)",40,0,0,0,40
1811796,1391095,2024-02-21,House,"House: Subcommittee recommends reporting with substitute (5-Y 3-N)",5,3,0,1,9
1811796,1394092,2024-02-23,House,"House: Reported from Courts of Justice with substitute (12-Y 9-N)",12,9,0,1,22
1811796,1398567,2024-02-28,House,"House: VOTE: Passage (53-Y 44-N)",53,44,0,3,100
1811796,1401224,2024-03-01,Senate,"Senate: House substitute rejected by Senate (0-Y 40-N)",0,40,0,0,40
1811796,1403708,2024-03-05,Senate,"Senate: Senate acceded to request (40-Y 0-N)",40,0,0,0,40
1811799,1364280,2024-01-15,Senate,"Senate: Rereferred from Courts of Justice (15-Y 0-N)",15,0,0,0,15
1811799,1377041,2024-02-06,Senate,"Senate: Reported from Finance and Appropriations with amendment (15-Y 0-N)",15,0,0,0,15
1811799,1378545,2024-02-07,Senate,"Senate: Constitutional reading dispensed (40-Y 0-N)",40,0,0,0,40
1811799,1380016,2024-02-08,Senate,"Senate: Constitutional reading dispensed (40-Y 0-N)",40,0,0,0,40
1811799,1380017,2024-02-08,Senate,"Senate: Read third time and passed Senate (40-Y 0-N)",40,0,0,0,40
1811799,1391302,2024-02-22,House,"House: Subcommittee recommends reporting with substitute (5-Y 1-N)",5,1,0,0,6
1811799,1393727,2024-02-23,House,"House: Reported from Public Safety with substitute (21-Y 0-N)",21,0,0,1,22
1811801,1374053,2024-02-01,Senate,"Senate: Reported from Education and Health with amendment (15-Y 0-N)",15,0,0,0,15
1811801,1377604,2024-02-06,Senate,"Senate: Read third time and passed Senate (39-Y 0-N)",39,0,0,1,40
1811801,1385364,2024-02-15,House,"House: Reported from Health and Human Services (22-Y 0-N)",22,0,0,0,22
1811801,1432211,2024-02-20,House,"House: VOTE: Block Vote Passage (98-Y 0-N)",98,0,0,2,100
1811803,1371041,2024-01-29,Senate,"Senate: Reported from Commerce and Labor with substitute (15-Y 0-N)",15,0,0,0,15
1811803,1372469,2024-01-31,Senate,"Senate: Constitutional reading dispensed (40-Y 0-N)",40,0,0,0,40
1811803,1432138,2024-02-27,House,"House: Subcommittee recommends reporting (10-Y 0-N)",10,0,0,1,11
1811803,1432139,2024-02-27,House,"House: Reported from Labor and Commerce (21-Y 0-N)",21,0,0,1,22
1811803,1432140,2024-03-01,House,"House: VOTE: Block Vote Passage (97-Y 0-N)",97,0,0,3,100
1811805,1379911,2024-02-08,Senate,"Senate: Reported from Education and Health with substitute (15-Y 0-N)",15,0,0,0,15
1811805,1379912,2024-02-08,Senate,"Senate: Constitutional reading dispensed (40-Y 0-N)",40,0,0,0,40
1811805,1381183,2024-02-09,Senate,"Senate: Constitutional reading dispensed (40-Y 0-N)",40,0,0,0,40
1811805,1381184,2024-02-09,Senate,"Senate: Passed Senate (40-Y 0-N)",40,0,0,0,40
1811805,1386583,2024-02-16,House,"House: Reported from Courts of Justice (22-Y 0-N)",22,0,0,0,22
1811805,1390952,2024-02-21,House,"House: VOTE: Block Vote Passage (100-Y 0-N)",100,0,0,0,100
1811808,1376434,2024-02-05,Senate,"Senate: Reported from Commerce and Labor with substitute (9-Y 6-N)",9,6,0,0,15
1811808,1379690,2024-02-08,Senate,"Senate: Reported from Finance and Appropriations with substitute (10-Y 5-N)",10,5,0,0,15
1811808,1381088,2024-02-09,Senate,"Senate: Constitutional reading dispensed (39-Y 0-N)",39,0,0,1,40
1811808,1383427,2024-02-13,Senate,"Senate: Read third time and passed Senate (21-Y 19-N)",21,19,0,0,40
1811808,1396062,2024-02-27,House,"House: Subcommittee recommends reporting (9-Y 1-N)",9,1,0,1,11
1811808,1396063,2024-02-27,House,"House: Reported from Labor and Commerce (20-Y 1-N)",20,1,0,1,22
1811808,1400570,2024-03-01,House,"House: VOTE: Passage (84-Y 13-N)",84,13,0,3,100
1811810,1373177,2024-01-31,Senate,"Senate: Reported from General Laws and Technology with substitute (15-Y 0-N)",15,0,0,0,15
1811810,1377601,2024-02-06,Senate,"Senate: Read third time and passed Senate (39-Y 0-N)",39,0,0,1,40
1811810,1432149,2024-02-22,House,"House: Subcommittee recommends reporting (6-Y 0-N)",6,0,0,2,8
1811810,1432150,2024-02-27,House,"House: Reported from General Laws (22-Y 0-N)",22,0,0,0,22
1811810,1432151,2024-03-01,House,"House: VOTE: Block Vote Passage (97-Y 0-N)",97,0,0,3,100
1811812,1364294,2024-01-15,Senate,"Senate: Incorporated by Local Government ",11,0,0,0,11
1811816,1374726,2024-02-01,Senate,"Senate: Continued to 2025 in Transportation (15-Y 0-N)",15,0,0,0,15
1811818,1369777,2024-01-26,Senate,"Senate: Reported from Rules with substitute (14-Y 0-N)",14,0,0,0,14
1811818,1370978,2024-01-29,Senate,"Senate: Constitutional reading dispensed (39-Y 0-N)",39,0,0,1,40
1811818,1372492,2024-01-31,Senate,"Senate: Read third time and passed Senate (40-Y 0-N)",40,0,0,0,40
1811818,1393188,2024-02-23,House,"House: Subcommittee recommends reporting (6-Y 0-N)",6,0,0,0,6
1811818,1393189,2024-02-23,House,"House: Reported from Rules (16-Y 0-N)",16,0,0,2,18
1811818,1398436,2024-02-28,House,"House: Reported from Appropriations (22-Y 0-N)",22,0,0,0,22
1811818,1401765,2024-03-04,House,"House: VOTE: Block Vote Passage (97-Y 0-N)",97,0,0,3,100
1811819,1378450,2024-02-07,Senate,"Senate: Reported from General Laws and Technology (15-Y 0-N)",15,0,0,0,15
1811819,1379311,2024-02-08,Senate,"Senate: Constitutional reading dispensed (40-Y 0-N)",40,0,0,0,40
1811819,1381162,2024-02-09,Senate,"Senate: Constitutional reading dispensed (40-Y 0-N)",40,0,0,0,40
1811819,1381163,2024-02-09,Senate,"Senate: Passed Senate (40-Y 0-N)",40,0,0,0,40
1811819,1389587,2024-02-20,House,"House: Reported from General Laws (15-Y 6-N)",15,6,0,1,22
1811819,1393350,2024-02-23,House,"House: VOTE: Passage (54-Y 44-N)",54,44,0,2,100
1811819,1430287,2024-04-17,Senate,"Senate: Senate concurred in Governor's recommendation (40-Y 0-N)",40,0,0,0,40
1811819,1430288,2024-04-17,House,"House: VOTE: Adoption (0-Y 100-N)",0,100,0,0,100
1811822,1367356,2024-01-22,Senate,"Senate: Reported from Local Government (15-Y 0-N)",15,0,0,0,15
1811822,1368925,2024-01-23,Senate,"Senate: Constitutional reading dispensed (39-Y 0-N)",39,0,0,1,40
1811822,1369080,2024-01-25,Senate,"Senate: Read third time and passed Senate (40-Y 0-N)",40,0,0,0,40
1811822,1387070,2024-02-16,House,"House: Reported from Counties, Cities and Towns (21-Y 0-N)",21,0,0,1,22
1811822,1390043,2024-02-21,House,"House: VOTE: Block Vote Passage (100-Y 0-N)",100,0,0,0,100
1811825,1373540,2024-02-01,Senate,"Senate: Reported from Education and Health with substitute (15-Y 0-N)",15,0,0,0,15
1811825,1379687,2024-02-08,Senate,"Senate: Reported from Finance and Appropriations with substitute (15-Y 0-N)",15,0,0,0,15
1811825,1380955,2024-02-09,Senate,"Senate: Constitutional reading dispensed (39-Y 0-N)",39,0,0,1,40
1811825,1381815,2024-02-12,Senate,"Senate: Constitutional reading dispensed (40-Y 0-N)",40,0,0,0,40
1811825,1381816,2024-02-12,Senate,"Senate: Passed Senate (40-Y 0-N)",40,0,0,0,40
1811825,1391767,2024-02-22,House,"House: Subcommittee recommends reporting with substitute (8-Y 0-N)",8,0,0,0,8
1811825,1395572,2024-02-27,House,"House: Reported from Health and Human Services with substitute (21-Y 0-N)",21,0,0,1,22
1811825,1400551,2024-03-01,House,"House: VOTE: Block Vote Passage (97-Y 0-N)",97,0,0,3,100
1811825,1403583,2024-03-05,Senate,"Senate: House substitute rejected by Senate (0-Y 40-N)",0,40,0,0,40
1811825,1405536,2024-03-07,Senate,"Senate: Senate acceded to request (40-Y 0-N)",40,0,0,0,40
1811825,1406213,2024-03-08,Senate,"Senate: Conference report agreed to by Senate (40-Y 0-N)",40,0,0,0,40
1811825,1406214,2024-03-08,House,"House: VOTE: Adoption (96-Y 0-N)",96,0,0,4,100
1811826,1369752,2024-01-26,Senate,"Senate: Reported from Rehabilitation and Social Services (15-Y 0-N)",15,0,0,0,15
1811826,1370432,2024-01-29,Senate,"Senate: Constitutional reading dispensed (39-Y 0-N)",39,0,0,1,40
1811826,1372470,2024-01-31,Senate,"Senate: Read third time and passed Senate (40-Y 0-N)",40,0,0,0,40
1811826,1385452,2024-02-15,House,"House: Reported from General Laws (20-Y 2-N)",20,2,0,0,22
1811826,1388756,2024-02-20,House,"House: VOTE: Passage (82-Y 16-N)",82,16,0,2,100
1811828,1375770,2024-02-05,Senate,"Senate: Reported from Courts of Justice with amendments (11-Y 2-N)",11,2,0,0,13
1811828,1378574,2024-02-07,Senate,"Senate: Reported from General Laws and Technology (12-Y 3-N)",12,3,0,0,15
1811828,1380102,2024-02-08,Senate,"Senate: Constitutional reading dispensed (40-Y 0-N)",40,0,0,0,40
1811828,1381695,2024-02-12,Senate,"Senate: Read third time and passed Senate (21-Y 19-N)",21,19,0,0,40
1811828,1388536,2024-02-20,House,"House: Reported from General Laws (12-Y 9-N)",12,9,0,1,22
1811828,1393356,2024-02-23,House,"House: VOTE: Passage (50-Y 48-N)",50,48,0,2,100
1811831,1374597,2024-02-02,Senate,"Senate: Reported from Rules with substitute (13-Y 0-N 1-A)",13,0,1,0,14
1811831,1375996,2024-02-05,Senate,"Senate: Constitutional reading dispensed (39-Y 0-N)",39,0,0,1,40
1811831,1378470,2024-02-07,Senate,"Senate: Read third time and passed Senate (39-Y 0-N)",39,0,0,1,40
1811831,1393177,2024-02-23,House,"House: Subcommittee recommends reporting (6-Y 0-N)",6,0,0,0,6
1811831,1393178,2024-02-23,House,"House: Reported from Rules (16-Y 0-N)",16,0,0,2,18
1811831,1397565,2024-02-28,House,"House: Reported from Appropriations (22-Y 0-N)",22,0,0,0,22
1811831,1401768,2024-03-04,House,"House: VOTE: Block Vote Passage (97-Y 0-N)",97,0,0,3,100
1811831,1429544,2024-04-17,Senate,"Senate: Senate concurred in Governor's recommendation (40-Y 0-N)",40,0,0,0,40
1811831,1430306,2024-04-17,House,"House: VOTE: (97-Y 0-N)",97,0,0,3,100
1811832,1371658,2024-01-30,Senate,"Senate: Reported from Privileges and Elections with substitute (8-Y 7-N)",8,7,0,0,15
1811832,1378167,2024-02-07,Senate,"Senate: Reported from Finance and Appropriations (11-Y 4-N)",11,4,0,0,15
1811832,1379286,2024-02-08,Senate,"Senate: Constitutional reading dispensed (40-Y 0-N)",40,0,0,0,40
1811832,1381749,2024-02-12,Senate,"Senate: Read third time and passed Senate (21-Y 19-N)",21,19,0,0,40
1811832,1394463,2024-02-26,House,"House: Subcommittee recommends reporting with substitute (6-Y 2-N)",6,2,0,0,8
1811832,1400339,2024-03-01,House,"House: Reported from Privileges and Elections with substitute (14-Y 7-N)",14,7,0,1,22
1811832,1404132,2024-03-06,House,"House: VOTE: Passage (54-Y 44-N)",54,44,0,2,100
1811832,1405596,2024-03-07,Senate,"Senate: House substitute agreed to by Senate (21-Y 19-N)",21,19,0,0,40
1811835,1374039,2024-02-01,Senate,"Senate: Reported from Education and Health (13-Y 2-N)",13,2,0,0,15
1811835,1377248,2024-02-06,Senate,"Senate: Read third time and passed Senate (32-Y 7-N)",32,7,0,1,40
1811835,1384186,2024-02-14,House,"House: Reported from Education (21-Y 0-N)",21,0,0,1,22
1811835,1432187,2024-02-19,House,"House: VOTE: Block Vote Passage (99-Y 0-N)",99,0,0,1,100
1811840,1370232,2024-01-29,Senate,"Senate: Continued to 2025 in Local Government (15-Y 0-N)",15,0,0,0,15
1811841,1369708,2024-01-26,Senate,"Senate: Reported from Rehabilitation and Social Services with substitute (10-Y 5-N)",10,5,0,0,15
1811841,1373531,2024-01-31,Senate,"Senate: Reported from Courts of Justice with substitute (7-Y 5-N 3-A)",7,5,3,0,15
1811841,1380259,2024-02-08,Senate,"Senate: Reported from Finance and Appropriations with substitute (9-Y 5-N 1-A)",9,5,1,0,15
1811841,1381052,2024-02-09,Senate,"Senate: Constitutional reading dispensed (39-Y 0-N)",39,0,0,1,40
1811841,1383489,2024-02-13,Senate,"Senate: Read third time and passed Senate (21-Y 18-N)",21,18,0,1,40
1811841,1392622,2024-02-22,House,"House: Reported from General Laws with substitute (12-Y 10-N)",12,10,0,0,22
1811841,1398437,2024-02-28,House,"House: VOTE: Passage (51-Y 47-N)",51,47,0,2,100
1811841,1398438,2024-02-28,Senate,"Senate: House substitute agreed to by Senate (21-Y 18-N)",21,18,0,1,40
1811844,1368898,2024-01-24,Senate,"Senate: Reported from General Laws and Technology (9-Y 6-N)",9,6,0,0,15
1811844,1376873,2024-02-06,Senate,"Senate: Reported from Finance and Appropriations with amendments (10-Y 5-N)",10,5,0,0,15
1811844,1378048,2024-02-07,Senate,"Senate: Constitutional reading dispensed (40-Y 0-N)",40,0,0,0,40
1811844,1381166,2024-02-09,Senate,"Senate: Read third time and passed Senate (21-Y 19-N)",21,19,0,0,40
1811844,1392891,2024-02-22,House,"House: Subcommittee recommends reporting (4-Y 2-N)",4,2,0,2,8
1811844,1396870,2024-02-27,House,"House: Reported from General Laws (12-Y 10-N)",12,10,0,0,22
1811844,1402406,2024-03-04,House,"House: Reported from Appropriations (12-Y 10-N)",12,10,0,0,22
1811844,1405550,2024-03-07,House,"House: VOTE: Passage (51-Y 48-N)",51,48,0,1,100
1811846,1379042,2024-02-08,Senate,"Senate: Continued to 2025 in Education and Health (15-Y 0-N)",15,0,0,0,15
1811848,1373171,2024-01-31,Senate,"Senate: Reported from General Laws and Technology (14-Y 0-N)",14,0,0,0,14
1811848,1377596,2024-02-06,Senate,"Senate: Read third time and passed Senate (39-Y 0-N)",39,0,0,1,40
1811848,1432188,2024-02-15,House,"House: Reported from General Laws (17-Y 5-N)",17,5,0,0,22
1811848,1432189,2024-02-20,House,"House: VOTE: Passage (71-Y 28-N)",71,28,0,1,100
1811851,1367688,2024-01-23,Senate,"Senate: Reported from Privileges and Elections (11-Y 0-N 3-A)",11,0,3,0,14
1811851,1369115,2024-01-25,Senate,"Senate: Constitutional reading dispensed (40-Y 0-N)",40,0,0,0,40
1811851,1370841,2024-01-29,Senate,"Senate: Read third time and passed Senate (39-Y 1-N)",39,1,0,0,40
1811851,1370842,2024-01-29,Senate,"Senate: Reconsideration of passage agreed to by Senate (39-Y 1-N)",39,1,0,0,40
1811851,1371557,2024-01-30,Senate,"Senate: Read third time and passed Senate (39-Y 1-N)",39,1,0,0,40
1811851,1387012,2024-02-16,House,"House: Reported from Privileges and Elections with substitute (21-Y 0-N)",21,0,0,1,22
1811851,1390039,2024-02-21,House,"House: VOTE: Block Vote Passage (100-Y 0-N)",100,0,0,0,100
1811851,1393820,2024-02-23,Senate,"Senate: House substitute agreed to by Senate (39-Y 0-N)",39,0,0,1,40
1811853,1377428,2024-02-06,Senate,"Senate: Passed by indefinitely in Agriculture, Conservation and Natural Resources (9-Y 6-N)",9,6,0,0,15
1811854,1373686,2024-02-01,Senate,"Senate: Reported from Education and Health (15-Y 0-N)",15,0,0,0,15
1811854,1379722,2024-02-08,Senate,"Senate: Reported from Finance and Appropriations with substitute (15-Y 0-N)",15,0,0,0,15
1811854,1381089,2024-02-09,Senate,"Senate: Constitutional reading dispensed (39-Y 0-N)",39,0,0,1,40
1811854,1382010,2024-02-12,Senate,"Senate: Constitutional reading dispensed (40-Y 0-N)",40,0,0,0,40
1811854,1382011,2024-02-12,Senate,"Senate: Passed Senate (40-Y 0-N)",40,0,0,0,40
1811854,1388299,2024-02-20,House,"House: Subcommittee recommends reporting with substitute (7-Y 1-N)",7,1,0,0,8
1811854,1389744,2024-02-21,House,"House: Reported from Education with substitute (13-Y 9-N)",13,9,0,0,22
1811854,1394823,2024-02-26,House,"House: VOTE: Passage (60-Y 35-N)",60,35,0,5,100
1811854,1397806,2024-02-28,Senate,"Senate: House substitute agreed to by Senate (21-Y 16-N)",21,16,0,3,40
1811854,1430135,2024-04-17,Senate,"Senate: Senate concurred in Governor's recommendation (40-Y 0-N)",40,0,0,0,40
1811854,1430136,2024-04-17,House,"House: VOTE: Adoption (63-Y 37-N)",63,37,0,0,100
1811857,1374487,2024-02-02,Senate,"Senate: Continued to 2025 in Rehabilitation and Social Services (13-Y 0-N)",13,0,0,0,13
1811860,1375847,2024-02-05,Senate,"Senate: Reported from Courts of Justice with substitute (9-Y 6-N)",9,6,0,0,15
1811860,1377890,2024-02-07,Senate,"Senate: Reported from Finance and Appropriations (10-Y 5-N)",10,5,0,0,15
1811860,1379892,2024-02-08,Senate,"Senate: Constitutional reading dispensed (40-Y 0-N)",40,0,0,0,40
1811860,1382026,2024-02-12,Senate,"Senate: Read third time and passed Senate (21-Y 19-N)",21,19,0,0,40
1811860,1386589,2024-02-16,House,"House: Reported from Public Safety (12-Y 10-N)",12,10,0,0,22
1811860,1386590,2024-02-16,House,"House: Reported from Courts of Justice with substitute (12-Y 10-N)",12,10,0,0,22
1811860,1389994,2024-02-21,House,"House: VOTE: Passage (52-Y 47-N 1-A)",52,47,1,0,100
1811860,1393811,2024-02-23,Senate,"Senate: House substitute agreed to by Senate (21-Y 17-N)",21,17,0,2,40
1811860,1430292,2024-04-17,Senate,"Senate: Passed in enrolled form rejected (22-Y 18-N)",22,18,0,0,40
1811861,1370660,2024-01-29,Senate,"Senate: Reported from Local Government (15-Y 0-N)",15,0,0,0,15
1811861,1371546,2024-01-30,Senate,"Senate: Constitutional reading dispensed (40-Y 0-N)",40,0,0,0,40
1811861,1374385,2024-02-01,Senate,"Senate: Read third time and passed Senate (40-Y 0-N)",40,0,0,0,40
1811861,1396511,2024-02-27,House,"House: Subcommittee recommends laying on the table (5-Y 2-N)",5,2,0,2,9
1811864,1379812,2024-02-08,Senate,"Senate: Reported from Education and Health with substitute (15-Y 0-N)",15,0,0,0,15
1811864,1379813,2024-02-08,Senate,"Senate: Constitutional reading dispensed (40-Y 0-N)",40,0,0,0,40
1811864,1380633,2024-02-09,Senate,"Senate: Constitutional reading dispensed (40-Y 0-N)",40,0,0,0,40
1811864,1380634,2024-02-09,Senate,"Senate: Read third time and passed Senate (40-Y 0-N)",40,0,0,0,40
1811864,1388526,2024-02-20,House,"House: Reported from Health and Human Services with amendment(s) (22-Y 0-N)",22,0,0,0,22
1811864,1393369,2024-02-23,House,"House: VOTE: Block Vote Passage (98-Y 0-N)",98,0,0,2,100
1811864,1396328,2024-02-27,Senate,"Senate: House amendments agreed to by Senate (39-Y 0-N)",39,0,0,1,40
1811866,1368086,2024-01-23,Senate,"Senate: Continued to 2025 in Agriculture, Conservation and Natural Resources (15-Y 0-N)",15,0,0,0,15
1811867,1372914,2024-01-31,Senate,"Senate: Passed by indefinitely in General Laws and Technology (9-Y 6-N)",9,6,0,0,15
1811869,1367565,2024-01-22,Senate,"Senate: Reported from Commerce and Labor with amendments (14-Y 0-N)",14,0,0,0,14
1811869,1378508,2024-02-07,Senate,"Senate: Reported from Finance and Appropriations with substitute (15-Y 0-N)",15,0,0,0,15
1811869,1379343,2024-02-08,Senate,"Senate: Constitutional reading dispensed (40-Y 0-N)",40,0,0,0,40
1811869,1381155,2024-02-09,Senate,"Senate: Constitutional reading dispensed (40-Y 0-N)",40,0,0,0,40
1811869,1381156,2024-02-09,Senate,"Senate: Passed Senate (40-Y 0-N)",40,0,0,0,40
1811869,1389571,2024-02-20,House,"House: Reported from Labor and Commerce (22-Y 0-N)",22,0,0,0,22
1811877,1367575,2024-01-22,Senate,"Senate: Reported from Commerce and Labor with substitute (8-Y 6-N)",8,6,0,0,14
1811877,1372460,2024-01-31,Senate,"Senate: Continued to 2025 in Finance and Appropriations (13-Y 2-N)",13,2,0,0,15
1811879,1378709,2024-02-07,Senate,"Senate: Continued to 2025 in General Laws and Technology (15-Y 0-N)",15,0,0,0,15
1811880,1368908,2024-01-24,Senate,"Senate: Reported from General Laws and Technology (15-Y 0-N)",15,0,0,0,15
1811880,1369732,2024-01-26,Senate,"Senate: Constitutional reading dispensed (37-Y 0-N)",37,0,0,3,40
1811880,1372203,2024-01-30,Senate,"Senate: Read third time and passed Senate (40-Y 0-N)",40,0,0,0,40
1811880,1388339,2024-02-20,House,"House: Subcommittee recommends reporting (8-Y 0-N)",8,0,0,0,8
1811880,1391269,2024-02-22,House,"House: Reported from Health and Human Services (21-Y 0-N)",21,0,0,1,22
1811880,1397006,2024-02-27,House,"House: VOTE: Block Vote Passage (97-Y 0-N)",97,0,0,3,100
1811883,1381321,2024-02-12,Senate,"Senate: Continued to 2025 in Finance and Appropriations (12-Y 3-N)",12,3,0,0,15
1811885,1371726,2024-01-30,Senate,"Senate: Reported from Agriculture, Conservation and Natural Resources with substitite (15-Y 0-N)",15,0,0,0,15
1811885,1381295,2024-02-12,Senate,"Senate: Continued to 2025 in Finance and Appropriations (12-Y 3-N)",12,3,0,0,15
1811886,1374051,2024-02-01,Senate,"Senate: Reported from Education and Health with substitute (15-Y 0-N)",15,0,0,0,15
1811886,1378531,2024-02-07,Senate,"Senate: Reported from Finance and Appropriations with substitute (15-Y 0-N)",15,0,0,0,15
1811886,1379336,2024-02-08,Senate,"Senate: Constitutional reading dispensed (40-Y 0-N)",40,0,0,0,40
1811886,1381175,2024-02-09,Senate,"Senate: Constitutional reading dispensed (40-Y 0-N)",40,0,0,0,40
1811886,1381176,2024-02-09,Senate,"Senate: Passed Senate (40-Y 0-N)",40,0,0,0,40
1811886,1395622,2024-02-27,House,"House: Subcommittee recommends reporting (8-Y 0-N)",8,0,0,0,8
1811886,1397276,2024-02-28,House,"House: Reported from Education (22-Y 0-N)",22,0,0,0,22
1811886,1402001,2024-03-04,House,"House: VOTE: Block Vote Passage (97-Y 0-N)",97,0,0,3,100
1811888,1368904,2024-01-24,Senate,"Senate: Reported from General Laws and Technology (14-Y 0-N 1-A)",14,0,1,0,15
1811888,1369738,2024-01-26,Senate,"Senate: Constitutional reading dispensed (37-Y 0-N)",37,0,0,3,40
1811888,1371542,2024-01-30,Senate,"Senate: Read third time and passed Senate (40-Y 0-N)",40,0,0,0,40
1811888,1371543,2024-01-30,Senate,"Senate: Reconsideration of passage agreed to by Senate (38-Y 2-N)",38,2,0,0,40
1811888,1373291,2024-01-31,Senate,"Senate: Read third time and passed Senate (40-Y 0-N)",40,0,0,0,40
1811888,1388437,2024-02-20,House,"House: Subcommittee recommends reporting (8-Y 0-N)",8,0,0,0,8
1811888,1391487,2024-02-22,House,"House: Reported from Health and Human Services (21-Y 0-N)",21,0,0,1,22
1811888,1395805,2024-02-27,House,"House: VOTE: Block Vote Passage (97-Y 0-N)",97,0,0,3,100
1811892,1368403,2024-01-24,Senate,"Senate: Reported from Finance and Appropriations with substitute (14-Y 0-N)",14,0,0,0,14
1811892,1369098,2024-01-25,Senate,"Senate: Constitutional reading dispensed (40-Y 0-N)",40,0,0,0,40
1811892,1371163,2024-01-29,Senate,"Senate: Read third time and passed Senate (40-Y 0-N)",40,0,0,0,40
1811892,1387635,2024-02-19,House,"House: Reported from Appropriations (22-Y 0-N)",22,0,0,0,22
1811892,1392930,2024-02-22,House,"House: VOTE: Block Vote Passage (99-Y 0-N)",99,0,0,1,100
1811893,1368044,2024-01-23,Senate,"Senate: Reported from Agriculture, Conservation and Natural Resources (15-Y 0-N)",15,0,0,0,15
1811893,1381308,2024-02-12,Senate,"Senate: Reported from Finance and Appropriations with substitute (15-Y 0-N)",15,0,0,0,15
1811893,1381843,2024-02-12,Senate,"Senate: Constitutional reading dispensed (40-Y 0-N)",40,0,0,0,40
1811893,1383170,2024-02-13,Senate,"Senate: Constitutional reading dispensed (39-Y 0-N)",39,0,0,1,40
1811893,1383171,2024-02-13,Senate,"Senate: Passed Senate (40-Y 0-N)",40,0,0,0,40
1811893,1394985,2024-02-26,House,"House: Subcommittee recommends reporting (10-Y 0-N)",10,0,0,0,10
1811893,1397381,2024-02-28,House,"House: Reported from Agriculture, Chesapeake and Natural Resources (22-Y 0-N)",22,0,0,0,22
1811893,1401522,2024-03-04,House,"House: VOTE: Block Vote Passage (97-Y 0-N)",97,0,0,3,100
1811895,1366330,2024-01-17,Senate,"Senate: Reported from Courts of Justice with substitute (13-Y 0-N 2-A)",13,0,2,0,15
1811895,1368399,2024-01-24,Senate,"Senate: Reported from Finance and Appropriations (14-Y 0-N)",14,0,0,0,14
1811895,1369092,2024-01-25,Senate,"Senate: Constitutional reading dispensed (40-Y 0-N)",40,0,0,0,40
1811895,1370902,2024-01-29,Senate,"Senate: Read third time and passed Senate (38-Y 2-N)",38,2,0,0,40
1811895,1391160,2024-02-21,House,"House: Subcommittee recommends reporting (8-Y 0-N)",8,0,0,1,9
1811895,1393813,2024-02-23,House,"House: Reported from Courts of Justice (21-Y 0-N)",21,0,0,1,22
1811895,1398715,2024-02-28,House,"House: Reported from Appropriations (22-Y 0-N)",22,0,0,0,22
1811895,1402162,2024-03-04,House,"House: VOTE: Block Vote Passage (97-Y 0-N)",97,0,0,3,100
1811898,1368902,2024-01-24,Senate,"Senate: Reported from Courts of Justice (15-Y 0-N)",15,0,0,0,15
1811898,1369739,2024-01-26,Senate,"Senate: Constitutional reading dispensed (37-Y 0-N)",37,0,0,3,40
1811898,1372208,2024-01-30,Senate,"Senate: Read third time and passed Senate (40-Y 0-N)",40,0,0,0,40
1811898,1386274,2024-02-15,House,"House: Reported from General Laws (22-Y 0-N)",22,0,0,0,22
1811898,1388510,2024-02-20,House,"House: VOTE: Block Vote Passage (98-Y 0-N)",98,0,0,2,100
1811901,1368886,2024-01-24,Senate,"Senate: Reported from General Laws and Technology (15-Y 0-N)",15,0,0,0,15
1811901,1376867,2024-02-06,Senate,"Senate: Reported from Finance and Appropriations with amendment (15-Y 0-N)",15,0,0,0,15
1811901,1378067,2024-02-07,Senate,"Senate: Constitutional reading dispensed (40-Y 0-N)",40,0,0,0,40
1811901,1379691,2024-02-08,Senate,"Senate: Constitutional reading dispensed (40-Y 0-N)",40,0,0,0,40
1811901,1379692,2024-02-08,Senate,"Senate: Passed Senate (40-Y 0-N)",40,0,0,0,40
1811901,1387368,2024-02-19,House,"House: Reported from Communications, Technology and Innovation (19-Y 3-N)",19,3,0,0,22
1811901,1391729,2024-02-22,House,"House: VOTE: Passage (92-Y 5-N)",92,5,0,3,100
1811902,1379130,2024-02-08,Senate,"Senate: Reported from Education and Health with amendments (15-Y 0-N)",15,0,0,0,15
1811902,1381464,2024-02-12,Senate,"Senate: Reported from Finance and Appropriations (10-Y 5-N)",10,5,0,0,15
1811902,1381465,2024-02-12,Senate,"Senate: Constitutional reading dispensed (40-Y 0-N)",40,0,0,0,40
1811902,1383895,2024-02-13,Senate,"Senate: Constitutional reading dispensed (40-Y 0-N)",40,0,0,0,40
1811902,1383896,2024-02-13,Senate,"Senate: Passed Senate (34-Y 5-N)",34,5,0,1,40
1811902,1388300,2024-02-20,House,"House: Subcommittee recommends reporting (8-Y 0-N)",8,0,0,0,8
1811902,1389748,2024-02-21,House,"House: Reported from Education (22-Y 0-N)",22,0,0,0,22
1811902,1394459,2024-02-26,House,"House: VOTE: Passage (81-Y 12-N)",81,12,0,7,100
1811905,1368892,2024-01-24,Senate,"Senate: Reported from General Laws and Technology (14-Y 1-N)",14,1,0,0,15
1811905,1369989,2024-01-26,Senate,"Senate: Constitutional reading dispensed (37-Y 0-N)",37,0,0,3,40
1811905,1371550,2024-01-30,Senate,"Senate: Read third time and passed Senate (39-Y 1-N)",39,1,0,0,40
1811905,1389559,2024-02-20,House,"House: Subcommittee recommends reporting (8-Y 0-N)",8,0,0,0,8
1811905,1392830,2024-02-22,House,"House: Reported from General Laws with amendment(s) (22-Y 0-N)",22,0,0,0,22
1811905,1397084,2024-02-27,House,"House: VOTE: Block Vote Passage (97-Y 0-N)",97,0,0,3,100
1811905,1399111,2024-02-29,Senate,"Senate: House amendment rejected by Senate (0-Y 39-N)",0,39,0,1,40
1811905,1402832,2024-03-05,Senate,"Senate: Senate acceded to request (40-Y 0-N)",40,0,0,0,40
1811909,1376487,2024-02-05,Senate,"Senate: Continued to 2025 in Commerce and Labor (15-Y 0-N)",15,0,0,0,15
1811912,1368999,2024-01-25,Senate,"Senate: Passed by indefinitely in Education and Health (9-Y 6-N)",9,6,0,0,15
1811914,1369760,2024-01-26,Senate,"Senate: Reported from Rules (14-Y 0-N)",14,0,0,0,14
1811914,1370467,2024-01-29,Senate,"Senate: Constitutional reading dispensed (39-Y 0-N)",39,0,0,1,40
1811914,1372494,2024-01-31,Senate,"Senate: Read third time and passed Senate (40-Y 0-N)",40,0,0,0,40
1811914,1393239,2024-02-23,House,"House: Subcommittee recommends reporting (6-Y 0-N)",6,0,0,0,6
1811914,1393240,2024-02-23,House,"House: Reported from Rules (16-Y 0-N)",16,0,0,2,18
1811914,1398646,2024-02-28,House,"House: Reported from Appropriations (22-Y 0-N)",22,0,0,0,22
1811914,1401503,2024-03-04,House,"House: VOTE: Block Vote Passage (97-Y 0-N)",97,0,0,3,100
1811915,1374571,2024-02-01,Senate,"Senate: Reported from Transportation with substitute (9-Y 6-N)",9,6,0,0,15
1811915,1382577,2024-02-12,Senate,"Senate: Reported from Courts of Justice with substitute (6-Y 4-N 2-A)",6,4,2,0,12
1811915,1383098,2024-02-13,Senate,"Senate: Constitutional reading dispensed (40-Y 0-N)",40,0,0,0,40
1811915,1383099,2024-02-13,Senate,"Senate: Defeated by Senate (19-Y 21-N)",19,21,0,0,40
1811915,1383100,2024-02-13,Senate,"Senate: Constitutional reading dispensed (40-Y 0-N)",40,0,0,0,40
1811917,1367319,2024-01-22,Senate,"Senate: Reported from Commerce and Labor with substitute (15-Y 0-N)",15,0,0,0,15
1811917,1368582,2024-01-24,Senate,"Senate: Constitutional reading dispensed (40-Y 0-N)",40,0,0,0,40
1811917,1369742,2024-01-26,Senate,"Senate: Read third time and passed Senate (38-Y 0-N)",38,0,0,2,40
1811917,1385475,2024-02-15,House,"House: Reported from Labor and Commerce (19-Y 0-N)",19,0,0,3,22
1811917,1388512,2024-02-20,House,"House: VOTE: Block Vote Passage (98-Y 0-N)",98,0,0,2,100
1811922,1373811,2024-01-31,Senate,"Senate: Reported from Courts of Justice with substitute (10-Y 5-N)",10,5,0,0,15
1811922,1378505,2024-02-07,Senate,"Senate: Continued to 2025 in Finance and Appropriations (14-Y 0-N 1-A)",14,0,1,0,15
1811925,1375669,2024-02-05,House,"House: Subcommittee recommends striking from docket (8-Y 0-N)",8,0,0,1,9
1811926,1380873,2024-02-09,Senate,"Senate: Reading waived (39-Y 0-N)",39,0,0,1,40
1811926,1381631,2024-02-12,Senate,"Senate: Reading waived (39-Y 0-N)",39,0,0,1,40
1811926,1393212,2024-02-23,House,"House: Subcommittee recommends reporting (6-Y 0-N)",6,0,0,0,6
1811926,1393213,2024-02-23,House,"House: Reported from Rules (16-Y 0-N)",16,0,0,2,18
1811926,1398433,2024-02-28,House,"House: Reported from Appropriations with substitute (22-Y 0-N)",22,0,0,0,22
1811926,1401757,2024-03-04,House,"House: VOTE: Block Vote Adoption (97-Y 0-N)",97,0,0,3,100
1811928,1377447,2024-02-06,Senate,"Senate: Reported from Finance and Appropriations (15-Y 0-N)",15,0,0,0,15
1811928,1378090,2024-02-07,Senate,"Senate: Constitutional reading dispensed (40-Y 0-N)",40,0,0,0,40
1811928,1380216,2024-02-08,Senate,"Senate: Constitutional reading dispensed (40-Y 0-N)",40,0,0,0,40
1811928,1380217,2024-02-08,Senate,"Senate: Read third time and passed Senate (40-Y 0-N)",40,0,0,0,40
1811928,1387688,2024-02-19,House,"House: Reported from Appropriations (22-Y 0-N)",22,0,0,0,22
1811928,1392974,2024-02-22,House,"House: VOTE: Block Vote Passage (99-Y 0-N)",99,0,0,1,100
1811930,1370760,2024-01-29,Senate,"Senate: Reported from Courts of Justice with amendments (15-Y 0-N)",15,0,0,0,15
1811930,1378485,2024-02-07,Senate,"Senate: Reported from Finance and Appropriations with substitute (15-Y 0-N)",15,0,0,0,15
1811930,1379956,2024-02-08,Senate,"Senate: Constitutional reading dispensed (40-Y 0-N)",40,0,0,0,40
1811930,1381188,2024-02-09,Senate,"Senate: Constitutional reading dispensed (40-Y 0-N)",40,0,0,0,40
1811930,1381189,2024-02-09,Senate,"Senate: Passed Senate (40-Y 0-N)",40,0,0,0,40
1811933,1367428,2024-01-22,Senate,"Senate: Reported from Commerce and Labor (8-Y 6-N)",8,6,0,0,14
1811933,1372763,2024-01-31,Senate,"Senate: Continued to 2025 in Finance and Appropriations (15-Y 0-N)",15,0,0,0,15
1811934,1366610,2024-01-18,Senate,"Senate: Reported from Transportation (15-Y 0-N)",15,0,0,0,15
1811934,1368921,2024-01-22,Senate,"Senate: Constitutional reading dispensed (40-Y 0-N)",40,0,0,0,40
1811934,1368922,2024-01-24,Senate,"Senate: Read third time and passed Senate (40-Y 0-N)",40,0,0,0,40
1811934,1388362,2024-02-20,House,"House: Subcommittee recommends reporting (8-Y 0-N)",8,0,0,0,8
1811934,1388363,2024-02-20,House,"House: Subcommittee recommends reporting (8-Y 0-N)",8,0,0,0,8
1811934,1391989,2024-02-22,House,"House: Reported from Transportation (22-Y 0-N)",22,0,0,0,22
1811934,1396083,2024-02-27,House,"House: VOTE: Block Vote Passage (97-Y 0-N)",97,0,0,3,100
1811938,1370835,2024-01-29,Senate,"Senate: Continued to 2025 in Commerce and Labor (15-Y 0-N)",15,0,0,0,15
1811941,1369743,2024-01-26,Senate,"Senate: Reported from Rehabilitation and Social Services with amendments (15-Y 0-N)",15,0,0,0,15
1811941,1379761,2024-02-08,Senate,"Senate: Reported from Finance and Appropriations with substitute (15-Y 0-N)",15,0,0,0,15
1811941,1380657,2024-02-09,Senate,"Senate: Constitutional reading dispensed (39-Y 0-N)",39,0,0,1,40
1811941,1381877,2024-02-12,Senate,"Senate: Constitutional reading dispensed (40-Y 0-N)",40,0,0,0,40
1811941,1381878,2024-02-12,Senate,"Senate: Passed Senate (40-Y 0-N)",40,0,0,0,40
1811941,1391441,2024-02-22,House,"House: Reported from Health and Human Services with substitute (21-Y 0-N)",21,0,0,1,22
1811942,1371455,2024-01-30,Senate,"Senate: Reported from Finance and Appropriations with substitute (10-Y 5-N)",10,5,0,0,15
1811942,1372518,2024-01-31,Senate,"Senate: Constitutional reading dispensed (40-Y 0-N)",40,0,0,0,40
1811942,1376114,2024-02-05,Senate,"Senate: Read third time and passed Senate (21-Y 19-N)",21,19,0,0,40
1811942,1388534,2024-02-20,House,"House: Subcommittee recommends reporting (5-Y 3-N)",5,3,0,0,8
1811942,1390026,2024-02-21,House,"House: Reported from Finance (12-Y 10-N)",12,10,0,0,22
1811942,1394447,2024-02-26,House,"House: VOTE: Passage (51-Y 43-N 1-A)",51,43,1,5,100
1811944,1379052,2024-02-08,Senate,"Senate: Reported from Education and Health with substitute (15-Y 0-N)",15,0,0,0,15
1811944,1379473,2024-02-08,Senate,"Senate: Constitutional reading dispensed (40-Y 0-N)",40,0,0,0,40
1811944,1380889,2024-02-09,Senate,"Senate: Constitutional reading dispensed (40-Y 0-N)",40,0,0,0,40
1811944,1380890,2024-02-09,Senate,"Senate: Passed Senate (40-Y 0-N)",40,0,0,0,40
1811944,1395567,2024-02-27,House,"House: Subcommittee recommends reporting with substitute (8-Y 0-N)",8,0,0,1,9
1811944,1395568,2024-02-27,House,"House: Reported from Health and Human Services with substitute (21-Y 0-N)",21,0,0,1,22
1811944,1400550,2024-03-01,House,"House: VOTE: Block Vote Passage (97-Y 0-N)",97,0,0,3,100
1811944,1402828,2024-03-05,Senate,"Senate: House substitute agreed to by Senate (40-Y 0-N)",40,0,0,0,40
1811946,1380965,2024-02-09,Senate,"Senate: Reported from Commerce and Labor (15-Y 0-N)",15,0,0,0,15
1811946,1380966,2024-02-09,Senate,"Senate: Constitutional reading dispensed (39-Y 0-N)",39,0,0,1,40
1811946,1382248,2024-02-12,Senate,"Senate: Constitutional reading dispensed (40-Y 0-N)",40,0,0,0,40
1811946,1382249,2024-02-12,Senate,"Senate: Passed Senate (40-Y 0-N)",40,0,0,0,40
1811946,1393243,2024-02-23,House,"House: Subcommittee recommends reporting (6-Y 0-N)",6,0,0,0,6
1811946,1393244,2024-02-23,House,"House: Reported from Rules (16-Y 0-N)",16,0,0,2,18
1811946,1398515,2024-02-28,House,"House: Reported from Appropriations (22-Y 0-N)",22,0,0,0,22
1811946,1402416,2024-03-04,House,"House: VOTE: Block Vote Passage (97-Y 0-N)",97,0,0,3,100
1811947,1373708,2024-02-01,Senate,"Senate: Reported from Education and Health (15-Y 0-N)",15,0,0,0,15
1811947,1379750,2024-02-08,Senate,"Senate: Incorporated by Finance and Appropriations ",15,0,0,0,15
1811949,1367232,2024-01-22,Senate,"Senate: Reported from Commerce and Labor with substitute (14-Y 0-N)",14,0,0,0,14
1811949,1377883,2024-02-07,Senate,"Senate: Reported from Finance and Appropriations with amendment (15-Y 0-N)",15,0,0,0,15
1811949,1379804,2024-02-08,Senate,"Senate: Constitutional reading dispensed (40-Y 0-N)",40,0,0,0,40
1811949,1380618,2024-02-09,Senate,"Senate: Constitutional reading dispensed (40-Y 0-N)",40,0,0,0,40
1811949,1380619,2024-02-09,Senate,"Senate: Read third time and passed Senate (40-Y 0-N)",40,0,0,0,40
1811949,1389292,2024-02-20,House,"House: Reported from Labor and Commerce with amendment(s) (12-Y 9-N)",12,9,0,1,22
1811949,1393344,2024-02-23,House,"House: VOTE: Passage (52-Y 46-N)",52,46,0,2,100
1811949,1396260,2024-02-27,Senate,"Senate: House amendments rejected by Senate (1-Y 38-N)",1,38,0,1,40
1811949,1400607,2024-03-01,Senate,"Senate: Senate acceded to request (40-Y 0-N)",40,0,0,0,40
1811949,1404170,2024-03-06,House,"House: VOTE: Adoption (52-Y 45-N)",52,45,0,3,100
1811949,1405681,2024-03-07,Senate,"Senate: Conference report agreed to by Senate (40-Y 0-N)",40,0,0,0,40
1811955,1369718,2024-01-25,Senate,"Senate: Reported from Transportation (15-Y 0-N)",15,0,0,0,15
1811955,1377102,2024-02-06,Senate,"Senate: Reported from Finance and Appropriations (15-Y 0-N)",15,0,0,0,15
1811955,1378038,2024-02-07,Senate,"Senate: Constitutional reading dispensed (40-Y 0-N)",40,0,0,0,40
1811955,1380232,2024-02-08,Senate,"Senate: Constitutional reading dispensed (40-Y 0-N)",40,0,0,0,40
1811955,1380233,2024-02-08,Senate,"Senate: Read third time and passed Senate (40-Y 0-N)",40,0,0,0,40
1811955,1391514,2024-02-22,House,"House: Reported from Transportation (22-Y 0-N)",22,0,0,0,22
1811955,1396670,2024-02-27,House,"House: VOTE: Block Vote Passage (97-Y 0-N)",97,0,0,3,100
1811956,1378319,2024-02-07,Senate,"Senate: Continued to 2025 in Finance and Appropriations (11-Y 4-N)",11,4,0,0,15
1811959,1378905,2024-02-07,Senate,"Senate: Continued to 2025 in Courts of Justice (13-Y 2-N)",13,2,0,0,15
1811961,1379040,2024-02-08,Senate,"Senate: Passed by indefinitely in Education and Health (8-Y 7-N)",8,7,0,0,15
1811963,1367358,2024-01-22,Senate,"Senate: Reported from Local Government (15-Y 0-N)",15,0,0,0,15
1811963,1368935,2024-01-23,Senate,"Senate: Constitutional reading dispensed (39-Y 0-N)",39,0,0,1,40
1811963,1369093,2024-01-25,Senate,"Senate: Read third time and passed Senate (40-Y 0-N)",40,0,0,0,40
1811963,1387058,2024-02-16,House,"House: Reported from Counties, Cities and Towns (22-Y 0-N)",22,0,0,0,22
1811963,1390027,2024-02-21,House,"House: VOTE: Block Vote Passage (100-Y 0-N)",100,0,0,0,100
1811964,1370512,2024-01-29,Senate,"Senate: Reported from Courts of Justice with amendments (14-Y 0-N)",14,0,0,0,14
1811964,1371705,2024-01-30,Senate,"Senate: Constitutional reading dispensed (40-Y 0-N)",40,0,0,0,40
1811964,1373827,2024-02-01,Senate,"Senate: Read third time and passed Senate (40-Y 0-N)",40,0,0,0,40
1811964,1386995,2024-02-16,House,"House: Reported from Courts of Justice (21-Y 1-N)",21,1,0,0,22
1811964,1390058,2024-02-21,House,"House: VOTE: Passage (99-Y 0-N)",99,0,0,1,100
1811968,1378515,2024-02-07,Senate,"Senate: Reported from Finance and Appropriations with substitute (15-Y 0-N)",15,0,0,0,15
1811968,1379270,2024-02-08,Senate,"Senate: Constitutional reading dispensed (40-Y 0-N)",40,0,0,0,40
1811968,1381050,2024-02-09,Senate,"Senate: Constitutional reading dispensed (40-Y 0-N)",40,0,0,0,40
1811968,1381051,2024-02-09,Senate,"Senate: Passed Senate (38-Y 1-N)",38,1,0,1,40
1811968,1393124,2024-02-23,House,"House: Subcommittee recommends reporting (6-Y 0-N)",6,0,0,0,6
1811968,1393296,2024-02-23,House,"House: Reported from Rules (16-Y 0-N)",16,0,0,2,18
1811968,1398693,2024-02-28,House,"House: Reported from Appropriations (21-Y 0-N)",21,0,0,1,22
1811968,1401587,2024-03-04,House,"House: VOTE: Passage (86-Y 12-N)",86,12,0,2,100
1811970,1382987,2024-02-12,Senate,"Senate: Reported from Courts of Justice (13-Y 0-N)",13,0,0,0,13
1811970,1382988,2024-02-13,Senate,"Senate: Constitutional reading dispensed (40-Y 0-N)",40,0,0,0,40
1811970,1382989,2024-02-13,Senate,"Senate: Passed Senate (40-Y 0-N)",40,0,0,0,40
1811970,1382990,2024-02-13,Senate,"Senate: Constitutional reading dispensed (40-Y 0-N)",40,0,0,0,40
1811970,1394025,2024-02-23,House,"House: Reported from Courts of Justice (21-Y 0-N)",21,0,0,1,22
1811970,1398793,2024-02-28,House,"House: VOTE: Block Vote Passage (97-Y 0-N)",97,0,0,3,100
1811972,1366632,2024-01-18,Senate,"Senate: Reported from Transportation with amendment (15-Y 0-N)",15,0,0,0,15
1811972,1368359,2024-01-22,Senate,"Senate: Constitutional reading dispensed (40-Y 0-N)",40,0,0,0,40
1811972,1368360,2024-01-24,Senate,"Senate: Read third time and passed Senate (40-Y 0-N)",40,0,0,0,40
1811972,1391351,2024-02-22,House,"House: Reported from Transportation (22-Y 0-N)",22,0,0,0,22
1811972,1395971,2024-02-27,House,"House: VOTE: Block Vote Passage (97-Y 0-N)",97,0,0,3,100
1811975,1375608,2024-02-05,Senate,"Senate: Reported from Courts of Justice (15-Y 0-N)",15,0,0,0,15
1811975,1376950,2024-02-06,Senate,"Senate: Constitutional reading dispensed (39-Y 0-N)",39,0,0,1,40
1811975,1378700,2024-02-07,Senate,"Senate: Constitutional reading dispensed (40-Y 0-N)",40,0,0,0,40
1811975,1378701,2024-02-07,Senate,"Senate: Passed Senate (40-Y 0-N)",40,0,0,0,40
1811975,1386805,2024-02-16,House,"House: Reported from Courts of Justice (22-Y 0-N)",22,0,0,0,22
1811975,1390653,2024-02-21,House,"House: VOTE: Block Vote Passage (100-Y 0-N)",100,0,0,0,100
1811976,1370462,2024-01-29,Senate,"Senate: Reading waived (40-Y 0-N)",40,0,0,0,40
1811976,1393945,2024-02-23,House,"House: Reported from Rules (17-Y 0-N)",17,0,0,1,18
1811976,1398548,2024-02-28,House,"House: VOTE: Block Vote Adoption (99-Y 0-N)",99,0,0,1,100
1811976,1398549,2024-02-28,House,"House: VOTE: Block Vote Adoption #2 (99-Y 0-N)",99,0,0,1,100
1811978,1368974,2024-01-25,Senate,"Senate: Reported from Education and Health (15-Y 0-N)",15,0,0,0,15
1811978,1369781,2024-01-26,Senate,"Senate: Constitutional reading dispensed (37-Y 0-N)",37,0,0,3,40
1811978,1371544,2024-01-30,Senate,"Senate: Read third time and passed Senate (40-Y 0-N)",40,0,0,0,40
1811978,1385637,2024-02-15,House,"House: Reported from Health and Human Services (22-Y 0-N)",22,0,0,0,22
1811978,1388533,2024-02-20,House,"House: VOTE: Block Vote Passage (98-Y 0-N)",98,0,0,2,100
1811981,1368770,2024-01-24,Senate,"Senate: Reported from General Laws and Technology with amendments (15-Y 0-N)",15,0,0,0,15
1811981,1372803,2024-01-31,Senate,"Senate: Reported from Finance and Appropriations with substitute (15-Y 0-N)",15,0,0,0,15
1811981,1374177,2024-02-01,Senate,"Senate: Constitutional reading dispensed (40-Y 0-N)",40,0,0,0,40
1811981,1377420,2024-02-06,Senate,"Senate: Read third time and passed Senate (39-Y 0-N)",39,0,0,1,40
1811981,1394339,2024-02-26,House,"House: Reported from Communications, Technology and Innovation (15-Y 4-N)",15,4,0,3,22
1811981,1397566,2024-02-28,House,"House: Reported from Appropriations with substitute (22-Y 0-N)",22,0,0,0,22
1811981,1401689,2024-03-04,House,"House: VOTE: Passage (89-Y 7-N)",89,7,0,4,100
1811981,1403585,2024-03-05,Senate,"Senate: House substitute agreed to by Senate (34-Y 5-N)",34,5,0,1,40
1811983,1370486,2024-01-29,Senate,"Senate: Reading waived (40-Y 0-N)",40,0,0,0,40
1811983,1393307,2024-02-23,House,"House: Reported from Rules (17-Y 0-N)",17,0,0,1,18
1811985,1367492,2024-01-22,Senate,"Senate: Reported from Commerce and Labor (9-Y 5-N)",9,5,0,0,14
1811985,1372808,2024-01-31,Senate,"Senate: Reported from Finance and Appropriations (11-Y 4-N)",11,4,0,0,15
1811985,1374215,2024-02-01,Senate,"Senate: Constitutional reading dispensed (40-Y 0-N)",40,0,0,0,40
1811985,1375893,2024-02-05,Senate,"Senate: Read third time and passed Senate (21-Y 19-N)",21,19,0,0,40
1811985,1385461,2024-02-15,House,"House: Reported from Labor and Commerce (10-Y 9-N)",10,9,0,3,22
1811985,1389181,2024-02-20,House,"House: VOTE: Passage (51-Y 47-N)",51,47,0,2,100
1811987,1380507,2024-02-09,Senate,"Senate: Continued to 2025 in Commerce and Labor (15-Y 0-N)",15,0,0,0,15
1811989,1366242,2024-01-17,Senate,"Senate: Rereferred from Courts of Justice (11-Y 0-N)",11,0,0,0,11
1811989,1368949,2024-01-24,Senate,"Senate: Reported from General Laws and Technology with substitute (15-Y 0-N)",15,0,0,0,15
1811989,1369964,2024-01-26,Senate,"Senate: Constitutional reading dispensed (37-Y 0-N)",37,0,0,3,40
1811989,1371548,2024-01-30,Senate,"Senate: Read third time and passed Senate (40-Y 0-N)",40,0,0,0,40
1811989,1386261,2024-02-15,House,"House: Reported from General Laws with substitute (22-Y 0-N)",22,0,0,0,22
1811989,1388508,2024-02-20,House,"House: VOTE: Block Vote Passage (98-Y 0-N)",98,0,0,2,100
1811989,1392715,2024-02-22,Senate,"Senate: House substitute agreed to by Senate (40-Y 0-N)",40,0,0,0,40
1811990,1366332,2024-01-17,Senate,"Senate: Incorporated by Courts of Justice ",15,0,0,0,15
1811995,1366959,2024-01-19,Senate,"Senate: Incorporated by Rehabilitation and Social Services ",11,0,0,0,11
1811997,1366889,2024-01-19,Senate,"Senate: Reported from Rehabilitation and Social Services with substitute (15-Y 0-N)",15,0,0,0,15
1811997,1372833,2024-01-31,Senate,"Senate: Reported from Finance and Appropriations with substitute (13-Y 2-N)",13,2,0,0,15
1811997,1374178,2024-02-01,Senate,"Senate: Constitutional reading dispensed (40-Y 0-N)",40,0,0,0,40
1811997,1377413,2024-02-06,Senate,"Senate: Read third time and passed Senate (37-Y 2-N)",37,2,0,1,40
1811997,1393165,2024-02-23,House,"House: Reported from Public Safety with substitute (21-Y 0-N)",21,0,0,1,22
1811997,1397571,2024-02-28,House,"House: Reported from Appropriations with substitute (22-Y 0-N)",22,0,0,0,22
1811997,1401741,2024-03-04,House,"House: VOTE: Block Vote Passage (97-Y 0-N)",97,0,0,3,100
1811997,1402829,2024-03-05,Senate,"Senate: House substitute agreed to by Senate (40-Y 0-N)",40,0,0,0,40
1812001,1368914,2024-01-24,Senate,"Senate: Reported from Courts of Justice with substitute (14-Y 1-N)",14,1,0,0,15
1812001,1372704,2024-01-31,Senate,"Senate: Reported from Finance and Appropriations (15-Y 0-N)",15,0,0,0,15
1812001,1374182,2024-02-01,Senate,"Senate: Constitutional reading dispensed (40-Y 0-N)",40,0,0,0,40
1812001,1376282,2024-02-05,Senate,"Senate: Read third time and passed Senate (35-Y 3-N)",35,3,0,2,40
1812001,1376283,2024-02-05,Senate,"Senate: Reconsideration of passage agreed to by Senate (39-Y 0-N)",39,0,0,1,40
1812001,1376284,2024-02-05,Senate,"Senate: Passed Senate (34-Y 6-N)",34,6,0,0,40
1812001,1390840,2024-02-21,House,"House: Subcommittee recommends laying on the table (5-Y 3-N)",5,3,0,1,9
1812003,1379756,2024-02-08,Senate,"Senate: Reported from Education and Health with substitute (9-Y 6-N)",9,6,0,0,15
1812003,1379757,2024-02-08,Senate,"Senate: Constitutional reading dispensed (40-Y 0-N)",40,0,0,0,40
1812003,1381636,2024-02-12,Senate,"Senate: Read third time and passed Senate (21-Y 19-N)",21,19,0,0,40
1812003,1397275,2024-02-28,House,"House: Reported from Education with substitute (12-Y 10-N)",12,10,0,0,22
1812003,1402061,2024-03-04,House,"House: VOTE: Passage (51-Y 47-N)",51,47,0,2,100
1812003,1403154,2024-03-05,Senate,"Senate: House substitute rejected by Senate (0-Y 39-N)",0,39,0,1,40
1812003,1405265,2024-03-07,Senate,"Senate: Senate acceded to request (40-Y 0-N)",40,0,0,0,40
1812003,1406709,2024-03-09,House,"House: VOTE: Adoption (49-Y 46-N)",49,46,0,5,100
1812003,1406710,2024-03-09,Senate,"Senate: Conference report agreed to by Senate (21-Y 19-N)",21,19,0,0,40
1812006,1380559,2024-02-09,Senate,"Senate: Continued to 2025 in Commerce and Labor (15-Y 0-N)",15,0,0,0,15
1812007,1366601,2024-01-18,Senate,"Senate: Reported from Education and Health with amendments (15-Y 0-N)",15,0,0,0,15
1812007,1368194,2024-01-24,Senate,"Senate: Stricken at request of Patron in Finance and Appropriations (13-Y 0-N)",13,0,0,0,13
1812009,1368008,2024-01-23,Senate,"Senate: Reported from Agriculture, Conservation and Natural Resources with amendment (15-Y 0-N)",15,0,0,0,15
1812009,1371562,2024-01-30,Senate,"Senate: Reported from Finance and Appropriations (15-Y 0-N)",15,0,0,0,15
1812009,1372951,2024-01-31,Senate,"Senate: Constitutional reading dispensed (40-Y 0-N)",40,0,0,0,40
1812009,1432137,2024-02-26,House,"House: Tabled in Appropriations (22-Y 0-N)",22,0,0,0,22
1812013,1379054,2024-02-08,Senate,"Senate: Reported from Education and Health with substitute (15-Y 0-N)",15,0,0,0,15
1812013,1381376,2024-02-12,Senate,"Senate: Reported from Finance and Appropriations with substitute (15-Y 0-N)",15,0,0,0,15
1812013,1382081,2024-02-12,Senate,"Senate: Constitutional reading dispensed (40-Y 0-N)",40,0,0,0,40
1812013,1383576,2024-02-13,Senate,"Senate: Constitutional reading dispensed (39-Y 0-N)",39,0,0,1,40
1812013,1383577,2024-02-13,Senate,"Senate: Passed Senate (40-Y 0-N)",40,0,0,0,40
1812013,1387586,2024-02-19,House,"House: Reported from Appropriations with substitute (22-Y 0-N)",22,0,0,0,22
1812013,1392090,2024-02-22,House,"House: VOTE: Block Vote Passage (99-Y 0-N)",99,0,0,1,100
1812013,1394912,2024-02-26,Senate,"Senate: House substitute rejected by Senate (0-Y 40-N)",0,40,0,0,40
1812013,1399514,2024-02-29,Senate,"Senate: Senate acceded to request (39-Y 0-N)",39,0,0,1,40
1812013,1406448,2024-03-08,House,"House: VOTE: Adoption (95-Y 0-N)",95,0,0,5,100
1812013,1406706,2024-03-09,Senate,"Senate: Conference report agreed to by Senate (40-Y 0-N)",40,0,0,0,40
1812014,1377103,2024-02-06,Senate,"Senate: Incorporated by Finance and Appropriations ",15,0,0,0,15
1812018,1368893,2024-01-24,Senate,"Senate: Reported from General Laws and Technology (15-Y 0-N)",15,0,0,0,15
1812018,1376946,2024-02-06,Senate,"Senate: Reported from Finance and Appropriations (15-Y 0-N)",15,0,0,0,15
1812018,1378062,2024-02-07,Senate,"Senate: Constitutional reading dispensed (40-Y 0-N)",40,0,0,0,40
1812018,1379237,2024-02-08,Senate,"Senate: Constitutional reading dispensed (40-Y 0-N)",40,0,0,0,40
1812018,1379238,2024-02-08,Senate,"Senate: Passed Senate (40-Y 0-N)",40,0,0,0,40
1812018,1386272,2024-02-15,House,"House: Reported from General Laws (22-Y 0-N)",22,0,0,0,22
1812018,1389276,2024-02-20,House,"House: VOTE: Block Vote Passage (98-Y 0-N)",98,0,0,2,100
1812020,1368779,2024-01-24,Senate,"Senate: Reported from Courts of Justice with substitute (11-Y 4-N)",11,4,0,0,15
1812020,1378529,2024-02-07,Senate,"Senate: Continued to 2025 in Finance and Appropriations (15-Y 0-N)",15,0,0,0,15
1812021,1377123,2024-02-06,Senate,"Senate: Reported from Finance and Appropriations with amendment (15-Y 0-N)",15,0,0,0,15
1812021,1378020,2024-02-07,Senate,"Senate: Constitutional reading dispensed (40-Y 0-N)",40,0,0,0,40
1812021,1379248,2024-02-08,Senate,"Senate: Constitutional reading dispensed (40-Y 0-N)",40,0,0,0,40
1812021,1379249,2024-02-08,Senate,"Senate: Read third time and passed Senate (40-Y 0-N)",40,0,0,0,40
1812021,1387661,2024-02-19,House,"House: Reported from Appropriations (22-Y 0-N)",22,0,0,0,22
1812021,1392980,2024-02-22,House,"House: VOTE: Block Vote Passage (99-Y 0-N)",99,0,0,1,100
1812023,1368911,2024-01-24,Senate,"Senate: Reported from Courts of Justice (15-Y 0-N)",15,0,0,0,15
1812023,1370000,2024-01-26,Senate,"Senate: Constitutional reading dispensed (37-Y 0-N)",37,0,0,3,40
1812023,1372246,2024-01-30,Senate,"Senate: Read third time and passed Senate (40-Y 0-N)",40,0,0,0,40
1812023,1384802,2024-02-14,House,"House: Subcommittee recommends reporting (8-Y 0-N)",8,0,0,1,9
1812023,1386640,2024-02-16,House,"House: Reported from Courts of Justice (22-Y 0-N)",22,0,0,0,22
1812023,1391115,2024-02-21,House,"House: VOTE: Block Vote Passage (100-Y 0-N)",100,0,0,0,100
1812025,1374684,2024-02-02,Senate,"Senate: Reported from Rules with amendment (14-Y 0-N)",14,0,0,0,14
1812025,1378224,2024-02-07,Senate,"Senate: Reported from Finance and Appropriations with substitute (15-Y 0-N)",15,0,0,0,15
1812025,1379243,2024-02-08,Senate,"Senate: Constitutional reading dispensed (40-Y 0-N)",40,0,0,0,40
1812025,1381134,2024-02-09,Senate,"Senate: Constitutional reading dispensed (40-Y 0-N)",40,0,0,0,40
1812025,1381135,2024-02-09,Senate,"Senate: Passed Senate (40-Y 0-N)",40,0,0,0,40
1812025,1393245,2024-02-23,House,"House: Subcommittee recommends reporting (6-Y 0-N)",6,0,0,0,6
1812025,1393246,2024-02-23,House,"House: Reported from Rules (16-Y 0-N)",16,0,0,2,18
1812025,1397613,2024-02-28,House,"House: Reported from Appropriations (22-Y 0-N)",22,0,0,0,22
1812025,1401851,2024-03-04,House,"House: VOTE: Passage (83-Y 15-N)",83,15,0,2,100
1812028,1367762,2024-01-23,Senate,"Senate: Reported from Privileges and Elections with amendment (14-Y 0-N)",14,0,0,0,14
1812028,1369535,2024-01-25,Senate,"Senate: Constitutional reading dispensed (40-Y 0-N)",40,0,0,0,40
1812028,1370796,2024-01-29,Senate,"Senate: Read third time and passed Senate (40-Y 0-N)",40,0,0,0,40
1812028,1386606,2024-02-16,House,"House: Reported from Privileges and Elections (18-Y 3-N)",18,3,0,1,22
1812028,1390311,2024-02-21,House,"House: VOTE: Passage (94-Y 6-N)",94,6,0,0,100
1812031,1378991,2024-02-07,Senate,"Senate: Reported from General Laws and Technology with amendments (15-Y 0-N)",15,0,0,0,15
1812031,1379260,2024-02-08,Senate,"Senate: Constitutional reading dispensed (40-Y 0-N)",40,0,0,0,40
1812031,1381194,2024-02-09,Senate,"Senate: Constitutional reading dispensed (40-Y 0-N)",40,0,0,0,40
1812031,1381195,2024-02-09,Senate,"Senate: Passed Senate (40-Y 0-N)",40,0,0,0,40
1812031,1389060,2024-02-20,House,"House: Reported from General Laws (21-Y 0-N)",21,0,0,1,22
1812031,1393695,2024-02-23,House,"House: VOTE: Block Vote Passage (98-Y 0-N)",98,0,0,2,100
1812032,1382911,2024-02-12,Senate,"Senate: Reported from Courts of Justice (14-Y 0-N)",14,0,0,0,14
1812032,1383897,2024-02-13,Senate,"Senate: Constitutional reading dispensed (40-Y 0-N)",40,0,0,0,40
1812032,1383898,2024-02-13,Senate,"Senate: Passed Senate (40-Y 0-N)",40,0,0,0,40
1812032,1383899,2024-02-13,Senate,"Senate: Constitutional reading dispensed (40-Y 0-N)",40,0,0,0,40
1812032,1386707,2024-02-16,House,"House: Subcommittee recommends reporting (8-Y 0-N)",8,0,0,1,9
1812032,1394000,2024-02-23,House,"House: Reported from Courts of Justice (20-Y 0-N)",20,0,0,2,22
1812032,1398233,2024-02-28,House,"House: VOTE: Block Vote Passage (97-Y 0-N)",97,0,0,3,100
1812034,1368876,2024-01-24,Senate,"Senate: Passed by indefinitely in Courts of Justice (9-Y 5-N)",9,5,0,0,14
1812036,1375602,2024-02-05,Senate,"Senate: Reported from Local Government with amendments (10-Y 3-N 2-A)",10,3,2,0,15
1812036,1377476,2024-02-06,Senate,"Senate: Constitutional reading dispensed (39-Y 0-N)",39,0,0,1,40
1812036,1381005,2024-02-09,Senate,"Senate: Read third time and passed Senate (29-Y 9-N 1-A)",29,9,1,1,40
1812036,1395549,2024-02-27,House,"House: Subcommittee recommends laying on the table (4-Y 2-N)",4,2,0,3,9
1812039,1373451,2024-01-31,Senate,"Senate: Reported from General Laws and Technology with substitute (15-Y 0-N)",15,0,0,0,15
1812039,1376849,2024-02-06,Senate,"Senate: Reported from Finance and Appropriations (10-Y 5-N)",10,5,0,0,15
1812039,1378354,2024-02-07,Senate,"Senate: Constitutional reading dispensed (40-Y 0-N)",40,0,0,0,40
1812039,1381837,2024-02-12,Senate,"Senate: Read third time and passed Senate (39-Y 0-N)",39,0,0,1,40
1812039,1389304,2024-02-20,House,"House: Reported from Labor and Commerce (20-Y 2-N)",20,2,0,0,22
1812039,1394012,2024-02-23,House,"House: VOTE: Passage (98-Y 0-N)",98,0,0,2,100
1812040,1368755,2024-01-24,Senate,"Senate: Reported from General Laws and Technology with amendment (15-Y 0-N)",15,0,0,0,15
1812040,1372819,2024-01-31,Senate,"Senate: Incorporated by Finance and Appropriations ",15,0,0,0,15
1812043,1373174,2024-01-31,Senate,"Senate: Continued to 2025 in General Laws and Technology (8-Y 7-N)",8,7,0,0,15
1812047,1378688,2024-02-07,Senate,"Senate: Continued to 2025 in General Laws and Technology (9-Y 6-N)",9,6,0,0,15
1812050,1380573,2024-02-09,Senate,"Senate: Reported from Commerce and Labor (8-Y 7-N)",8,7,0,0,15
1812050,1381081,2024-02-09,Senate,"Senate: Constitutional reading dispensed (39-Y 0-N)",39,0,0,1,40
1812050,1383587,2024-02-13,Senate,"Senate: Read third time and passed Senate (21-Y 19-N)",21,19,0,0,40
1812050,1396059,2024-02-27,House,"House: Subcommittee recommends reporting with amendments (6-Y 4-N)",6,4,0,1,11
1812050,1396060,2024-02-27,House,"House: Reported from Labor and Commerce with amendment(s) (11-Y 10-N)",11,10,0,1,22
1812050,1400534,2024-03-01,House,"House: VOTE: Passage (50-Y 47-N)",50,47,0,3,100
1812050,1403557,2024-03-05,Senate,"Senate: House amendment agreed to by Senate (21-Y 19-N)",21,19,0,0,40
1812053,1380519,2024-02-09,Senate,"Senate: Reported from Commerce and Labor with substitute (9-Y 6-N)",9,6,0,0,15
1812053,1380937,2024-02-09,Senate,"Senate: Constitutional reading dispensed (39-Y 0-N)",39,0,0,1,40
1812053,1383032,2024-02-13,Senate,"Senate: Read third time and passed Senate (20-Y 19-N)",20,19,0,1,40
1812053,1383033,2024-02-13,Senate,"Senate: Reconsideration of passage agreed to by Senate (39-Y 0-N)",39,0,0,1,40
1812053,1383034,2024-02-13,Senate,"Senate: Passed Senate (21-Y 18-N)",21,18,0,1,40
1812053,1396216,2024-02-27,House,"House: Reported from Labor and Commerce with substitute (18-Y 3-N)",18,3,0,1,22
1812053,1400626,2024-03-01,House,"House: VOTE: Passage (85-Y 12-N)",85,12,0,3,100
1812053,1403040,2024-03-05,Senate,"Senate: House substitute agreed to by Senate (23-Y 17-N)",23,17,0,0,40
1812053,1429776,2024-04-17,Senate,"Senate: Senate concurred in Governor's recommendation (37-Y 3-N)",37,3,0,0,40
1812053,1429777,2024-04-17,House,"House: VOTE: Adoption (92-Y 5-N)",92,5,0,3,100
1812054,1375652,2024-02-05,Senate,"Senate: Reported from Courts of Justice with substitute (9-Y 6-N)",9,6,0,0,15
1812054,1378096,2024-02-07,Senate,"Senate: Reported from Finance and Appropriations (9-Y 5-N 1-A)",9,5,1,0,15
1812054,1379799,2024-02-08,Senate,"Senate: Constitutional reading dispensed (40-Y 0-N)",40,0,0,0,40
1812054,1383783,2024-02-13,Senate,"Senate: Constitutional reading dispensed (40-Y 0-N)",40,0,0,0,40
1812054,1383784,2024-02-13,Senate,"Senate: Passed Senate (21-Y 19-N)",21,19,0,0,40
1812054,1390806,2024-02-21,House,"House: Subcommittee recommends reporting (6-Y 2-N)",6,2,0,1,9
1812054,1393433,2024-02-23,House,"House: Reported from Courts of Justice (12-Y 9-N)",12,9,0,1,22
1812056,1380880,2024-02-09,Senate,"Senate: Reading waived (39-Y 0-N)",39,0,0,1,40
1812056,1393241,2024-02-23,House,"House: Subcommittee recommends reporting (6-Y 0-N)",6,0,0,0,6
1812056,1393242,2024-02-23,House,"House: Reported from Rules (16-Y 0-N)",16,0,0,2,18
1812059,1376854,2024-02-06,Senate,"Senate: Continued to 2025 in Finance and Appropriations (15-Y 0-N)",15,0,0,0,15
1812061,1369676,2024-01-25,Senate,"Senate: Reported from Transportation with substitute (15-Y 0-N)",15,0,0,0,15
1812061,1370665,2024-01-29,Senate,"Senate: Constitutional reading dispensed (39-Y 0-N)",39,0,0,1,40
1812061,1373302,2024-01-31,Senate,"Senate: Read third time and passed Senate (40-Y 0-N)",40,0,0,0,40
1812061,1391515,2024-02-22,House,"House: Reported from Transportation (22-Y 0-N)",22,0,0,0,22
1812061,1395893,2024-02-27,House,"House: VOTE: Block Vote Passage (97-Y 0-N)",97,0,0,3,100
1812061,1429601,2024-04-17,Senate,"Senate: Senate concurred in Governor's recommendation (40-Y 0-N)",40,0,0,0,40
1812061,1430733,2024-04-17,House,"House: BLOCK VOTE: (97-Y 0-N)",97,0,0,3,100
1812062,1368069,2024-01-23,Senate,"Senate: Continued to 2025 in Agriculture, Conservation and Natural Resources (14-Y 1-N)",14,1,0,0,15
1812064,1371761,2024-01-30,Senate,"Senate: Incorporated by Agriculture, Conservation and Natural Resources ",10,0,0,0,10
1812066,1375613,2024-02-05,Senate,"Senate: Reported from Courts of Justice with amendments (15-Y 0-N)",15,0,0,0,15
1812066,1378069,2024-02-07,Senate,"Senate: Reported from Finance and Appropriations (15-Y 0-N)",15,0,0,0,15
1812066,1379295,2024-02-08,Senate,"Senate: Constitutional reading dispensed (40-Y 0-N)",40,0,0,0,40
1812066,1381078,2024-02-09,Senate,"Senate: Constitutional reading dispensed (40-Y 0-N)",40,0,0,0,40
1812066,1381079,2024-02-09,Senate,"Senate: Passed Senate (40-Y 0-N)",40,0,0,0,40
1812066,1386704,2024-02-16,House,"House: Reported from Public Safety (22-Y 0-N)",22,0,0,0,22
1812066,1390405,2024-02-21,House,"House: VOTE: Block Vote Passage (100-Y 0-N)",100,0,0,0,100
1812069,1373192,2024-01-31,Senate,"Senate: Reported from General Laws and Technology with substitute (15-Y 0-N)",15,0,0,0,15
1812069,1377600,2024-02-06,Senate,"Senate: Read third time and passed Senate (39-Y 0-N)",39,0,0,1,40
1812069,1432207,2024-02-15,House,"House: Reported from General Laws with substitute (22-Y 0-N)",22,0,0,0,22
1812069,1432208,2024-02-20,House,"House: VOTE: Block Vote Passage (98-Y 0-N)",98,0,0,2,100
1812069,1432209,2024-02-23,Senate,"Senate: House substitute agreed to by Senate (39-Y 0-N)",39,0,0,1,40
1812070,1379953,2024-02-08,Senate,"Senate: Reported from Education and Health (15-Y 0-N)",15,0,0,0,15
1812070,1379954,2024-02-08,Senate,"Senate: Constitutional reading dispensed (40-Y 0-N)",40,0,0,0,40
1812070,1381167,2024-02-09,Senate,"Senate: Constitutional reading dispensed (40-Y 0-N)",40,0,0,0,40
1812070,1381168,2024-02-09,Senate,"Senate: Passed Senate (40-Y 0-N)",40,0,0,0,40
1812070,1387354,2024-02-19,House,"House: Subcommittee recommends reporting with amendments (10-Y 0-N)",10,0,0,0,10
1812070,1390752,2024-02-21,House,"House: Reported from Education with amendment(s) (22-Y 0-N)",22,0,0,0,22
1812070,1395085,2024-02-26,House,"House: VOTE: Block Vote Passage (96-Y 0-N)",96,0,0,4,100
1812070,1398720,2024-02-28,Senate,"Senate: House amendment agreed to by Senate (39-Y 0-N)",39,0,0,1,40
1812072,1367201,2024-01-22,Senate,"Senate: Incorporated by Courts of Justice ",15,0,0,0,15
1812074,1378659,2024-02-07,Senate,"Senate: Reported from Courts of Justice with substitute (15-Y 0-N)",15,0,0,0,15
1812074,1380150,2024-02-08,Senate,"Senate: Constitutional reading dispensed (40-Y 0-N)",40,0,0,0,40
1812074,1381059,2024-02-09,Senate,"Senate: Constitutional reading dispensed (40-Y 0-N)",40,0,0,0,40
1812074,1381060,2024-02-09,Senate,"Senate: Passed Senate (40-Y 0-N)",40,0,0,0,40
1812074,1397282,2024-02-28,House,"House: Reported from Education (16-Y 6-N)",16,6,0,0,22
1812074,1403140,2024-03-05,House,"House: VOTE: Adoption (50-Y 48-N)",50,48,0,2,100
1812077,1378703,2024-02-07,Senate,"Senate: Reported from Courts of Justice with amendments (15-Y 0-N)",15,0,0,0,15
1812077,1381415,2024-02-12,Senate,"Senate: Reported from Finance and Appropriations with substitute (14-Y 0-N)",14,0,0,0,14
1812077,1382099,2024-02-12,Senate,"Senate: Constitutional reading dispensed (40-Y 0-N)",40,0,0,0,40
1812077,1383077,2024-02-13,Senate,"Senate: Constitutional reading dispensed (39-Y 0-N)",39,0,0,1,40
1812077,1383078,2024-02-13,Senate,"Senate: Passed Senate (40-Y 0-N)",40,0,0,0,40
1812077,1393136,2024-02-23,House,"House: Reported from Public Safety (21-Y 0-N)",21,0,0,1,22
1812077,1397874,2024-02-28,House,"House: VOTE: Block Vote Passage (97-Y 0-N)",97,0,0,3,100
1812080,1378795,2024-02-07,Senate,"Senate: Passed by indefinitely in Courts of Justice (9-Y 6-N)",9,6,0,0,15
1812083,1376364,2024-02-05,Senate,"Senate: Continued to 2025 in Commerce and Labor (11-Y 4-N)",11,4,0,0,15
1812084,1377395,2024-02-06,Senate,"Senate: Stricken at request of Patron in Agriculture, Conservation and Natural Resources (10-Y 0-N)",10,0,0,0,10
1812086,1379754,2024-02-08,Senate,"Senate: Continued to 2025 in Education and Health (15-Y 0-N)",15,0,0,0,15
1812088,1371819,2024-01-30,Senate,"Senate: Reported from Agriculture, Conservation and Natural Resources with substitite (11-Y 3-N 1-A)",11,3,1,0,15
1812088,1376935,2024-02-06,Senate,"Senate: Reported from Finance and Appropriations with substitute (10-Y 5-N)",10,5,0,0,15
1812088,1378006,2024-02-07,Senate,"Senate: Constitutional reading dispensed (40-Y 0-N)",40,0,0,0,40
1812088,1381049,2024-02-09,Senate,"Senate: Read third time and passed Senate (25-Y 14-N)",25,14,0,1,40
1812088,1391323,2024-02-22,House,"House: Reported from Transportation with substitute (13-Y 9-N)",13,9,0,0,22
1812088,1396631,2024-02-27,House,"House: VOTE: Passage (51-Y 46-N)",51,46,0,3,100
1812088,1399594,2024-02-29,Senate,"Senate: House substitute rejected by Senate (0-Y 39-N)",0,39,0,1,40
1812088,1403299,2024-03-05,Senate,"Senate: Senate acceded to request (40-Y 0-N)",40,0,0,0,40
1812088,1405329,2024-03-07,House,"House: VOTE: Adoption (52-Y 46-N)",52,46,0,2,100
1812088,1406126,2024-03-08,Senate,"Senate: Conference report agreed to by Senate (25-Y 15-N)",25,15,0,0,40
1812090,1370427,2024-01-29,Senate,"Senate: Reading waived (40-Y 0-N)",40,0,0,0,40
1812090,1393305,2024-02-23,House,"House: Reported from Rules (17-Y 0-N)",17,0,0,1,18
1812090,1401528,2024-02-28,House,"House: VOTE: Block Vote Adoption (99-Y 0-N)",99,0,0,1,100
1812090,1401529,2024-02-28,House,"House: VOTE: Block Vote Adoption #2 (99-Y 0-N)",99,0,0,1,100
1812092,1375607,2024-02-05,Senate,"Senate: Reported from Courts of Justice (15-Y 0-N)",15,0,0,0,15
1812092,1376838,2024-02-06,Senate,"Senate: Constitutional reading dispensed (39-Y 0-N)",39,0,0,1,40
1812092,1378083,2024-02-07,Senate,"Senate: Constitutional reading dispensed (40-Y 0-N)",40,0,0,0,40
1812092,1378084,2024-02-07,Senate,"Senate: Passed Senate (40-Y 0-N)",40,0,0,0,40
1812092,1386821,2024-02-16,House,"House: Reported from Courts of Justice (22-Y 0-N)",22,0,0,0,22
1812092,1390903,2024-02-21,House,"House: VOTE: Block Vote Passage (100-Y 0-N)",100,0,0,0,100
1812094,1372845,2024-01-31,Senate,"Senate: Rereferred from General Laws and Technology (14-Y 0-N)",14,0,0,0,14
1812094,1379367,2024-02-08,Senate,"Senate: Reported from Local Government with amendments (8-Y 7-N)",8,7,0,0,15
1812094,1379368,2024-02-08,Senate,"Senate: Constitutional reading dispensed (40-Y 0-N)",40,0,0,0,40
1812094,1381919,2024-02-12,Senate,"Senate: Read third time and passed Senate (21-Y 19-N)",21,19,0,0,40
1812094,1392737,2024-02-22,House,"House: Subcommittee recommends reporting with substitute (6-Y 2-N)",6,2,0,0,8
1812094,1396489,2024-02-27,House,"House: Reported from General Laws with substitute (13-Y 9-N)",13,9,0,0,22
1812094,1400789,2024-03-01,House,"House: VOTE: Passage (52-Y 45-N)",52,45,0,3,100
1812094,1403314,2024-03-05,Senate,"Senate: House substitute rejected by Senate (0-Y 40-N)",0,40,0,0,40
1812094,1405354,2024-03-07,Senate,"Senate: Senate acceded to request (40-Y 0-N)",40,0,0,0,40
1812094,1406138,2024-03-08,Senate,"Senate: Conference report agreed to by Senate (22-Y 18-N)",22,18,0,0,40
1812094,1406472,2024-03-08,House,"House: VOTE: Adoption (51-Y 48-N)",51,48,0,1,100
1812096,1367320,2024-01-22,Senate,"Senate: Reported from Courts of Justice (9-Y 6-N)",9,6,0,0,15
1812096,1368930,2024-01-23,Senate,"Senate: Constitutional reading dispensed (39-Y 0-N)",39,0,0,1,40
1812096,1369421,2024-01-25,Senate,"Senate: Read third time and passed Senate (21-Y 19-N)",21,19,0,0,40
1812096,1386622,2024-02-16,House,"House: Reported from Public Safety (12-Y 10-N)",12,10,0,0,22
1812096,1389925,2024-02-21,House,"House: VOTE: Passage (51-Y 49-N)",51,49,0,0,100
1812098,1375918,2024-02-05,Senate,"Senate: Reported from Local Government with substitute (11-Y 4-N)",11,4,0,0,15
1812098,1377100,2024-02-06,Senate,"Senate: Constitutional reading dispensed (39-Y 0-N)",39,0,0,1,40
1812098,1380875,2024-02-09,Senate,"Senate: Read third time and passed Senate (25-Y 15-N)",25,15,0,0,40
1812098,1393156,2024-02-23,House,"House: Reported from Counties, Cities and Towns with amendment(s) (13-Y 9-N)",13,9,0,0,22
1812098,1398046,2024-02-28,House,"House: VOTE: Passage (52-Y 38-N)",52,38,0,10,100
1812098,1400861,2024-03-01,Senate,"Senate: House amendment agreed to by Senate (24-Y 16-N)",24,16,0,0,40
1812098,1430247,2024-04-17,Senate,"Senate: Senate concurred in Governor's recommendation (36-Y 4-N)",36,4,0,0,40
1812098,1430248,2024-04-17,House,"House: VOTE: Adoption (60-Y 39-N)",60,39,0,1,100
1812100,1374056,2024-02-01,Senate,"Senate: Reported from Education and Health with amendment (15-Y 0-N)",15,0,0,0,15
1812100,1380403,2024-02-08,Senate,"Senate: Continued to 2025 in Finance and Appropriations (10-Y 5-N)",10,5,0,0,15
1812102,1372059,2024-01-30,House,"House: Reported from Health and Human Services with substitute (22-Y 0-N)",22,0,0,0,22
1812102,1375999,2024-02-05,House,"House: VOTE: Block Vote Passage (98-Y 0-N)",98,0,0,2,100
1812102,1385299,2024-02-15,Senate,"Senate: Reported from Education and Health (13-Y 0-N)",13,0,0,0,13
1812102,1386786,2024-02-16,Senate,"Senate: Constitutional reading dispensed (38-Y 0-N)",38,0,0,2,40
1812102,1387856,2024-02-19,Senate,"Senate: Passed Senate (39-Y 0-N)",39,0,0,1,40
1812105,1366490,2024-01-18,Senate,"Senate: Reported from Education and Health (15-Y 0-N)",15,0,0,0,15
1812105,1368798,2024-01-19,Senate,"Senate: Constitutional reading dispensed (37-Y 0-N)",37,0,0,3,40
1812105,1368799,2024-01-23,Senate,"Senate: Read third time and passed Senate (39-Y 0-N)",39,0,0,1,40
1812105,1384198,2024-02-14,House,"House: Reported from Education (21-Y 0-N)",21,0,0,1,22
1812105,1387391,2024-02-19,House,"House: VOTE: Block Vote Passage (99-Y 0-N)",99,0,0,1,100
1812107,1373703,2024-02-01,Senate,"Senate: Reported from Education and Health (15-Y 0-N)",15,0,0,0,15
1812107,1377881,2024-02-07,Senate,"Senate: Reported from Finance and Appropriations (15-Y 0-N)",15,0,0,0,15
1812107,1379898,2024-02-08,Senate,"Senate: Constitutional reading dispensed (40-Y 0-N)",40,0,0,0,40
1812107,1380629,2024-02-09,Senate,"Senate: Constitutional reading dispensed (40-Y 0-N)",40,0,0,0,40
1812107,1380630,2024-02-09,Senate,"Senate: Read third time and passed Senate (40-Y 0-N)",40,0,0,0,40
1812107,1387320,2024-02-19,House,"House: Reported from Education with substitute (21-Y 1-N)",21,1,0,0,22
1812107,1392649,2024-02-22,House,"House: VOTE: Passage (89-Y 10-N)",89,10,0,1,100
1812107,1394832,2024-02-26,Senate,"Senate: House substitute agreed to by Senate (40-Y 0-N)",40,0,0,0,40
1812108,1382786,2024-02-12,Senate,"Senate: Passed by indefinitely in Courts of Justice (9-Y 6-N)",9,6,0,0,15
1812125,1374672,2024-02-02,Senate,"Senate: Reported from Rules with substitute (14-Y 0-N)",14,0,0,0,14
1812125,1376502,2024-02-05,Senate,"Senate: Constitutional reading dispensed (39-Y 0-N)",39,0,0,1,40
1812125,1379710,2024-02-08,Senate,"Senate: Constitutional reading dispensed (40-Y 0-N)",40,0,0,0,40
1812125,1379711,2024-02-08,Senate,"Senate: Read third time and passed Senate (40-Y 0-N)",40,0,0,0,40
1812125,1392377,2024-02-22,House,"House: Subcommittee recommends reporting (8-Y 0-N)",8,0,0,0,8
1812125,1395560,2024-02-27,House,"House: Reported from Health and Human Services (21-Y 0-N)",21,0,0,1,22
1812125,1397603,2024-02-28,House,"House: Tabled in Appropriations (19-Y 2-N)",19,2,0,1,22
1812127,1371178,2024-01-29,Senate,"Senate: Reading waived (40-Y 0-N)",40,0,0,0,40
1812127,1393254,2024-02-23,House,"House: Subcommittee recommends reporting with substitute (6-Y 0-N)",6,0,0,0,6
1812127,1393255,2024-02-23,House,"House: Reported from Rules with substitute (16-Y 0-N)",16,0,0,2,18
1812127,1397638,2024-02-28,House,"House: Reported from Appropriations with substitute (22-Y 0-N)",22,0,0,0,22
1812127,1401955,2024-03-04,House,"House: VOTE: Block Vote Adoption (97-Y 0-N)",97,0,0,3,100
1812129,1369008,2024-01-25,Senate,"Senate: Passed by indefinitely in Education and Health (10-Y 5-N)",10,5,0,0,15
1812132,1382940,2024-02-12,Senate,"Senate: Passed by indefinitely in Courts of Justice (9-Y 6-N)",9,6,0,0,15
1812139,1369714,2024-01-26,Senate,"Senate: Reported from Rules (14-Y 0-N)",14,0,0,0,14
1812139,1370322,2024-01-29,Senate,"Senate: Constitutional reading dispensed (39-Y 0-N)",39,0,0,1,40
1812139,1373845,2024-02-01,Senate,"Senate: Read third time and passed Senate (40-Y 0-N)",40,0,0,0,40
1812139,1393142,2024-02-23,House,"House: Subcommittee recommends reporting (6-Y 0-N)",6,0,0,0,6
1812139,1393248,2024-02-23,House,"House: Reported from Rules (16-Y 0-N)",16,0,0,2,18
1812139,1397590,2024-02-28,House,"House: Reported from Appropriations with substitute (22-Y 0-N)",22,0,0,0,22
1812139,1401761,2024-03-04,House,"House: VOTE: Block Vote Passage (97-Y 0-N)",97,0,0,3,100
1812139,1402840,2024-03-05,Senate,"Senate: House substitute agreed to by Senate (40-Y 0-N)",40,0,0,0,40
1812141,1370498,2024-01-29,Senate,"Senate: Reported from Courts of Justice with substitute (15-Y 0-N)",15,0,0,0,15
1812141,1378536,2024-02-07,Senate,"Senate: Reported from Finance and Appropriations (15-Y 0-N)",15,0,0,0,15
1812141,1380000,2024-02-08,Senate,"Senate: Constitutional reading dispensed (40-Y 0-N)",40,0,0,0,40
1812141,1381181,2024-02-09,Senate,"Senate: Constitutional reading dispensed (40-Y 0-N)",40,0,0,0,40
1812141,1381182,2024-02-09,Senate,"Senate: Passed Senate (40-Y 0-N)",40,0,0,0,40
1812141,1387159,2024-02-16,House,"House: Reported from Courts of Justice (19-Y 3-N)",19,3,0,0,22
1812141,1390508,2024-02-21,House,"House: VOTE: Passage (74-Y 26-N)",74,26,0,0,100
1812143,1374964,2024-02-02,Senate,"Senate: Reported from Rehabilitation and Social Services (11-Y 4-N)",11,4,0,0,15
1812143,1376576,2024-02-05,Senate,"Senate: Constitutional reading dispensed (39-Y 0-N)",39,0,0,1,40
1812143,1378708,2024-02-07,Senate,"Senate: Read third time and passed Senate (33-Y 7-N)",33,7,0,0,40
1812143,1385451,2024-02-15,House,"House: Subcommittee recommends reporting with substitute (8-Y 0-N)",8,0,0,0,8
1812143,1388846,2024-02-20,House,"House: Reported from Health and Human Services with substitute (22-Y 0-N)",22,0,0,0,22
1812143,1393405,2024-02-23,House,"House: VOTE: Passage (94-Y 4-N)",94,4,0,2,100
1812143,1396970,2024-02-27,Senate,"Senate: House substitute rejected by Senate (0-Y 39-N)",0,39,0,1,40
1812143,1400925,2024-03-01,Senate,"Senate: Senate acceded to request (40-Y 0-N)",40,0,0,0,40
1812143,1406549,2024-03-08,Senate,"Senate: Conference report agreed to by Senate (33-Y 7-N)",33,7,0,0,40
1812143,1406550,2024-03-08,House,"House: VOTE: Adoption (94-Y 2-N)",94,2,0,4,100
1812145,1377377,2024-02-06,Senate,"Senate: Stricken at request of Patron in Finance and Appropriations (15-Y 0-N)",15,0,0,0,15
1812148,1368978,2024-01-25,Senate,"Senate: Reported from Education and Health with substitute (15-Y 0-N)",15,0,0,0,15
1812148,1377882,2024-02-07,Senate,"Senate: Continued to 2025 in Finance and Appropriations (10-Y 5-N)",10,5,0,0,15
1812150,1371597,2024-01-30,Senate,"Senate: Reported from Finance and Appropriations with substitute (12-Y 0-N 3-A)",12,0,3,0,15
1812150,1373252,2024-01-31,Senate,"Senate: Constitutional reading dispensed (40-Y 0-N)",40,0,0,0,40
1812150,1376906,2024-02-06,Senate,"Senate: Engrossment reconsidered by Senate (39-Y 0-N)",39,0,0,1,40
1812150,1376907,2024-02-06,Senate,"Senate: Constitutional reading dispensed (39-Y 0-N)",39,0,0,1,40
1812150,1376908,2024-02-06,Senate,"Senate: Passed Senate (23-Y 16-N)",23,16,0,1,40
1812150,1390572,2024-02-21,House,"House: Reported from Finance (12-Y 10-N)",12,10,0,0,22
1812150,1395063,2024-02-26,House,"House: VOTE: Passage (52-Y 43-N)",52,43,0,5,100
1812150,1429898,2024-04-17,Senate,"Senate: Senate rejected Governor's recommendation (19-Y 21-N)",19,21,0,0,40
1812152,1372036,2024-01-30,Senate,"Senate: Rereferred from Agriculture, Conservation and Natural Resources (15-Y 0-N)",15,0,0,0,15
1812152,1382476,2024-02-12,Senate,"Senate: Reported from Courts of Justice with amendment (10-Y 2-N)",10,2,0,0,12
1812152,1383912,2024-02-13,Senate,"Senate: Constitutional reading dispensed (40-Y 0-N)",40,0,0,0,40
1812152,1383913,2024-02-13,Senate,"Senate: Passed Senate (22-Y 18-N)",22,18,0,0,40
1812152,1383914,2024-02-13,Senate,"Senate: Constitutional reading dispensed (40-Y 0-N)",40,0,0,0,40
1812152,1389483,2024-02-20,House,"House: Reported from Labor and Commerce (16-Y 6-N)",16,6,0,0,22
1812152,1393692,2024-02-23,House,"House: VOTE: Passage (66-Y 30-N)",66,30,0,4,100
1812155,1374824,2024-02-02,Senate,"Senate: Reported from Rehabilitation and Social Services (8-Y 6-N)",8,6,0,0,14
1812155,1376633,2024-02-05,Senate,"Senate: Constitutional reading dispensed (39-Y 0-N)",39,0,0,1,40
1812155,1378344,2024-02-07,Senate,"Senate: Read third time and passed Senate (21-Y 19-N)",21,19,0,0,40
1812155,1391428,2024-02-22,House,"House: Subcommittee recommends reporting (4-Y 2-N)",4,2,0,0,6
1812155,1393289,2024-02-23,House,"House: Reported from Public Safety (12-Y 9-N)",12,9,0,1,22
1812155,1398301,2024-02-28,House,"House: VOTE: Passage (50-Y 49-N)",50,49,0,1,100
1812157,1368005,2024-01-23,Senate,"Senate: Reported from Agriculture, Conservation and Natural Resources with amendment (15-Y 0-N)",15,0,0,0,15
1812157,1373080,2024-01-31,Senate,"Senate: Reported from Finance and Appropriations with amendments (15-Y 0-N)",15,0,0,0,15
1812157,1374370,2024-02-01,Senate,"Senate: Constitutional reading dispensed (40-Y 0-N)",40,0,0,0,40
1812157,1376107,2024-02-05,Senate,"Senate: Read third time and passed Senate (40-Y 0-N)",40,0,0,0,40
1812157,1384191,2024-02-14,House,"House: Reported from Agriculture, Chesapeake and Natural Resources (21-Y 0-N)",21,0,0,1,22
1812157,1387392,2024-02-19,House,"House: VOTE: Block Vote Passage (99-Y 0-N)",99,0,0,1,100
1812159,1371559,2024-01-30,Senate,"Senate: Passed by indefinitely in Finance and Appropriations (15-Y 0-N)",15,0,0,0,15
1812162,1375767,2024-02-05,Senate,"Senate: Reported from Courts of Justice with amendments (14-Y 0-N)",14,0,0,0,14
1812162,1376836,2024-02-06,Senate,"Senate: Constitutional reading dispensed (39-Y 0-N)",39,0,0,1,40
1812162,1378339,2024-02-07,Senate,"Senate: Constitutional reading dispensed (40-Y 0-N)",40,0,0,0,40
1812162,1378340,2024-02-07,Senate,"Senate: Passed Senate (40-Y 0-N)",40,0,0,0,40
1812162,1387020,2024-02-16,House,"House: Subcommittee recommends reporting (8-Y 0-N)",8,0,0,1,9
1812162,1393789,2024-02-23,House,"House: Reported from Courts of Justice (21-Y 0-N)",21,0,0,1,22
1812162,1399101,2024-02-29,House,"House: VOTE: Passage (100-Y 0-N)",100,0,0,0,100
1812164,1367041,2024-01-19,Senate,"Senate: Incorporated by Rehabilitation and Social Services ",11,0,0,0,11
1812166,1370520,2024-01-29,Senate,"Senate: Continued to 2025 in Local Government (15-Y 0-N)",15,0,0,0,15
1812168,1378519,2024-02-07,Senate,"Senate: Passed by indefinitely in Finance and Appropriations with letter (15-Y 0-N)",15,0,0,0,15
1812177,1368877,2024-01-24,Senate,"Senate: Reported from General Laws and Technology (15-Y 0-N)",15,0,0,0,15
1812177,1369762,2024-01-26,Senate,"Senate: Constitutional reading dispensed (37-Y 0-N)",37,0,0,3,40
1812177,1371545,2024-01-30,Senate,"Senate: Read third time and passed Senate (40-Y 0-N)",40,0,0,0,40
1812177,1386273,2024-02-15,House,"House: Reported from General Laws (22-Y 0-N)",22,0,0,0,22
1812177,1389262,2024-02-20,House,"House: VOTE: Passage (88-Y 11-N)",88,11,0,1,100
1812179,1368975,2024-01-25,Senate,"Senate: Reported from Education and Health with substitute (15-Y 0-N)",15,0,0,0,15
1812179,1377531,2024-02-06,Senate,"Senate: Reported from Finance and Appropriations (15-Y 0-N)",15,0,0,0,15
1812179,1377976,2024-02-07,Senate,"Senate: Constitutional reading dispensed (40-Y 0-N)",40,0,0,0,40
1812179,1380082,2024-02-08,Senate,"Senate: Constitutional reading dispensed (40-Y 0-N)",40,0,0,0,40
1812179,1380083,2024-02-08,Senate,"Senate: Read third time and passed Senate (40-Y 0-N)",40,0,0,0,40
1812179,1388541,2024-02-20,House,"House: Reported from Health and Human Services (22-Y 0-N)",22,0,0,0,22
1812179,1393429,2024-02-23,House,"House: VOTE: Block Vote Passage (98-Y 0-N)",98,0,0,2,100
1812182,1379132,2024-02-08,Senate,"Senate: Reported from Education and Health with substitute (15-Y 0-N)",15,0,0,0,15
1812182,1380086,2024-02-08,Senate,"Senate: Reported from Finance and Appropriations with substitute (15-Y 0-N)",15,0,0,0,15
1812182,1380824,2024-02-09,Senate,"Senate: Constitutional reading dispensed (39-Y 0-N)",39,0,0,1,40
1812182,1381846,2024-02-12,Senate,"Senate: Constitutional reading dispensed (40-Y 0-N)",40,0,0,0,40
1812182,1381847,2024-02-12,Senate,"Senate: Passed Senate (40-Y 0-N)",40,0,0,0,40
1812184,1370513,2024-01-29,Senate,"Senate: Passed by indefinitely in Courts of Justice (9-Y 6-N)",9,6,0,0,15
1812186,1369692,2024-01-25,Senate,"Senate: Reported from Transportation with amendment (8-Y 7-N)",8,7,0,0,15
1812186,1376960,2024-02-06,Senate,"Senate: Reported from Finance and Appropriations (13-Y 2-N)",13,2,0,0,15
1812186,1378008,2024-02-07,Senate,"Senate: Constitutional reading dispensed (40-Y 0-N)",40,0,0,0,40
1812186,1381064,2024-02-09,Senate,"Senate: Read third time and passed Senate (20-Y 17-N)",20,17,0,3,40
1812186,1381065,2024-02-09,Senate,"Senate: Reconsideration of passage agreed to by Senate (40-Y 0-N)",40,0,0,0,40
1812186,1381066,2024-02-09,Senate,"Senate: Passed Senate (23-Y 17-N)",23,17,0,0,40
1812186,1388445,2024-02-20,House,"House: Subcommittee failed to recommend reporting (3-Y 4-N)",3,4,1,0,8
1812189,1368702,2024-01-24,Senate,"Senate: Passed by indefinitely in Courts of Justice (9-Y 6-N)",9,6,0,0,15
1812191,1373856,2024-01-31,Senate,"Senate: Reported from Courts of Justice with substitute (9-Y 6-N)",9,6,0,0,15
1812191,1378504,2024-02-07,Senate,"Senate: Reported from Finance and Appropriations (10-Y 5-N)",10,5,0,0,15
1812191,1379365,2024-02-08,Senate,"Senate: Constitutional reading dispensed (40-Y 0-N)",40,0,0,0,40
1812191,1382243,2024-02-12,Senate,"Senate: Read third time and passed Senate (21-Y 19-N)",21,19,0,0,40
1812191,1386610,2024-02-16,House,"House: Reported from Public Safety (12-Y 10-N)",12,10,0,0,22
1812191,1390033,2024-02-21,House,"House: VOTE: Passage (52-Y 48-N)",52,48,0,0,100
1812191,1429686,2024-04-17,Senate,"Senate: Senate rejected Governor's recommendation (19-Y 21-N)",19,21,0,0,40
1812193,1367323,2024-01-22,Senate,"Senate: Reported from Commerce and Labor (8-Y 6-N)",8,6,0,0,14
1812193,1372802,2024-01-31,Senate,"Senate: Continued to 2025 in Finance and Appropriations (15-Y 0-N)",15,0,0,0,15
1812317,1378530,2024-02-07,Senate,"Senate: Continued to 2025 in Finance and Appropriations (13-Y 2-N)",13,2,0,0,15
1812322,1374669,2024-02-02,Senate,"Senate: Reported from Rules with amendments (14-Y 0-N)",14,0,0,0,14
1812322,1378059,2024-02-07,Senate,"Senate: Stricken at request of Patron in Finance and Appropriations (15-Y 0-N)",15,0,0,0,15
1812327,1371873,2024-01-30,Senate,"Senate: Reported from Privileges and Elections (8-Y 7-N)",8,7,0,0,15
1812327,1378295,2024-02-07,Senate,"Senate: Reported from Finance and Appropriations (10-Y 5-N)",10,5,0,0,15
1812327,1379361,2024-02-08,Senate,"Senate: Constitutional reading dispensed (40-Y 0-N)",40,0,0,0,40
1812327,1381493,2024-02-12,Senate,"Senate: Read third time and passed Senate (21-Y 19-N)",21,19,0,0,40
1812327,1386715,2024-02-16,House,"House: Reported from Privileges and Elections (11-Y 10-N)",11,10,0,1,22
1812327,1390681,2024-02-21,House,"House: VOTE: Passage (51-Y 49-N)",51,49,0,0,100
1812327,1430151,2024-04-17,Senate,"Senate: Passed in enrolled form rejected (21-Y 19-N)",21,19,0,0,40
1812332,1377306,2024-02-06,Senate,"Senate: Reported from Agriculture, Conservation and Natural Resources with substitite (15-Y 0-N)",15,0,0,0,15
1812332,1379749,2024-02-08,Senate,"Senate: Reported from Finance and Appropriations with substitute (15-Y 0-N)",15,0,0,0,15
1812332,1381084,2024-02-09,Senate,"Senate: Constitutional reading dispensed (39-Y 0-N)",39,0,0,1,40
1812332,1381799,2024-02-12,Senate,"Senate: Constitutional reading dispensed (40-Y 0-N)",40,0,0,0,40
1812332,1381800,2024-02-12,Senate,"Senate: Passed Senate (40-Y 0-N)",40,0,0,0,40
1812332,1393184,2024-02-23,House,"House: Subcommittee recommends reporting (6-Y 0-N)",6,0,0,0,6
1812332,1393185,2024-02-23,House,"House: Reported from Rules (16-Y 0-N)",16,0,0,2,18
1812332,1397568,2024-02-28,House,"House: Reported from Appropriations with substitute (15-Y 7-N)",15,7,0,0,22
1812332,1401884,2024-03-04,House,"House: VOTE: Passage (93-Y 5-N)",93,5,0,2,100
1812332,1403013,2024-03-05,Senate,"Senate: House substitute rejected by Senate (2-Y 38-N)",2,38,0,0,40
1812332,1405080,2024-03-07,Senate,"Senate: Senate acceded to request (40-Y 0-N)",40,0,0,0,40
1812332,1406694,2024-03-09,House,"House: VOTE: Adoption (98-Y 0-N)",98,0,0,2,100
1812332,1406695,2024-03-09,Senate,"Senate: Conference report agreed to by Senate (39-Y 1-N)",39,1,0,0,40
1812337,1373767,2024-02-01,Senate,"Senate: Reported from Education and Health with substitute (8-Y 7-N)",8,7,0,0,15
1812337,1378316,2024-02-07,Senate,"Senate: Reported from Finance and Appropriations (10-Y 5-N)",10,5,0,0,15
1812337,1379373,2024-02-08,Senate,"Senate: Constitutional reading dispensed (40-Y 0-N)",40,0,0,0,40
1812337,1381829,2024-02-12,Senate,"Senate: Read third time and passed Senate (20-Y 19-N)",20,19,0,1,40
1812337,1387323,2024-02-19,House,"House: Subcommittee recommends reporting with substitute (6-Y 4-N)",6,4,0,0,10
1812337,1389781,2024-02-21,House,"House: Reported from Education with substitute (12-Y 10-N)",12,10,0,0,22
1812337,1394661,2024-02-26,House,"House: Reported from Appropriations with substitute (12-Y 10-N)",12,10,0,0,22
1812337,1395976,2024-02-26,House,"House: Reported from Appropriations (12-Y 10-N)",12,10,0,0,22
1812337,1398365,2024-02-28,House,"House: VOTE: Passage (51-Y 49-N)",51,49,0,0,100
1812337,1400983,2024-03-01,Senate,"Senate: House substitute agreed to by Senate (21-Y 19-N)",21,19,0,0,40
1812344,1369707,2024-01-26,Senate,"Senate: Incorporated by Rehabilitation and Social Services ",12,0,0,0,12
1812349,1374062,2024-02-01,Senate,"Senate: Reported from Education and Health with substitute (15-Y 0-N)",15,0,0,0,15
1812349,1377585,2024-02-06,Senate,"Senate: Read third time and passed Senate (39-Y 0-N)",39,0,0,1,40
1812349,1432190,2024-02-15,House,"House: Subcommittee recommends reporting (8-Y 0-N)",8,0,0,0,8
1812349,1432191,2024-02-20,House,"House: Reported from Health and Human Services (22-Y 0-N)",22,0,0,0,22
1812349,1432192,2024-02-23,House,"House: VOTE: Block Vote Passage (98-Y 0-N)",98,0,0,2,100
1812354,1367184,2024-01-22,Senate,"Senate: Failed to report (defeated) in Local Government (5-Y 9-N 1-A)",5,9,1,0,15
1812359,1376418,2024-02-05,Senate,"Senate: Reported from Courts of Justice with substitute (12-Y 2-N)",12,2,0,0,14
1812359,1379897,2024-02-08,Senate,"Senate: Reported from Finance and Appropriations with amendment (11-Y 4-N)",11,4,0,0,15
1812359,1381160,2024-02-09,Senate,"Senate: Constitutional reading dispensed (39-Y 0-N)",39,0,0,1,40
1812359,1383816,2024-02-13,Senate,"Senate: Read third time and passed Senate (25-Y 15-N)",25,15,0,0,40
1812359,1387890,2024-02-19,House,"House: Subcommittee recommends reporting with amendments (5-Y 3-N)",5,3,0,1,9
1812359,1393457,2024-02-23,House,"House: Reported from Courts of Justice with amendment(s) (11-Y 10-N)",11,10,0,1,22
1812359,1397952,2024-02-28,House,"House: Reported from Appropriations with amendment(s) (20-Y 2-N)",20,2,0,0,22
1812359,1402440,2024-03-04,House,"House: VOTE: Passage (57-Y 41-N)",57,41,0,2,100
1812359,1403353,2024-03-05,Senate,"Senate: House amendments rejected by Senate (0-Y 40-N)",0,40,0,0,40
1812359,1405753,2024-03-07,Senate,"Senate: Senate acceded to request (40-Y 0-N)",40,0,0,0,40
1812359,1406702,2024-03-09,House,"House: VOTE: Adoption (54-Y 43-N)",54,43,0,3,100
1812359,1406703,2024-03-09,Senate,"Senate: Conference report agreed to by Senate (21-Y 19-N)",21,19,0,0,40
1812366,1371743,2024-01-30,Senate,"Senate: Passed by indefinitely in Agriculture, Conservation and Natural Resources (14-Y 1-N)",14,1,0,0,15
1812371,1380900,2024-02-09,Senate,"Senate: Reading waived (39-Y 0-N)",39,0,0,1,40
1812371,1382341,2024-02-12,Senate,"Senate: Reading waived (39-Y 0-N)",39,0,0,1,40
1812371,1393252,2024-02-23,House,"House: Subcommittee recommends reporting (6-Y 0-N)",6,0,0,0,6
1812371,1393253,2024-02-23,House,"House: Reported from Rules (16-Y 0-N)",16,0,0,2,18
1812376,1368994,2024-01-25,Senate,"Senate: Reported from Education and Health with substitute (15-Y 0-N)",15,0,0,0,15
1812376,1369868,2024-01-26,Senate,"Senate: Constitutional reading dispensed (37-Y 0-N)",37,0,0,3,40
1812376,1371799,2024-01-30,Senate,"Senate: Read third time and passed Senate (40-Y 0-N)",40,0,0,0,40
1812376,1385250,2024-02-15,House,"House: Reported from Health and Human Services (22-Y 0-N)",22,0,0,0,22
1812376,1388960,2024-02-20,House,"House: VOTE: Block Vote Passage (98-Y 0-N)",98,0,0,2,100
1812381,1364287,2024-01-15,Senate,"Senate: Reported from Commerce and Labor with substitute (14-Y 1-N)",14,1,0,0,15
1812381,1378307,2024-02-07,Senate,"Senate: Reported from Finance and Appropriations with substitute (15-Y 0-N)",15,0,0,0,15
1812381,1379381,2024-02-08,Senate,"Senate: Constitutional reading dispensed (40-Y 0-N)",40,0,0,0,40
1812381,1381995,2024-02-12,Senate,"Senate: Read third time and passed Senate (38-Y 1-N)",38,1,0,1,40
1812381,1389134,2024-02-20,House,"House: Reported from General Laws with amendment(s) (21-Y 0-N)",21,0,0,1,22
1812381,1393735,2024-02-23,House,"House: VOTE: Block Vote Passage (98-Y 0-N)",98,0,0,2,100
1812381,1395772,2024-02-27,Senate,"Senate: House amendments rejected by Senate (1-Y 38-N)",1,38,0,1,40
1812381,1398143,2024-02-28,Senate,"Senate: Senate acceded to request (39-Y 0-N)",39,0,0,1,40
1812381,1402182,2024-03-04,Senate,"Senate: Conference report agreed to by Senate (37-Y 1-N)",37,1,0,2,40
1812381,1403357,2024-03-05,House,"House: VOTE: Adoption (100-Y 0-N)",100,0,0,0,100
1812381,1430182,2024-04-17,Senate,"Senate: Senate concurred in Governor's recommendation (39-Y 1-N)",39,1,0,0,40
1812381,1430183,2024-04-17,House,"House: VOTE: Adoption (99-Y 1-N)",99,1,0,0,100
1812445,1371496,2024-01-30,House,"House: Reported from Health and Human Services with substitute (22-Y 0-N)",22,0,0,0,22
1812445,1375922,2024-02-05,House,"House: VOTE: Block Vote Passage (98-Y 0-N)",98,0,0,2,100
1812445,1385466,2024-02-15,Senate,"Senate: Reported from Education and Health (15-Y 0-N)",15,0,0,0,15
1812445,1386793,2024-02-16,Senate,"Senate: Constitutional reading dispensed (38-Y 0-N)",38,0,0,2,40
1812445,1387555,2024-02-19,Senate,"Senate: Passed Senate (39-Y 0-N)",39,0,0,1,40
1812565,1375097,2024-02-02,House,"House: Subcommittee recommends reporting (7-Y 0-N)",7,0,0,2,9
1812565,1378976,2024-02-07,House,"House: Reported from Courts of Justice (22-Y 0-N)",22,0,0,0,22
1812565,1382995,2024-02-13,House,"House: VOTE: Block Vote Passage (99-Y 0-N)",99,0,0,1,100
1812565,1398664,2024-02-28,Senate,"Senate: Reported from Courts of Justice with substitute (15-Y 0-N)",15,0,0,0,15
1812565,1401025,2024-03-01,Senate,"Senate: Constitutional reading dispensed (40-Y 0-N)",40,0,0,0,40
1812565,1402265,2024-03-04,Senate,"Senate: Passed Senate with substitute (39-Y 0-N)",39,0,0,1,40
1812565,1403582,2024-03-05,House,"House: VOTE: Adoption (100-Y 0-N)",100,0,0,0,100
1812682,1376584,2024-02-05,House,"House: Subcommittee recommends reporting (8-Y 0-N)",8,0,0,1,9
1812682,1378648,2024-02-07,House,"House: Reported from Courts of Justice (22-Y 0-N)",22,0,0,0,22
1812682,1382823,2024-02-13,House,"House: VOTE: Block Vote Passage (99-Y 0-N)",99,0,0,1,100
1812682,1398877,2024-02-28,Senate,"Senate: Reported from Courts of Justice (15-Y 0-N)",15,0,0,0,15
1812682,1401169,2024-03-01,Senate,"Senate: Constitutional reading dispensed (40-Y 0-N)",40,0,0,0,40
1812682,1402403,2024-03-04,Senate,"Senate: Passed Senate (39-Y 0-N)",39,0,0,1,40
1812744,1379557,2024-02-08,House,"House: Subcommittee recommends reporting (7-Y 0-N)",7,0,0,1,8
1812744,1379848,2024-02-08,House,"House: Reported from General Laws (20-Y 0-N)",20,0,0,2,22
1812744,1383904,2024-02-13,House,"House: VOTE: Block Vote Passage (99-Y 0-N)",99,0,0,1,100
1812744,1390281,2024-02-21,Senate,"Senate: Reported from General Laws and Technology with amendments (11-Y 4-N)",11,4,0,0,15
1812744,1393481,2024-02-23,Senate,"Senate: Constitutional reading dispensed (38-Y 0-N)",38,0,0,2,40
1812744,1395376,2024-02-26,Senate,"Senate: Passed Senate with amendments (37-Y 3-N)",37,3,0,0,40
1812744,1398685,2024-02-28,House,"House: VOTE: Adoption (100-Y 0-N)",100,0,0,0,100
1812761,1372028,2024-01-30,House,"House: Subcommittee recommends reporting with amendments (5-Y 2-N)",5,2,0,0,7
1812761,1374161,2024-02-01,House,"House: Reported from Labor and Commerce with amendment(s) (16-Y 6-N)",16,6,0,0,22
1812773,1370986,2024-01-29,Senate,"Senate: Reported from Courts of Justice (14-Y 0-N)",14,0,0,0,14
1812773,1378518,2024-02-07,Senate,"Senate: Reported from Finance and Appropriations (15-Y 0-N)",15,0,0,0,15
1812773,1379981,2024-02-08,Senate,"Senate: Constitutional reading dispensed (40-Y 0-N)",40,0,0,0,40
1812773,1381179,2024-02-09,Senate,"Senate: Constitutional reading dispensed (40-Y 0-N)",40,0,0,0,40
1812773,1381180,2024-02-09,Senate,"Senate: Passed Senate (40-Y 0-N)",40,0,0,0,40
1812773,1386714,2024-02-16,House,"House: Reported from Courts of Justice with substitute (22-Y 0-N)",22,0,0,0,22
1812773,1390371,2024-02-21,House,"House: VOTE: Block Vote Passage (100-Y 0-N)",100,0,0,0,100
1812773,1396000,2024-02-27,Senate,"Senate: House substitute rejected by Senate (0-Y 39-N)",0,39,0,1,40
1812773,1398559,2024-02-28,House,"House: VOTE: Adoption (99-Y 0-N)",99,0,0,1,100
1812787,1376503,2024-02-05,House,"House: Subcommittee recommends reporting with amendments (5-Y 3-N)",5,3,0,1,9
1812809,1364271,2024-01-15,Senate,"Senate: Rereferred from Courts of Justice (15-Y 0-N)",15,0,0,0,15
1812809,1377284,2024-02-06,Senate,"Senate: Reported from Finance and Appropriations with substitute (15-Y 0-N)",15,0,0,0,15
1812809,1378035,2024-02-07,Senate,"Senate: Constitutional reading dispensed (40-Y 0-N)",40,0,0,0,40
1812809,1379246,2024-02-08,Senate,"Senate: Constitutional reading dispensed (40-Y 0-N)",40,0,0,0,40
1812809,1379247,2024-02-08,Senate,"Senate: Read third time and passed Senate (40-Y 0-N)",40,0,0,0,40
1812809,1386265,2024-02-15,House,"House: Reported from General Laws with substitute (22-Y 0-N)",22,0,0,0,22
1812809,1389260,2024-02-20,House,"House: VOTE: Block Vote Passage (98-Y 0-N)",98,0,0,2,100
1812809,1392595,2024-02-22,Senate,"Senate: House substitute agreed to by Senate (40-Y 0-N)",40,0,0,0,40
1812809,1392596,2024-02-22,Senate,"Senate: Reconsideration of House substitute agreed to by Senate (40-Y 0-N)",40,0,0,0,40
1812809,1392597,2024-02-22,Senate,"Senate: House substitute rejected by Senate (0-Y 40-N)",0,40,0,0,40
1812809,1396604,2024-02-27,Senate,"Senate: Senate acceded to request (39-Y 0-N)",39,0,0,1,40
1812809,1404191,2024-03-06,House,"House: VOTE: Adoption (98-Y 0-N)",98,0,0,2,100
1812809,1405632,2024-03-07,Senate,"Senate: Conference report agreed to by Senate (40-Y 0-N)",40,0,0,0,40
1812821,1368111,2024-01-23,House,"House: Subcommittee recommends reporting with substitute (8-Y 0-N)",8,0,0,1,9
1812821,1369415,2024-01-25,House,"House: Reported from General Laws with substitute (22-Y 0-N)",22,0,0,0,22
1812821,1372510,2024-01-31,House,"House: VOTE: Passage (96-Y 3-N)",96,3,0,1,100
1812821,1386850,2024-02-16,Senate,"Senate: Reported from Rehabilitation and Social Services (13-Y 0-N)",13,0,0,0,13
1812821,1387771,2024-02-19,Senate,"Senate: Constitutional reading dispensed (38-Y 0-N)",38,0,0,2,40
1812821,1389133,2024-02-20,Senate,"Senate: Passed Senate (40-Y 0-N)",40,0,0,0,40
1812835,1379038,2024-02-08,House,"House: Subcommittee failed to recommend reporting (2-Y 4-N)",2,4,0,0,6
1812849,1372452,2024-01-31,House,"House: Subcommittee recommends reporting with amendments (6-Y 2-N)",6,2,0,0,8
1812849,1374607,2024-02-02,House,"House: Reported from Privileges and Elections with amendment(s) (19-Y 3-N)",19,3,0,0,22
1812849,1380101,2024-02-08,House,"House: VOTE: Passage (92-Y 6-N)",92,6,0,2,100
1812849,1388839,2024-02-20,Senate,"Senate: Reported from Privileges and Elections (15-Y 0-N)",15,0,0,0,15
1812849,1392846,2024-02-22,Senate,"Senate: Constitutional reading dispensed (40-Y 0-N)",40,0,0,0,40
1812849,1393772,2024-02-23,Senate,"Senate: Passed Senate (39-Y 0-N)",39,0,0,1,40
1812867,1375828,2024-02-05,House,"House: Subcommittee recommends reporting with substitute (10-Y 0-N)",10,0,0,0,10
1812867,1378056,2024-02-07,House,"House: Reported from Education with substitute (22-Y 0-N)",22,0,0,0,22
1812867,1383322,2024-02-13,House,"House: VOTE: Block Vote Passage (99-Y 0-N)",99,0,0,1,100
1812867,1399102,2024-02-29,Senate,"Senate: Reported from Education and Health (15-Y 0-N)",15,0,0,0,15
1812867,1400957,2024-03-01,Senate,"Senate: Constitutional reading dispensed (40-Y 0-N)",40,0,0,0,40
1812867,1402250,2024-03-04,Senate,"Senate: Passed Senate (39-Y 0-N)",39,0,0,1,40
1812881,1376976,2024-02-06,Senate,"Senate: Passed by indefinitely in Finance and Appropriations (14-Y 0-N)",14,0,0,0,14
1812893,1368861,2024-01-24,Senate,"Senate: Reported from General Laws and Technology with substitute (10-Y 3-N 2-A)",10,3,2,0,15
1812893,1372490,2024-01-31,Senate,"Senate: Continued to 2025 in Finance and Appropriations (15-Y 0-N)",15,0,0,0,15
1812906,1374836,2024-02-02,House,"House: Subcommittee recommends reporting with amendments (7-Y 0-N)",7,0,0,2,9
1812906,1378483,2024-02-07,House,"House: Reported from Courts of Justice with substitute (20-Y 2-N)",20,2,0,0,22
1812906,1383430,2024-02-13,House,"House: VOTE: Passage (87-Y 12-N)",87,12,0,1,100
1812906,1398719,2024-02-28,Senate,"Senate: Reported from Courts of Justice with amendment (14-Y 0-N)",14,0,0,0,14
1812906,1401045,2024-03-01,Senate,"Senate: Constitutional reading dispensed (40-Y 0-N)",40,0,0,0,40
1812906,1401736,2024-03-04,Senate,"Senate: Passed Senate with amendment (39-Y 0-N)",39,0,0,1,40
1812906,1402777,2024-03-05,House,"House: VOTE: Adoption (87-Y 13-N)",87,13,0,0,100
1812927,1378908,2024-02-07,Senate,"Senate: Reported from General Laws and Technology with substitute (9-Y 6-N)",9,6,0,0,15
1812927,1381574,2024-02-12,Senate,"Senate: Continued to 2025 in Finance and Appropriations (15-Y 0-N)",15,0,0,0,15
1812940,1376274,2024-02-05,Senate,"Senate: Reported from Local Government with substitute (8-Y 6-N 1-A)",8,6,1,0,15
1812940,1378053,2024-02-07,Senate,"Senate: Reported from Finance and Appropriations (9-Y 5-N 1-A)",9,5,1,0,15
1812940,1380038,2024-02-08,Senate,"Senate: Constitutional reading dispensed (40-Y 0-N)",40,0,0,0,40
1812940,1382355,2024-02-12,Senate,"Senate: Read third time and passed Senate (34-Y 6-N)",34,6,0,0,40
1812940,1395550,2024-02-27,House,"House: Subcommittee recommends reporting with amendments (5-Y 2-N)",5,2,0,2,9
1812940,1398137,2024-02-28,House,"House: Reported from Counties, Cities and Towns with amendment(s) (19-Y 3-N)",19,3,0,0,22
1812940,1402425,2024-03-04,House,"House: VOTE: Passage (91-Y 7-N)",91,7,0,2,100
1812940,1403388,2024-03-05,Senate,"Senate: House amendment agreed to by Senate (34-Y 6-N)",34,6,0,0,40
1812954,1369010,2024-01-25,House,"House: Subcommittee recommends reporting with substitute (8-Y 0-N)",8,0,0,0,8
1812954,1371481,2024-01-30,House,"House: Reported from Health and Human Services with substitute (22-Y 0-N)",22,0,0,0,22
1812985,1374716,2024-02-02,Senate,"Senate: Reported from Rules (14-Y 0-N)",14,0,0,0,14
1812985,1377875,2024-02-07,Senate,"Senate: Reported from Finance and Appropriations with substitute (15-Y 0-N)",15,0,0,0,15
1812985,1379747,2024-02-08,Senate,"Senate: Constitutional reading dispensed (40-Y 0-N)",40,0,0,0,40
1812985,1381100,2024-02-09,Senate,"Senate: Constitutional reading dispensed (40-Y 0-N)",40,0,0,0,40
1812985,1381101,2024-02-09,Senate,"Senate: Passed Senate (40-Y 0-N)",40,0,0,0,40
1812985,1393203,2024-02-23,House,"House: Subcommittee recommends reporting (6-Y 0-N)",6,0,0,0,6
1812985,1393204,2024-02-23,House,"House: Reported from Rules (16-Y 0-N)",16,0,0,2,18
1812985,1397579,2024-02-28,House,"House: Reported from Appropriations with substitute (20-Y 2-N)",20,2,0,0,22
1812985,1401879,2024-03-04,House,"House: VOTE: Passage (98-Y 0-N)",98,0,0,2,100
1812985,1402977,2024-03-05,Senate,"Senate: House substitute agreed to by Senate (40-Y 0-N)",40,0,0,0,40
1812999,1376969,2024-02-06,House,"House: Subcommittee recommends reporting with substitute (7-Y 0-N)",7,0,0,1,8
1812999,1377818,2024-02-06,House,"House: Reported from General Laws with substitute (20-Y 0-N)",20,0,0,2,22
1813013,1376808,2024-02-06,House,"House: Subcommittee recommends reporting with substitute (8-Y 0-N)",8,0,0,0,8
1813013,1378362,2024-02-07,House,"House: Reported from Education with substitute (22-Y 0-N)",22,0,0,0,22
1813013,1382834,2024-02-13,House,"House: VOTE: Block Vote Passage (99-Y 0-N)",99,0,0,1,100
1813013,1399210,2024-02-29,Senate,"Senate: Reported from Education and Health with substitute (15-Y 0-N)",15,0,0,0,15
1813013,1401014,2024-03-01,Senate,"Senate: Constitutional reading dispensed (40-Y 0-N)",40,0,0,0,40
1813013,1401740,2024-03-04,Senate,"Senate: Passed Senate with substitute (39-Y 0-N)",39,0,0,1,40
1813013,1402894,2024-03-05,House,"House: VOTE: Adoption (99-Y 0-N)",99,0,0,1,100
1813027,1379452,2024-02-08,House,"House: Subcommittee recommends reporting with amendments (8-Y 0-N)",8,0,0,0,8
1813027,1380243,2024-02-08,House,"House: Reported from General Laws with amendment(s) (20-Y 0-N)",20,0,0,2,22
1813027,1383483,2024-02-13,House,"House: VOTE: Block Vote Passage (99-Y 0-N)",99,0,0,1,100
1813027,1398602,2024-02-28,Senate,"Senate: Reported from General Laws and Technology with substitute (14-Y 0-N 1-A)",14,0,1,0,15
1813027,1400742,2024-03-01,Senate,"Senate: Constitutional reading dispensed (40-Y 0-N)",40,0,0,0,40
1813027,1403257,2024-03-05,Senate,"Senate: Passed Senate with substitute (40-Y 0-N)",40,0,0,0,40
1813027,1405264,2024-03-07,House,"House: VOTE: Adoption (99-Y 0-N)",99,0,0,1,100
1813037,1375098,2024-02-02,House,"House: Subcommittee recommends striking from docket (6-Y 0-N)",6,0,0,3,9
1813289,1375547,2024-02-05,House,"House: Subcommittee recommends reporting with amendments (10-Y 0-N)",10,0,0,0,10
1813289,1375658,2024-02-05,House,"House: Reported from Communications, Technology and Innovation with amendment(s) (22-Y 0-N)",22,0,0,0,22
1813289,1380715,2024-02-09,House,"House: Subcommittee recommends reporting with amendments (5-Y 2-N)",5,2,0,2,9
1813289,1380716,2024-02-09,House,"House: Reported from Appropriations with amendment(s) (13-Y 7-N)",13,7,0,2,22
1813289,1383833,2024-02-13,House,"House: VOTE: Passage (71-Y 27-N)",71,27,0,2,100
1813289,1398729,2024-02-28,Senate,"Senate: Continued to 2025 in General Laws and Technology (15-Y 0-N)",15,0,0,0,15
1813291,1379370,2024-02-08,House,"House: Subcommittee recommends laying on the table (5-Y 2-N)",5,2,0,1,8
1813292,1373156,2024-01-31,House,"House: Subcommittee recommends reporting with substitute (8-Y 2-N)",8,2,0,0,10
1813292,1378427,2024-02-07,House,"House: Reported from Agriculture, Chesapeake and Natural Resources with substitute (13-Y 9-N)",13,9,0,0,22
1813292,1383102,2024-02-13,House,"House: VOTE: Passage (52-Y 44-N)",52,44,0,4,100
1813292,1383103,2024-02-13,House,"House: VOTE: Passage #2 (54-Y 44-N)",54,44,0,2,100
1813292,1396755,2024-02-27,Senate,"Senate: Reported from Agriculture, Conservation and Natural Resources with substitute (12-Y 2-N)",12,2,0,0,14
1813292,1399066,2024-02-29,Senate,"Senate: Constitutional reading dispensed (39-Y 0-N)",39,0,0,1,40
1813292,1402236,2024-03-04,Senate,"Senate: Passed Senate with substitute (25-Y 13-N 1-A)",25,13,1,1,40
1813292,1402698,2024-03-05,House,"House: VOTE: Adoption (58-Y 41-N)",58,41,0,1,100
1813293,1375927,2024-02-05,House,"House: Subcommittee recommends reporting (10-Y 0-N)",10,0,0,0,10
1813293,1378013,2024-02-07,House,"House: Reported from Education (22-Y 0-N)",22,0,0,0,22
1813293,1382846,2024-02-13,House,"House: VOTE: Block Vote Passage (99-Y 0-N)",99,0,0,1,100
1813293,1399140,2024-02-29,Senate,"Senate: Reported from Education and Health (15-Y 0-N)",15,0,0,0,15
1813293,1401450,2024-03-04,Senate,"Senate: Reported from Finance and Appropriations with substitute (15-Y 0-N)",15,0,0,0,15
1813293,1403710,2024-03-05,Senate,"Senate: Constitutional reading dispensed (39-Y 0-N)",39,0,0,1,40
1813293,1404766,2024-03-06,Senate,"Senate: Passed Senate with substitute (40-Y 0-N)",40,0,0,0,40
1813293,1405917,2024-03-07,House,"House: VOTE: Adoption (98-Y 0-N)",98,0,0,2,100
1813294,1377107,2024-02-06,House,"House: Subcommittee recommends striking from docket (8-Y 0-N)",8,0,0,0,8
1813304,1375605,2024-02-05,House,"House: Subcommittee recommends reporting with amendments (9-Y 1-N)",9,1,0,0,10
1813304,1378621,2024-02-07,House,"House: Reported from Education with amendment(s) (21-Y 1-N)",21,1,0,0,22
1813304,1383823,2024-02-13,House,"House: VOTE: Passage (96-Y 2-N)",96,2,0,2,100
1813304,1399657,2024-02-29,Senate,"Senate: Reported from Education and Health (15-Y 0-N)",15,0,0,0,15
1813304,1400918,2024-03-01,Senate,"Senate: Constitutional reading dispensed (40-Y 0-N)",40,0,0,0,40
1813304,1402149,2024-03-04,Senate,"Senate: Passed Senate (39-Y 0-N)",39,0,0,1,40
1813324,1372374,2024-01-31,House,"House: Subcommittee recommends laying on the table (5-Y 3-N)",5,3,0,0,8
1813334,1377299,2024-02-06,House,"House: Subcommittee recommends reporting with substitute (7-Y 0-N)",7,0,0,1,8
1813334,1380121,2024-02-08,House,"House: Reported from General Laws with substitute (20-Y 0-N)",20,0,0,2,22
1813334,1383046,2024-02-13,House,"House: VOTE: Block Vote Passage (99-Y 0-N)",99,0,0,1,100
1813334,1390803,2024-02-21,Senate,"Senate: Reported from General Laws and Technology with substitute (15-Y 0-N)",15,0,0,0,15
1813334,1395906,2024-02-27,Senate,"Senate: Constitutional reading dispensed (39-Y 0-N)",39,0,0,1,40
1813334,1395907,2024-02-27,Senate,"Senate: Reported from Finance and Appropriations (15-Y 0-N)",15,0,0,0,15
1813334,1398313,2024-02-28,Senate,"Senate: Passed Senate with substitute (39-Y 0-N)",39,0,0,1,40
1813334,1402737,2024-03-05,House,"House: VOTE: REJECTED (0-Y 99-N 1-A)",0,99,1,0,100
1813334,1404068,2024-03-06,Senate,"Senate: Senate insisted on substitute (40-Y 0-N)",40,0,0,0,40
1813334,1406660,2024-03-09,House,"House: VOTE: Adoption (96-Y 0-N)",96,0,0,4,100
1813334,1406661,2024-03-09,Senate,"Senate: Conference report agreed to by Senate (31-Y 9-N)",31,9,0,0,40
1813364,1378745,2024-02-07,House,"House: Subcommittee recommends passing by indefinitely (8-Y 0-N)",8,0,0,0,8
1813374,1369253,2024-01-25,House,"House: Subcommittee recommends reporting (7-Y 0-N)",7,0,0,1,8
1813374,1371467,2024-01-30,House,"House: Reported from Health and Human Services (22-Y 0-N)",22,0,0,0,22
1813374,1376606,2024-02-05,House,"House: VOTE: Block Vote Passage (98-Y 0-N)",98,0,0,2,100
1813374,1386835,2024-02-16,Senate,"Senate: Reported from Rehabilitation and Social Services (14-Y 0-N)",14,0,0,0,14
1813374,1399454,2024-02-29,Senate,"Senate: Reported from Finance and Appropriations (14-Y 0-N)",14,0,0,0,14
1813374,1401890,2024-03-04,Senate,"Senate: Constitutional reading dispensed (40-Y 0-N)",40,0,0,0,40
1813374,1403252,2024-03-05,Senate,"Senate: Passed Senate (40-Y 0-N)",40,0,0,0,40
1813384,1374875,2024-02-02,House,"House: Subcommittee recommends reporting with amendments (7-Y 0-N)",7,0,0,1,8
1813384,1377141,2024-02-06,House,"House: Reported from Transportation with amendment(s) (22-Y 0-N)",22,0,0,0,22
1813384,1382275,2024-02-12,House,"House: VOTE: Block Vote Passage (100-Y 0-N)",100,0,0,0,100
1813384,1392317,2024-02-22,Senate,"Senate: Reported from Transportation (15-Y 0-N)",15,0,0,0,15
1813384,1394606,2024-02-26,Senate,"Senate: Constitutional reading dispensed (40-Y 0-N)",40,0,0,0,40
1813384,1395969,2024-02-27,Senate,"Senate: Passed Senate (39-Y 0-N)",39,0,0,1,40
1813418,1372676,2024-01-31,House,"House: Subcommittee recommends laying on the table (10-Y 0-N)",10,0,0,0,10
1813460,1373572,2024-02-01,House,"House: Subcommittee recommends reporting with amendments (6-Y 0-N)",6,0,0,0,6
1813460,1374557,2024-02-02,House,"House: Reported from Public Safety with amendment(s) (22-Y 0-N)",22,0,0,0,22
1813460,1380227,2024-02-08,House,"House: VOTE: Block Vote Passage (98-Y 0-N)",98,0,0,2,100
1813460,1391178,2024-02-21,Senate,"Senate: Reported from Courts of Justice (15-Y 0-N)",15,0,0,0,15
1813460,1393452,2024-02-23,Senate,"Senate: Constitutional reading dispensed (38-Y 0-N)",38,0,0,2,40
1813460,1394702,2024-02-26,Senate,"Senate: Passed Senate (40-Y 0-N)",40,0,0,0,40
1813467,1367221,2024-01-22,Senate,"Senate: Passed by indefinitely in Local Government (13-Y 2-N)",13,2,0,0,15
1813470,1369700,2024-01-26,Senate,"Senate: Reported from Rehabilitation and Social Services (15-Y 0-N)",15,0,0,0,15
1813470,1371196,2024-01-29,Senate,"Senate: Constitutional reading dispensed (39-Y 0-N)",39,0,0,1,40
1813470,1372449,2024-01-31,Senate,"Senate: Read third time and passed Senate (40-Y 0-N)",40,0,0,0,40
1813470,1389146,2024-02-20,House,"House: Subcommittee recommends reporting (6-Y 1-N)",6,1,0,1,8
1813470,1392837,2024-02-22,House,"House: Reported from General Laws (22-Y 0-N)",22,0,0,0,22
1813470,1396577,2024-02-27,House,"House: VOTE: Passage (96-Y 1-N)",96,1,0,3,100
1813475,1372014,2024-01-30,Senate,"Senate: Reported from Privileges and Elections with amendment (15-Y 0-N)",15,0,0,0,15
1813475,1374376,2024-02-01,Senate,"Senate: Reading waived (40-Y 0-N)",40,0,0,0,40
1813475,1377081,2024-02-06,Senate,"Senate: Read third time and agreed to by Senate (39-Y 0-N)",39,0,0,1,40
1813475,1378785,2024-02-07,House,"House: Reported from Privileges and Elections (22-Y 0-N)",22,0,0,0,22
1813475,1382928,2024-02-08,House,"House: VOTE: Adoption (97-Y 0-N)",97,0,0,3,100
1813480,1375621,2024-02-05,Senate,"Senate: Failed to report (defeated) in Courts of Justice (5-Y 8-N)",5,8,0,0,13
1813484,1374261,2024-02-01,House,"House: Subcommittee recommends reporting with substitute (5-Y 2-N)",5,2,0,1,8
1813484,1377753,2024-02-06,House,"House: Reported from Labor and Commerce with substitute (12-Y 10-N)",12,10,0,0,22
1813484,1381853,2024-02-12,House,"House: VOTE: Passage (54-Y 46-N)",54,46,0,0,100
1813484,1398603,2024-02-28,Senate,"Senate: Reported from General Laws and Technology with amendments (13-Y 0-N 2-A)",13,0,2,0,15
1813484,1400737,2024-03-01,Senate,"Senate: Constitutional reading dispensed (40-Y 0-N)",40,0,0,0,40
1813484,1403320,2024-03-05,Senate,"Senate: Passed Senate with amendments (34-Y 5-N)",34,5,0,1,40
1813484,1404469,2024-03-06,House,"House: VOTE: Adoption (58-Y 40-N)",58,40,0,2,100
1813489,1370523,2024-01-29,House,"House: Subcommittee recommends reporting (11-Y 0-N)",11,0,0,0,11
1813489,1372450,2024-01-31,House,"House: Reported from Education (22-Y 0-N)",22,0,0,0,22
1813489,1377464,2024-02-06,House,"House: VOTE: Block Vote Passage (99-Y 0-N)",99,0,0,1,100
1813489,1391467,2024-02-22,Senate,"Senate: Reported from Education and Health (15-Y 0-N)",15,0,0,0,15
1813489,1395872,2024-02-27,Senate,"Senate: Continued to 2025 in Finance and Appropriations (15-Y 0-N)",15,0,0,0,15
1813493,1366858,2024-01-19,Senate,"Senate: Reported from Rehabilitation and Social Services (14-Y 0-N 1-A)",14,0,1,0,15
1813493,1368628,2024-01-22,Senate,"Senate: Constitutional reading dispensed (40-Y 0-N)",40,0,0,0,40
1813493,1368629,2024-01-24,Senate,"Senate: Read third time and passed Senate (38-Y 2-N)",38,2,0,0,40
1813493,1368630,2024-01-24,Senate,"Senate: Reconsideration of passage agreed to by Senate (39-Y 1-N)",39,1,0,0,40
1813493,1368631,2024-01-24,Senate,"Senate: Passed Senate (38-Y 2-N)",38,2,0,0,40
1813493,1389558,2024-02-20,House,"House: Subcommittee recommends reporting with substitute (7-Y 0-N)",7,0,0,1,8
1813493,1392854,2024-02-22,House,"House: Reported from General Laws with substitute (22-Y 0-N)",22,0,0,0,22
1813493,1395766,2024-02-27,House,"House: VOTE: Passage (91-Y 5-N)",91,5,0,4,100
1813493,1399168,2024-02-29,Senate,"Senate: House substitute rejected by Senate (0-Y 39-N)",0,39,0,1,40
1813493,1402973,2024-03-05,Senate,"Senate: Senate acceded to request (40-Y 0-N)",40,0,0,0,40
1813493,1404103,2024-03-06,House,"House: VOTE: Adoption (93-Y 4-N)",93,4,0,3,100
1813493,1405140,2024-03-07,Senate,"Senate: Conference report agreed to by Senate (40-Y 0-N)",40,0,0,0,40
1813497,1379790,2024-02-08,Senate,"Senate: Continued to 2025 in Education and Health (15-Y 0-N)",15,0,0,0,15
1813501,1367500,2024-01-22,Senate,"Senate: Reported from Commerce and Labor with amendments (14-Y 0-N)",14,0,0,0,14
1813501,1368756,2024-01-24,Senate,"Senate: Constitutional reading dispensed (40-Y 0-N)",40,0,0,0,40
1813501,1369986,2024-01-26,Senate,"Senate: Read third time and passed Senate (38-Y 0-N)",38,0,0,2,40
1813501,1386278,2024-02-15,House,"House: Reported from Labor and Commerce (19-Y 0-N)",19,0,0,3,22
1813501,1388591,2024-02-20,House,"House: VOTE: Block Vote Passage (98-Y 0-N)",98,0,0,2,100
1813507,1371982,2024-01-30,Senate,"Senate: Reported from Privileges and Elections with amendment (15-Y 0-N)",15,0,0,0,15
1813507,1374384,2024-02-01,Senate,"Senate: Reading waived (40-Y 0-N)",40,0,0,0,40
1813507,1377074,2024-02-06,Senate,"Senate: Read third time and agreed to by Senate (39-Y 0-N)",39,0,0,1,40
1813507,1378737,2024-02-07,House,"House: Reported from Privileges and Elections (22-Y 0-N)",22,0,0,0,22
1813507,1382876,2024-02-08,House,"House: VOTE: Adoption (95-Y 0-N 1-A)",95,0,1,4,100
1813510,1372062,2024-01-30,Senate,"Senate: Reported from Privileges and Elections with amendment (15-Y 0-N)",15,0,0,0,15
1813510,1374378,2024-02-01,Senate,"Senate: Reading waived (40-Y 0-N)",40,0,0,0,40
1813510,1376301,2024-02-05,Senate,"Senate: Amendment by Senator Stuart agreed to (22-Y 18-N)",22,18,0,0,40
1813510,1376302,2024-02-05,Senate,"Senate: Amendment by Senator (Stuart) reconsidered (39-Y 0-N)",39,0,1,0,40
1813510,1376303,2024-02-05,Senate,"Senate: Amendment by Senator Stuart agreed to (21-Y 17-N 1-A)",21,17,1,1,40
1813510,1377078,2024-02-06,Senate,"Senate: Read third time and agreed to by Senate (34-Y 0-N)",34,0,0,6,40
1813510,1378928,2024-02-07,House,"House: Reported from Privileges and Elections (21-Y 0-N)",21,0,1,0,22
1813510,1380254,2024-02-08,House,"House: VOTE: Adoption except lines 43-44 (97-Y 0-N)",97,0,0,3,100
1813510,1380255,2024-02-08,House,"House: VOTE: Lines 43-44 and 83-85 Adopti (95-Y 0-N 2-A)",95,0,2,3,100
1813515,1370271,2024-01-29,Senate,"Senate: Stricken at request of Patron in Local Government (15-Y 0-N)",15,0,0,0,15
1813520,1371777,2024-01-30,Senate,"Senate: Reported from Privileges and Elections with amendment (15-Y 0-N)",15,0,0,0,15
1813520,1374130,2024-02-01,Senate,"Senate: Reading waived (40-Y 0-N)",40,0,0,0,40
1813520,1376909,2024-02-06,Senate,"Senate: Read third time and agreed to by Senate (39-Y 0-N)",39,0,0,1,40
1813520,1378932,2024-02-07,House,"House: Reported from Privileges and Elections (22-Y 0-N)",22,0,0,0,22
1813520,1382723,2024-02-08,House,"House: VOTE: Adoption (94-Y 0-N 3-A)",94,0,3,3,100
1813528,1376419,2024-02-05,Senate,"Senate: Reported from Commerce and Labor with amendments (15-Y 0-N)",15,0,0,0,15
1813528,1378051,2024-02-07,Senate,"Senate: Constitutional reading dispensed (40-Y 0-N)",40,0,0,0,40
1813528,1379934,2024-02-08,Senate,"Senate: Constitutional reading dispensed (40-Y 0-N)",40,0,0,0,40
1813528,1379935,2024-02-08,Senate,"Senate: Read third time and passed Senate (40-Y 0-N)",40,0,0,0,40
1813528,1385404,2024-02-15,House,"House: Reported from Labor and Commerce (19-Y 0-N)",19,0,0,3,22
1813528,1388799,2024-02-20,House,"House: VOTE: Block Vote Passage (98-Y 0-N)",98,0,0,2,100
1813534,1370503,2024-01-29,Senate,"Senate: Reported from Courts of Justice with amendments (9-Y 6-N)",9,6,0,0,15
1813534,1377874,2024-02-07,Senate,"Senate: Reported from Finance and Appropriations with amendment (10-Y 5-N)",10,5,0,0,15
1813534,1379851,2024-02-08,Senate,"Senate: Constitutional reading dispensed (40-Y 0-N)",40,0,0,0,40
1813534,1382005,2024-02-12,Senate,"Senate: Read third time and passed Senate (21-Y 19-N)",21,19,0,0,40
1813534,1387001,2024-02-16,House,"House: Reported from Courts of Justice with substitute (12-Y 10-N)",12,10,0,0,22
1813534,1390627,2024-02-21,House,"House: Reported from Appropriations (15-Y 7-N)",15,7,0,0,22
1813534,1394874,2024-02-26,House,"House: VOTE: Passage (52-Y 42-N)",52,42,0,6,100
1813534,1397828,2024-02-28,Senate,"Senate: House substitute agreed to by Senate (20-Y 19-N)",20,19,0,1,40
1813537,1371016,2024-01-29,Senate,"Senate: Stricken at request of Patron in Courts of Justice (12-Y 0-N)",12,0,0,0,12
1813541,1373266,2024-01-31,House,"House: Subcommittee recommends reporting with substitute (8-Y 0-N)",8,0,0,1,9
1813541,1375897,2024-02-02,House,"House: Reported from Courts of Justice with substitute (20-Y 0-N)",20,0,0,2,22
1813541,1380134,2024-02-08,House,"House: VOTE: Block Vote Passage (98-Y 0-N)",98,0,0,2,100
1813541,1398724,2024-02-28,Senate,"Senate: Reported from Courts of Justice (14-Y 0-N)",14,0,0,0,14
1813541,1401043,2024-03-01,Senate,"Senate: Constitutional reading dispensed (40-Y 0-N)",40,0,0,0,40
1813541,1401767,2024-03-04,Senate,"Senate: Passed Senate (39-Y 0-N)",39,0,0,1,40
1813541,1429706,2024-04-17,Senate,"Senate: Senate concurred in Governor's recommendation (40-Y 0-N)",40,0,0,0,40
1813541,1430331,2024-04-17,House,"House: VOTE: (100-Y 0-N)",100,0,0,0,100
1813638,1372086,2024-01-30,House,"House: Subcommittee recommends reporting (10-Y 0-N)",10,0,0,0,10
1813638,1374148,2024-02-01,House,"House: Reported from Labor and Commerce (22-Y 0-N)",22,0,0,0,22
1813638,1378669,2024-02-07,House,"House: VOTE: Block Vote Passage (100-Y 0-N)",100,0,0,0,100
1813638,1401898,2024-03-04,Senate,"Senate: Reported from Commerce and Labor (14-Y 0-N)",14,0,0,0,14
1813638,1402996,2024-03-05,Senate,"Senate: Constitutional reading dispensed (40-Y 0-N)",40,0,0,0,40
1813638,1404249,2024-03-06,Senate,"Senate: Passed Senate (40-Y 0-N)",40,0,0,0,40
1813639,1376526,2024-02-05,House,"House: Subcommittee recommends reporting with substitute (8-Y 0-N)",8,0,0,1,9
1813639,1378931,2024-02-07,House,"House: Reported from Appropriations with substitute (22-Y 0-N)",22,0,0,0,22
1813639,1383105,2024-02-13,House,"House: VOTE: Passage (90-Y 9-N)",90,9,0,1,100
1813639,1396190,2024-02-27,Senate,"Senate: Continued to 2025 in Finance and Appropriations (15-Y 0-N)",15,0,0,0,15
1813642,1372774,2024-01-31,House,"House: Subcommittee recommends reporting (10-Y 0-N)",10,0,0,0,10
1813642,1378719,2024-02-07,House,"House: Reported from Agriculture, Chesapeake and Natural Resources (22-Y 0-N)",22,0,0,0,22
1813642,1383924,2024-02-13,House,"House: VOTE: Block Vote Passage (99-Y 0-N)",99,0,0,1,100
1813642,1389554,2024-02-20,Senate,"Senate: Reported from Agriculture, Conservation and Natural Resources (15-Y 0-N)",15,0,0,0,15
1813642,1392902,2024-02-22,Senate,"Senate: Constitutional reading dispensed (40-Y 0-N)",40,0,0,0,40
1813642,1393850,2024-02-23,Senate,"Senate: Passed Senate (39-Y 0-N)",39,0,0,1,40
1813667,1379862,2024-02-08,House,"House: Subcommittee recommends reporting (7-Y 0-N)",7,0,0,1,8
1813667,1379863,2024-02-08,House,"House: Reported from General Laws (20-Y 0-N)",20,0,0,2,22
1813667,1382785,2024-02-13,House,"House: VOTE: Block Vote Passage (99-Y 0-N)",99,0,0,1,100
1813667,1390310,2024-02-21,Senate,"Senate: Reported from General Laws and Technology (15-Y 0-N)",15,0,0,0,15
1813667,1393461,2024-02-23,Senate,"Senate: Constitutional reading dispensed (38-Y 0-N)",38,0,0,2,40
1813667,1395115,2024-02-26,Senate,"Senate: Passed Senate (40-Y 0-N)",40,0,0,0,40
1813714,1372225,2024-01-30,House,"House: Subcommittee recommends striking from docket (8-Y 0-N)",8,0,0,1,9
1813739,1378487,2024-02-07,House,"House: Reported from Agriculture, Chesapeake and Natural Resources with substitute (20-Y 2-N)",20,2,0,0,22
1813739,1383215,2024-02-13,House,"House: VOTE: Passage (88-Y 11-N)",88,11,0,1,100
1813739,1389339,2024-02-20,Senate,"Senate: Reported from Agriculture, Conservation and Natural Resources (15-Y 0-N)",15,0,0,0,15
1813739,1392666,2024-02-22,Senate,"Senate: Constitutional reading dispensed (40-Y 0-N)",40,0,0,0,40
1813739,1394042,2024-02-23,Senate,"Senate: Passed Senate (39-Y 0-N)",39,0,0,1,40
1813766,1374333,2024-02-01,House,"House: Reported from Rules (17-Y 0-N)",17,0,1,0,18
1813766,1377500,2024-02-06,House,"House: VOTE: Adoption (98-Y 0-N 1-A)",98,0,1,1,100
1813837,1371744,2024-01-30,House,"House: Subcommittee recommends laying on the table (8-Y 0-N)",8,0,0,0,8
1813930,1373164,2024-01-31,House,"House: Subcommittee recommends passing by indefinitely (6-Y 4-N)",6,4,0,0,10
1813966,1373529,2024-02-01,House,"House: Subcommittee recommends reporting with substitute (6-Y 0-N)",6,0,0,0,6
1813966,1374531,2024-02-02,House,"House: Reported from Public Safety with substitute (22-Y 0-N)",22,0,0,0,22
1813966,1378140,2024-02-07,House,"House: Subcommittee recommends reporting (8-Y 0-N)",8,0,0,1,9
1813966,1378769,2024-02-07,House,"House: Reported from Appropriations (22-Y 0-N)",22,0,0,0,22
1813966,1382831,2024-02-13,House,"House: VOTE: Block Vote Passage (99-Y 0-N)",99,0,0,1,100
1813966,1391064,2024-02-21,Senate,"Senate: Reported from Courts of Justice (9-Y 0-N)",9,0,0,0,9
1813966,1394098,2024-02-23,Senate,"Senate: Constitutional reading dispensed (38-Y 0-N)",38,0,0,2,40
1813966,1395187,2024-02-26,Senate,"Senate: Passed Senate (40-Y 0-N)",40,0,0,0,40
1813997,1378635,2024-02-07,House,"House: Stricken from docket by Education (19-Y 2-N)",19,2,0,1,22
1814065,1377963,2024-02-07,House,"House: Stricken from docket by Education (19-Y 2-N)",19,2,0,1,22
1814098,1373922,2024-02-01,House,"House: Subcommittee recommends reporting with amendments (7-Y 2-N)",7,2,0,1,10
1814098,1374729,2024-02-02,House,"House: Reported from Public Safety with amendment(s) (12-Y 10-N)",12,10,0,0,22
1814098,1379532,2024-02-08,House,"House: VOTE: Passage (51-Y 46-N)",51,46,0,3,100
1814098,1394261,2024-02-26,Senate,"Senate: Reported from Courts of Justice (9-Y 6-N)",9,6,0,0,15
1814098,1396032,2024-02-27,Senate,"Senate: Constitutional reading dispensed (39-Y 0-N)",39,0,0,1,40
1814098,1398343,2024-02-28,Senate,"Senate: Passed Senate (20-Y 19-N)",20,19,0,1,40
1814202,1373812,2024-02-01,House,"House: Subcommittee recommends reporting (8-Y 0-N)",8,0,0,0,8
1814202,1376869,2024-02-06,House,"House: Reported from Health and Human Services (22-Y 0-N)",22,0,0,0,22
1814202,1382395,2024-02-12,House,"House: VOTE: Block Vote Passage (100-Y 0-N)",100,0,0,0,100
1814202,1399855,2024-02-29,Senate,"Senate: Reported from Education and Health with amendments (15-Y 0-N)",15,0,0,0,15
1814202,1401071,2024-03-01,Senate,"Senate: Constitutional reading dispensed (40-Y 0-N)",40,0,0,0,40
1814202,1402308,2024-03-04,Senate,"Senate: Passed Senate with amendments (39-Y 0-N)",39,0,0,1,40
1814202,1403605,2024-03-05,House,"House: VOTE: Adoption (86-Y 0-N)",86,0,0,14,100
1817833,1374296,2024-02-01,House,"House: Subcommittee recommends reporting with substitute (6-Y 2-N)",6,2,0,0,8
1817833,1377730,2024-02-06,House,"House: Reported from General Laws with substitute (11-Y 8-N)",11,8,0,3,22
1817833,1382052,2024-02-12,House,"House: VOTE: Passage (54-Y 46-N)",54,46,0,0,100
1817833,1398571,2024-02-28,Senate,"Senate: Reported from General Laws and Technology (9-Y 6-N)",9,6,0,0,15
1817833,1400688,2024-03-01,Senate,"Senate: Constitutional reading dispensed (40-Y 0-N)",40,0,0,0,40
1817833,1403336,2024-03-05,Senate,"Senate: Passed Senate (21-Y 19-N)",21,19,0,0,40
1817836,1375557,2024-02-05,House,"House: Subcommittee recommends reporting (5-Y 3-N)",5,3,0,1,9
1817836,1381108,2024-02-09,House,"House: Reported from Courts of Justice (13-Y 9-N)",13,9,0,0,22
1817836,1383731,2024-02-13,House,"House: VOTE: Passage (72-Y 26-N)",72,26,0,2,100
1817836,1391085,2024-02-21,Senate,"Senate: Reported from Courts of Justice with substitute (14-Y 0-N 1-A)",14,0,1,0,15
1817836,1393799,2024-02-23,Senate,"Senate: Constitutional reading dispensed (38-Y 0-N)",38,0,0,2,40
1817836,1394416,2024-02-26,Senate,"Senate: Passed Senate with substitute (37-Y 2-N 1-A)",37,2,1,0,40
1817836,1398714,2024-02-28,House,"House: VOTE: Adoption (88-Y 12-N)",88,12,0,0,100
1817843,1377525,2024-02-06,House,"House: Subcommittee recommends reporting (4-Y 2-N)",4,2,0,1,7
1817843,1380283,2024-02-08,House,"House: Reported from Labor and Commerce (21-Y 0-N)",21,0,0,1,22
1817843,1383773,2024-02-13,House,"House: VOTE: Block Vote Passage (99-Y 0-N)",99,0,0,1,100
1817843,1402497,2024-03-04,Senate,"Senate: Reported from Commerce and Labor (14-Y 0-N)",14,0,0,0,14
1817843,1403742,2024-03-05,Senate,"Senate: Constitutional reading dispensed (40-Y 0-N)",40,0,0,0,40
1817843,1404024,2024-03-06,Senate,"Senate: Passed Senate (40-Y 0-N)",40,0,0,0,40
1817849,1379448,2024-02-08,House,"House: Subcommittee recommends reporting with substitute (5-Y 3-N)",5,3,0,0,8
1817849,1380423,2024-02-08,House,"House: Reported from General Laws with substitute (12-Y 8-N)",12,8,0,2,22
1817849,1383877,2024-02-13,House,"House: VOTE: Passage (51-Y 46-N)",51,46,0,3,100
1817849,1398711,2024-02-28,Senate,"Senate: Reported from General Laws and Technology with substitute (13-Y 2-N)",13,2,0,0,15
1817849,1401445,2024-03-04,Senate,"Senate: Reported from Finance and Appropriations with amendments (11-Y 4-N)",11,4,0,0,15
1817849,1403697,2024-03-05,Senate,"Senate: Constitutional reading dispensed (39-Y 0-N)",39,0,0,1,40
1817849,1404705,2024-03-06,Senate,"Senate: Passed Senate with substitute with amendments (22-Y 18-N)",22,18,0,0,40
1817849,1405545,2024-03-07,House,"House: VOTE: Adoption (51-Y 48-N)",51,48,0,1,100
1817849,1430219,2024-04-17,House,"House: VOTE: Adoption (54-Y 45-N)",54,45,0,1,100
1817849,1430220,2024-04-17,Senate,"Senate: Senate concurred in Governor's recommendation (40-Y 0-N)",40,0,0,0,40
1817851,1369786,2024-01-26,House,"House: Subcommittee recommends reporting (8-Y 0-N)",8,0,0,0,8
1817851,1369787,2024-01-26,House,"House: Reported from Counties, Cities and Towns (11-Y 8-N)",11,8,1,2,22
1817851,1374090,2024-02-01,House,"House: VOTE: Passage (52-Y 47-N)",52,47,0,1,100
1817851,1394607,2024-02-26,Senate,"Senate: Reported from Local Government with amendment (9-Y 6-N)",9,6,0,0,15
1817851,1395801,2024-02-27,Senate,"Senate: Constitutional reading dispensed (39-Y 0-N)",39,0,0,1,40
1817851,1398712,2024-02-28,Senate,"Senate: Passed Senate with amendments (28-Y 11-N)",28,11,0,1,40
1817851,1400575,2024-03-01,House,"House: VOTE: Adoption (55-Y 42-N)",55,42,0,3,100
1817854,1371596,2024-01-30,House,"House: Subcommittee recommends reporting (5-Y 3-N)",5,3,0,0,8
1817854,1373601,2024-02-01,House,"House: Reported from Transportation with amendment(s) (12-Y 10-N)",12,10,0,0,22
1818288,1372247,2024-01-30,House,"House: Subcommittee recommends reporting (8-Y 0-N)",8,0,0,0,8
1818288,1374310,2024-02-01,House,"House: Reported from General Laws (22-Y 0-N)",22,0,0,0,22
1818288,1378892,2024-02-07,House,"House: VOTE: Block Vote Passage (100-Y 0-N)",100,0,0,0,100
1818288,1384465,2024-02-14,Senate,"Senate: Reported from General Laws and Technology (14-Y 0-N 1-A)",14,0,1,0,15
1818288,1386699,2024-02-16,Senate,"Senate: Constitutional reading dispensed (38-Y 0-N)",38,0,0,2,40
1818288,1388099,2024-02-19,Senate,"Senate: Passed Senate (37-Y 2-N)",37,2,0,1,40
1818423,1374343,2024-02-01,House,"House: Reported from Rules (18-Y 0-N)",18,0,0,0,18
1818423,1377792,2024-02-06,House,"House: VOTE: Block Vote Adoption (98-Y 0-N)",98,0,0,2,100
1818423,1394900,2024-02-26,Senate,"Senate: Reading waived (40-Y 0-N)",40,0,0,0,40
1818445,1377224,2024-02-06,House,"House: Subcommittee recommends striking from docket (8-Y 0-N)",8,0,0,1,9
1818525,1370017,2024-01-26,House,"House: Reported from Rules with substitute (14-Y 3-N)",14,3,0,1,18
1818525,1378475,2024-02-07,House,"House: Subcommittee recommends reporting with substitute (6-Y 2-N)",6,2,0,1,9
1818525,1378476,2024-02-07,House,"House: Reported from Appropriations with substitute (15-Y 7-N)",15,7,0,0,22
1818525,1383926,2024-02-13,House,"House: VOTE: Passage (73-Y 26-N)",73,26,0,1,100
1818525,1400928,2024-03-01,Senate,"Senate: Reported from Rules (9-Y 4-N)",9,4,0,0,13
1818525,1402172,2024-03-04,Senate,"Senate: Constitutional reading dispensed (40-Y 0-N)",40,0,0,0,40
1818525,1403449,2024-03-05,Senate,"Senate: Passed Senate (20-Y 19-N)",20,19,0,1,40
1818525,1429603,2024-04-17,Senate,"Senate: Senate concurred in Governor's recommendation (40-Y 0-N)",40,0,0,0,40
1818525,1430314,2024-04-17,House,"House: VOTE: Adoption (64-Y 34-N 1-A)",64,34,1,1,100
1818555,1370274,2024-01-29,House,"House: Subcommittee recommends reporting (8-Y 0-N)",8,0,0,1,9
1818555,1371183,2024-01-29,House,"House: Reported from Appropriations (21-Y 0-N)",21,0,0,1,22
1818555,1375028,2024-02-02,House,"House: VOTE: Block Vote Passage (92-Y 0-N)",92,0,0,8,100
1818555,1402244,2024-03-04,Senate,"Senate: Reported from Finance and Appropriations with amendment (15-Y 0-N)",15,0,0,0,15
1818555,1403571,2024-03-05,Senate,"Senate: Constitutional reading dispensed (39-Y 0-N)",39,0,0,1,40
1818555,1404657,2024-03-06,Senate,"Senate: Passed Senate with amendment",40,0,0,0,40
1818555,1405778,2024-03-07,House,"House: VOTE: REJECTED (1-Y 97-N)",1,97,0,2,100
1818555,1405779,2024-03-07,Senate,"Senate: Senate insisted on amendment (40-Y 0-N)",40,0,0,0,40
1818555,1406462,2024-03-08,Senate,"Senate: Conference report agreed to by Senate (39-Y 0-N)",39,0,0,1,40
1818555,1406463,2024-03-08,House,"House: VOTE: Adoption (96-Y 0-N)",96,0,0,4,100
1818584,1371451,2024-01-30,House,"House: Subcommittee recommends reporting with amendments (8-Y 0-N)",8,0,0,0,8
1818584,1373685,2024-02-01,House,"House: Reported from Transportation with amendment(s) (21-Y 0-N)",21,0,0,1,22
1818584,1378890,2024-02-07,House,"House: VOTE: Block Vote Passage (100-Y 0-N)",100,0,0,0,100
1818584,1386425,2024-02-15,Senate,"Senate: Reported from Transportation (12-Y 0-N)",12,0,0,0,12
1818584,1388142,2024-02-19,Senate,"Senate: Constitutional reading dispensed (38-Y 0-N)",38,0,0,2,40
1818584,1389264,2024-02-20,Senate,"Senate: Passed Senate (40-Y 0-N)",40,0,0,0,40
1818609,1372045,2024-01-30,House,"House: Subcommittee recommends reporting with amendments (6-Y 1-N)",6,1,0,0,7
1818609,1374180,2024-02-01,House,"House: Reported from Labor and Commerce with amendment(s) (22-Y 0-N)",22,0,0,0,22
1818609,1378331,2024-02-07,House,"House: VOTE: Block Vote Passage (100-Y 0-N)",100,0,0,0,100
1818609,1387576,2024-02-19,Senate,"Senate: Reported from Commerce and Labor (15-Y 0-N)",15,0,0,0,15
1818609,1389991,2024-02-21,Senate,"Senate: Constitutional reading dispensed (40-Y 0-N)",40,0,0,0,40
1818609,1392292,2024-02-22,Senate,"Senate: Passed Senate (40-Y 0-N)",40,0,0,0,40
1818635,1376118,2024-02-05,House,"House: Subcommittee recommends reporting with substitute (8-Y 2-N)",8,2,0,0,10
1818635,1378656,2024-02-07,House,"House: Reported from Agriculture, Chesapeake and Natural Resources with substitute (20-Y 2-N)",20,2,0,0,22
1818635,1383922,2024-02-13,House,"House: VOTE: Defeated (46-Y 52-N)",46,52,0,2,100
1818693,1376027,2024-02-05,House,"House: Subcommittee recommends reporting (10-Y 0-N)",10,0,0,0,10
1818693,1378853,2024-02-07,House,"House: Reported from Agriculture, Chesapeake and Natural Resources (22-Y 0-N)",22,0,0,0,22
1818693,1383789,2024-02-13,House,"House: VOTE: Block Vote Passage (99-Y 0-N)",99,0,0,1,100
1818693,1389593,2024-02-20,Senate,"Senate: Reported from Agriculture, Conservation and Natural Resources with substitute (15-Y 0-N)",15,0,0,0,15
1818693,1399395,2024-02-29,Senate,"Senate: Continued to 2025 in Finance and Appropriations (12-Y 2-N)",12,2,0,0,14
1818716,1370887,2024-01-29,House,"House: Subcommittee recommends reporting with substitute (5-Y 2-N)",5,2,0,1,8
1818716,1374624,2024-02-02,House,"House: Reported from Privileges and Elections with substitute (11-Y 9-N)",11,9,0,2,22
1818716,1375678,2024-02-02,House,"House: Reported from Privileges and Elections with substitute (12-Y 10-N)",12,10,0,0,22
1818716,1380276,2024-02-08,House,"House: VOTE: Passage (51-Y 47-N)",51,47,0,2,100
1818716,1389615,2024-02-20,Senate,"Senate: Reported from Privileges and Elections (8-Y 7-N)",8,7,0,0,15
1818716,1392909,2024-02-22,Senate,"Senate: Constitutional reading dispensed (40-Y 0-N)",40,0,0,0,40
1818716,1394108,2024-02-23,Senate,"Senate: Passed Senate (21-Y 18-N)",21,18,0,1,40
1818742,1373592,2024-02-01,House,"House: Subcommittee recommends reporting (8-Y 0-N)",8,0,0,0,8
1818742,1374914,2024-02-02,House,"House: Reported from Counties, Cities and Towns (22-Y 0-N)",22,0,0,0,22
1818742,1380197,2024-02-08,House,"House: VOTE: Block Vote Passage (98-Y 0-N)",98,0,0,2,100
1818742,1387656,2024-02-19,Senate,"Senate: Reported from Local Government with amendment (15-Y 0-N)",15,0,0,0,15
1818742,1388509,2024-02-20,Senate,"Senate: Constitutional reading dispensed (39-Y 0-N)",39,0,0,1,40
1818742,1390515,2024-02-21,Senate,"Senate: Passed Senate with amendment (40-Y 0-N)",40,0,0,0,40
1818742,1393704,2024-02-23,House,"House: VOTE: Adoption (90-Y 4-N 1-A)",90,4,1,5,100
1818768,1375721,2024-02-05,House,"House: Subcommittee recommends striking from docket (8-Y 0-N)",8,0,0,1,9
1818796,1375684,2024-02-05,House,"House: Subcommittee recommends laying on the table (5-Y 3-N)",5,3,0,1,9
1818826,1379880,2024-02-08,House,"House: Subcommittee recommends reporting (7-Y 0-N)",7,0,0,1,8
1818826,1379881,2024-02-08,House,"House: Reported from General Laws (20-Y 0-N)",20,0,0,2,22
1818826,1382926,2024-02-13,House,"House: VOTE: Block Vote Passage (99-Y 0-N)",99,0,0,1,100
1818826,1398735,2024-02-28,Senate,"Senate: Reported from General Laws and Technology (14-Y 1-N)",14,1,0,0,15
1818826,1401228,2024-03-01,Senate,"Senate: Constitutional reading dispensed (40-Y 0-N)",40,0,0,0,40
1818826,1403722,2024-03-05,Senate,"Senate: Passed Senate (37-Y 3-N)",37,3,0,0,40
1818852,1376470,2024-02-05,House,"House: Subcommittee recommends continuing to 2025 with substitute (7-Y 0-N)",7,0,0,1,8
1818879,1373577,2024-02-01,House,"House: Subcommittee recommends reporting with substitute (4-Y 2-N)",4,2,0,0,6
1818879,1374495,2024-02-02,House,"House: Reported from Public Safety with substitute (14-Y 8-N)",14,8,0,0,22
1818879,1380176,2024-02-08,House,"House: VOTE: Passage (59-Y 39-N)",59,39,0,2,100
1818879,1393199,2024-02-23,Senate,"Senate: Reported from Rehabilitation and Social Services (15-Y 0-N)",15,0,0,0,15
1818879,1397541,2024-02-28,Senate,"Senate: Continued to 2025 in Finance and Appropriations (15-Y 0-N)",15,0,0,0,15
1818920,1371739,2024-01-30,Senate,"Senate: Stricken at request of Patron in Agriculture, Conservation and Natural Resources (15-Y 0-N)",15,0,0,0,15
1818952,1368083,2024-01-23,Senate,"Senate: Passed by indefinitely in Agriculture, Conservation and Natural Resources (9-Y 6-N)",9,6,0,0,15
1818952,1371766,2024-01-30,Senate,"Senate: Continued to 2025 in Agriculture, Conservation and Natural Resources (9-Y 6-N)",9,6,0,0,15
1818988,1367780,2024-01-23,Senate,"Senate: Reported from Agriculture, Conservation and Natural Resources (15-Y 0-N)",15,0,0,0,15
1818988,1371482,2024-01-30,Senate,"Senate: Reported from Finance and Appropriations (15-Y 0-N)",15,0,0,0,15
1818988,1372465,2024-01-31,Senate,"Senate: Constitutional reading dispensed (40-Y 0-N)",40,0,0,0,40
1818988,1432059,2024-02-15,House,"House: Reported from Health and Human Services (22-Y 0-N)",22,0,0,0,22
1818988,1432060,2024-02-20,House,"House: VOTE: Block Vote Passage (98-Y 0-N)",98,0,0,2,100
1819025,1373583,2024-02-01,House,"House: Subcommittee recommends reporting (5-Y 3-N)",5,3,0,0,8
1819025,1374913,2024-02-02,House,"House: Reported from Counties, Cities and Towns (13-Y 9-N)",13,9,0,0,22
1819025,1380245,2024-02-08,House,"House: VOTE: Passage (54-Y 44-N)",54,44,0,2,100
1819025,1394499,2024-02-26,Senate,"Senate: Reported from Local Government (10-Y 3-N 2-A)",10,3,2,0,15
1819025,1395722,2024-02-27,Senate,"Senate: Constitutional reading dispensed (39-Y 0-N)",39,0,0,1,40
1819025,1398678,2024-02-28,Senate,"Senate: Passed Senate (24-Y 15-N)",24,15,0,1,40
1819025,1429743,2024-04-17,Senate,"Senate: Senate concurred in Governor's recommendation (40-Y 0-N)",40,0,0,0,40
1819025,1430892,2024-04-17,House,"House: VOTE: Adoption (62-Y 38-N)",62,38,0,0,100
1819065,1376660,2024-02-05,Senate,"Senate: Reported from Commerce and Labor (15-Y 0-N)",15,0,0,0,15
1819065,1381600,2024-02-12,Senate,"Senate: Continued to 2025 in Finance and Appropriations (14-Y 1-N)",14,1,0,0,15
1819101,1368577,2024-01-24,Senate,"Senate: Passed by indefinitely in Courts of Justice (9-Y 6-N)",9,6,0,0,15
1819137,1367637,2024-01-23,Senate,"Senate: Reported from Finance and Appropriations with substitute (14-Y 0-N)",14,0,0,0,14
1819137,1368447,2024-01-24,Senate,"Senate: Constitutional reading dispensed (40-Y 0-N)",40,0,0,0,40
1819137,1369939,2024-01-26,Senate,"Senate: Read third time and passed Senate (38-Y 0-N)",38,0,0,2,40
1819137,1384414,2024-02-14,House,"House: Reported from Finance (22-Y 0-N)",22,0,0,0,22
1819137,1387517,2024-02-19,House,"House: VOTE: Block Vote Passage (99-Y 0-N)",99,0,0,1,100
1819176,1372024,2024-01-30,Senate,"Senate: Reported from Privileges and Elections (15-Y 0-N)",15,0,0,0,15
1819176,1374379,2024-02-01,Senate,"Senate: Reading waived (40-Y 0-N)",40,0,0,0,40
1819176,1377083,2024-02-06,Senate,"Senate: Read third time and agreed to by Senate (39-Y 0-N)",39,0,0,1,40
1819176,1378916,2024-02-07,House,"House: Reported from Privileges and Elections (22-Y 0-N)",22,0,0,0,22
1819176,1382901,2024-02-08,House,"House: VOTE: Adoption (95-Y 0-N)",95,0,0,5,100
1819212,1371745,2024-01-30,Senate,"Senate: Reported from Agriculture, Conservation and Natural Resources (15-Y 0-N)",15,0,0,0,15
1819212,1374162,2024-02-01,Senate,"Senate: Constitutional reading dispensed (40-Y 0-N)",40,0,0,0,40
1819212,1376446,2024-02-05,Senate,"Senate: Read third time and passed Senate (40-Y 0-N)",40,0,0,0,40
1819212,1384124,2024-02-14,House,"House: Reported from Agriculture, Chesapeake and Natural Resources (21-Y 0-N)",21,0,0,1,22
1819212,1387411,2024-02-19,House,"House: VOTE: Block Vote Passage (99-Y 0-N)",99,0,0,1,100
1819249,1372822,2024-01-31,Senate,"Senate: Failed to report (defeated) in General Laws and Technology (3-Y 12-N)",3,12,0,0,15
1819289,1368913,2024-01-24,Senate,"Senate: Reported from General Laws and Technology with substitute (10-Y 4-N 1-A)",10,4,1,0,15
1819289,1377504,2024-02-06,Senate,"Senate: Continued to 2025 in Finance and Appropriations (13-Y 2-N)",13,2,0,0,15
1819325,1370670,2024-01-29,Senate,"Senate: Reported from Local Government (13-Y 2-N)",13,2,0,0,15
1819325,1378520,2024-02-07,Senate,"Senate: Passed by indefinitely in Finance and Appropriations (11-Y 4-N)",11,4,0,0,15
1819360,1380541,2024-02-09,Senate,"Senate: Continued to 2025 in Commerce and Labor (11-Y 4-N)",11,4,0,0,15
1819400,1377133,2024-02-06,Senate,"Senate: Continued to 2025 in Finance and Appropriations (14-Y 0-N)",14,0,0,0,14
1819436,1379078,2024-02-08,Senate,"Senate: Passed by indefinitely in Education and Health (9-Y 6-N)",9,6,0,0,15
1819475,1374803,2024-02-02,Senate,"Senate: Reported from Rehabilitation and Social Services (15-Y 0-N)",15,0,0,0,15
1819475,1380383,2024-02-08,Senate,"Senate: Reported from Finance and Appropriations with substitute (15-Y 0-N)",15,0,0,0,15
1819475,1381185,2024-02-09,Senate,"Senate: Constitutional reading dispensed (39-Y 0-N)",39,0,0,1,40
1819475,1382032,2024-02-12,Senate,"Senate: Constitutional reading dispensed (40-Y 0-N)",40,0,0,0,40
1819475,1382033,2024-02-12,Senate,"Senate: Passed Senate (40-Y 0-N)",40,0,0,0,40
1819475,1391933,2024-02-22,House,"House: Subcommittee recommends reporting with substitute (8-Y 0-N)",8,0,0,0,8
1819475,1395562,2024-02-27,House,"House: Reported from Health and Human Services with substitute (21-Y 0-N)",21,0,0,1,22
1819475,1400546,2024-03-01,House,"House: VOTE: Passage (96-Y 0-N)",96,0,0,4,100
1819475,1402820,2024-03-05,Senate,"Senate: House substitute with amendment agreed to by Senate (40-Y 0-N)",40,0,0,0,40
1819511,1378488,2024-02-07,Senate,"Senate: Reported from General Laws and Technology with substitute (14-Y 1-N)",14,1,0,0,15
1819511,1379840,2024-02-08,Senate,"Senate: Constitutional reading dispensed (40-Y 0-N)",40,0,0,0,40
1819511,1381479,2024-02-12,Senate,"Senate: Read third time and passed Senate (34-Y 6-N)",34,6,0,0,40
1819511,1393025,2024-02-22,House,"House: Subcommittee recommends reporting (8-Y 0-N)",8,0,0,0,8
1819511,1396396,2024-02-27,House,"House: Reported from General Laws (22-Y 0-N)",22,0,0,0,22
1819511,1400435,2024-03-01,House,"House: VOTE: Block Vote Passage (97-Y 0-N)",97,0,0,3,100
1819549,1371757,2024-01-30,Senate,"Senate: Reported from Agriculture, Conservation and Natural Resources with amendment (15-Y 0-N)",15,0,0,0,15
1819549,1376940,2024-02-06,Senate,"Senate: Reported from Finance and Appropriations (15-Y 0-N)",15,0,0,0,15
1819549,1377968,2024-02-07,Senate,"Senate: Constitutional reading dispensed (40-Y 0-N)",40,0,0,0,40
1819549,1380115,2024-02-08,Senate,"Senate: Constitutional reading dispensed (40-Y 0-N)",40,0,0,0,40
1819549,1380116,2024-02-08,Senate,"Senate: Passed Senate (40-Y 0-N)",40,0,0,0,40
1819549,1394943,2024-02-26,House,"House: Subcommittee recommends laying on the table (8-Y 2-N)",8,2,0,0,10
1819744,1372229,2024-01-30,House,"House: Reported from Labor and Commerce (22-Y 0-N)",22,0,0,0,22
1819744,1376113,2024-02-05,House,"House: VOTE: Block Vote Passage (98-Y 0-N)",98,0,0,2,100
1819744,1394967,2024-02-26,Senate,"Senate: Reported from Commerce and Labor (15-Y 0-N)",15,0,0,0,15
1819744,1398459,2024-02-28,Senate,"Senate: Constitutional reading dispensed (39-Y 0-N)",39,0,0,1,40
1819744,1399999,2024-02-29,Senate,"Senate: Passed Senate (39-Y 0-N)",39,0,0,1,40
1819858,1374360,2024-02-01,House,"House: Subcommittee recommends striking from docket (8-Y 0-N)",8,0,0,0,8
1819858,1377726,2024-02-06,House,"House: Stricken from docket by General Laws (20-Y 0-N)",20,0,0,2,22
1819901,1376726,2024-02-06,House,"House: Subcommittee recommends reporting with substitute (8-Y 0-N)",8,0,0,0,8
1819901,1377426,2024-02-06,House,"House: Reported from Transportation with substitute (21-Y 0-N)",21,0,0,1,22
1819901,1380685,2024-02-09,House,"House: Subcommittee recommends reporting (7-Y 0-N)",7,0,0,2,9
1819901,1380686,2024-02-09,House,"House: Reported from Appropriations (20-Y 0-N)",20,0,0,2,22
1819901,1382825,2024-02-13,House,"House: VOTE: Block Vote Passage (99-Y 0-N)",99,0,0,1,100
1819901,1392829,2024-02-22,Senate,"Senate: Reported from Transportation (15-Y 0-N)",15,0,0,0,15
1819901,1394454,2024-02-26,Senate,"Senate: Constitutional reading dispensed (40-Y 0-N)",40,0,0,0,40
1819901,1396880,2024-02-27,Senate,"Senate: Passed Senate (39-Y 0-N)",39,0,0,1,40
1819941,1371195,2024-01-29,House,"House: Subcommittee recommends laying on the table (6-Y 1-N)",6,1,0,2,9
1819980,1374467,2024-02-01,House,"House: Subcommittee recommends reporting (5-Y 3-N)",5,3,0,0,8
1819980,1374572,2024-02-01,House,"House: Subcommittee recommends reporting (6-Y 2-N)",6,2,0,0,8
1819980,1376824,2024-02-06,House,"House: Reported from Health and Human Services (16-Y 6-N)",16,6,0,0,22
1819980,1382027,2024-02-12,House,"House: VOTE: Passage (64-Y 34-N)",64,34,0,2,100
1819980,1391552,2024-02-22,Senate,"Senate: Reported from Education and Health (15-Y 0-N)",15,0,0,0,15
1819980,1393975,2024-02-23,Senate,"Senate: Constitutional reading dispensed (38-Y 0-N)",38,0,0,2,40
1819980,1394724,2024-02-26,Senate,"Senate: Passed Senate (40-Y 0-N)",40,0,0,0,40
1820065,1371469,2024-01-30,House,"House: Subcommittee recommends reporting (8-Y 0-N)",8,0,0,0,8
1820065,1373689,2024-02-01,House,"House: Reported from Transportation (22-Y 0-N)",22,0,0,0,22
1820065,1378894,2024-02-07,House,"House: VOTE: Block Vote Passage (100-Y 0-N)",100,0,0,0,100
1820065,1386646,2024-02-15,Senate,"Senate: Reported from Transportation (15-Y 0-N)",15,0,0,0,15
1820065,1387776,2024-02-19,Senate,"Senate: Constitutional reading dispensed (38-Y 0-N)",38,0,0,2,40
1820065,1389108,2024-02-20,Senate,"Senate: Passed Senate (40-Y 0-N)",40,0,0,0,40
1820107,1372216,2024-01-30,House,"House: Reported from Labor and Commerce (22-Y 0-N)",22,0,0,0,22
1820107,1376621,2024-02-05,House,"House: VOTE: Block Vote Passage (98-Y 0-N)",98,0,0,2,100
1820107,1395480,2024-02-26,Senate,"Senate: Reported from Commerce and Labor (15-Y 0-N)",15,0,0,0,15
1820107,1398352,2024-02-28,Senate,"Senate: Constitutional reading dispensed (39-Y 0-N)",39,0,0,1,40
1820107,1399919,2024-02-29,Senate,"Senate: Passed Senate (39-Y 0-N)",39,0,0,1,40
1820149,1369915,2024-01-26,House,"House: Subcommittee recommends reporting with amendments (5-Y 3-N)",5,3,0,1,9
1820149,1376254,2024-02-02,House,"House: Reported from Courts of Justice with amendment(s) (12-Y 9-N)",12,9,0,1,22
1820149,1379967,2024-02-08,House,"House: VOTE: Passage (51-Y 47-N)",51,47,0,2,100
1820149,1387288,2024-02-19,Senate,"Senate: Reported from Courts of Justice (8-Y 4-N)",8,4,0,0,12
1820149,1388502,2024-02-20,Senate,"Senate: Constitutional reading dispensed (39-Y 0-N)",39,0,0,1,40
1820149,1390034,2024-02-21,Senate,"Senate: Passed Senate (22-Y 18-N)",22,18,0,0,40
1820149,1390035,2024-02-21,Senate,"Senate: Reconsideration of Senate passage agreed to by Senate (40-Y 0-N)",40,0,0,0,40
1820149,1390036,2024-02-21,Senate,"Senate: Passed Senate (21-Y 19-N)",21,19,0,0,40
1820241,1375765,2024-02-05,House,"House: Subcommittee recommends reporting (8-Y 0-N)",8,0,0,1,9
1820241,1375766,2024-02-05,House,"House: Reported from Appropriations (21-Y 0-N)",21,0,0,1,22
1820241,1380538,2024-02-09,House,"House: VOTE: Block Vote Passage (96-Y 0-N)",96,0,0,4,100
1820241,1401443,2024-03-04,Senate,"Senate: Reported from Finance and Appropriations with substitute (15-Y 0-N)",15,0,0,0,15
1820241,1403693,2024-03-05,Senate,"Senate: Constitutional reading dispensed (39-Y 0-N)",39,0,0,1,40
1820241,1404481,2024-03-06,Senate,"Senate: Passed Senate with substitute (40-Y 0-N)",40,0,0,0,40
1820241,1405531,2024-03-07,House,"House: VOTE: REJECTED (0-Y 98-N)",0,98,0,2,100
1820241,1405532,2024-03-07,Senate,"Senate: Senate insisted on substitute (40-Y 0-N)",40,0,0,0,40
1820241,1406400,2024-03-08,Senate,"Senate: Conference report agreed to by Senate (40-Y 0-N)",40,0,0,0,40
1820241,1406401,2024-03-08,House,"House: VOTE: Adoption (96-Y 0-N)",96,0,0,4,100
1820262,1373372,2024-01-31,House,"House: Subcommittee recommends reporting with substitute (8-Y 0-N)",8,0,0,1,9
1820262,1375588,2024-02-02,House,"House: Reported from Courts of Justice with substitute (21-Y 0-N)",21,0,0,1,22
1820262,1380347,2024-02-08,House,"House: VOTE: Block Vote Passage (98-Y 0-N)",98,0,0,2,100
1820262,1398670,2024-02-28,Senate,"Senate: Reported from Courts of Justice with amendment (15-Y 0-N)",15,0,0,0,15
1820262,1398945,2024-02-28,Senate,"Senate: Reported from Courts of Justice with amendments (15-Y 0-N)",15,0,0,0,15
1820262,1401229,2024-03-01,Senate,"Senate: Constitutional reading dispensed (40-Y 0-N)",40,0,0,0,40
1820262,1402447,2024-03-04,Senate,"Senate: Passed Senate with amendments (39-Y 0-N)",39,0,0,1,40
1820262,1403573,2024-03-05,House,"House: VOTE: REJECTED (1-Y 99-N)",1,99,0,0,100
1820262,1404650,2024-03-06,Senate,"Senate: Senate insisted on amendments (40-Y 0-N)",40,0,0,0,40
1820262,1406742,2024-03-09,Senate,"Senate: Conference report agreed to by Senate (40-Y 0-N)",40,0,0,0,40
1820262,1406743,2024-03-09,House,"House: VOTE: Adoption (98-Y 0-N)",98,0,0,2,100
1820284,1376558,2024-02-05,House,"House: Subcommittee recommends reporting with substitute (8-Y 2-N)",8,2,0,0,10
1820284,1378604,2024-02-07,House,"House: Reported from Agriculture, Chesapeake and Natural Resources with substitute (19-Y 3-N)",19,3,0,0,22
1820284,1383060,2024-02-13,House,"House: VOTE: Passage (90-Y 9-N)",90,9,0,1,100
1820284,1391081,2024-02-21,Senate,"Senate: Continued to 2025 in Courts of Justice (15-Y 0-N)",15,0,0,0,15
1820307,1379875,2024-02-08,House,"House: Subcommittee recommends reporting (7-Y 0-N)",7,0,0,1,8
1820307,1379876,2024-02-08,House,"House: Reported from General Laws (20-Y 0-N)",20,0,0,2,22
1820307,1382826,2024-02-13,House,"House: VOTE: Block Vote Passage (99-Y 0-N)",99,0,0,1,100
1820307,1398759,2024-02-28,Senate,"Senate: Reported from General Laws and Technology (14-Y 0-N 1-A)",14,0,1,0,15
1820307,1401236,2024-03-01,Senate,"Senate: Constitutional reading dispensed (40-Y 0-N)",40,0,0,0,40
1820307,1402849,2024-03-05,Senate,"Senate: Passed Senate (40-Y 0-N)",40,0,0,0,40
1820328,1371883,2024-01-30,House,"House: Subcommittee recommends passing by indefinitely (5-Y 3-N)",5,3,0,0,8
1820374,1375563,2024-02-05,House,"House: Subcommittee recommends striking from docket (8-Y 0-N)",8,0,0,1,9
1820400,1377418,2024-02-06,House,"House: Subcommittee recommends reporting (8-Y 0-N)",8,0,0,1,9
1820400,1378345,2024-02-07,House,"House: Reported from Finance (18-Y 0-N)",18,0,0,4,22
1820400,1378346,2024-02-07,House,"House: Reported from Finance (19-Y 0-N)",19,0,0,3,22
1820420,1373591,2024-02-01,Senate,"Senate: Reported from Education and Health with substitute (15-Y 0-N)",15,0,0,0,15
1820420,1379877,2024-02-08,Senate,"Senate: Continued to 2025 in Finance and Appropriations (14-Y 1-N)",14,1,0,0,15
1820442,1370975,2024-01-29,House,"House: Subcommittee recommends reporting (4-Y 2-N)",4,2,0,0,6
1820442,1373984,2024-02-01,House,"House: Reported from Rules (12-Y 6-N)",12,6,0,0,18
1820442,1378114,2024-02-07,House,"House: Subcommittee recommends reporting (5-Y 3-N)",5,3,0,1,9
1820442,1378679,2024-02-07,House,"House: Reported from Appropriations (12-Y 9-N)",12,9,0,1,22
1820442,1382267,2024-02-12,House,"House: VOTE: Adoption (54-Y 45-N)",54,45,0,1,100
1820442,1402520,2024-03-04,Senate,"Senate: Reading waived (40-Y 0-N)",40,0,0,0,40
1820463,1369654,2024-01-25,House,"House: Subcommittee recommends reporting with substitute (8-Y 0-N)",8,0,0,0,8
1820463,1371951,2024-01-30,House,"House: Reported from Health and Human Services with substitute (22-Y 0-N)",22,0,0,0,22
1820463,1375178,2024-02-02,House,"House: Subcommittee recommends laying on the table (8-Y 0-N)",8,0,0,1,9
1820510,1377404,2024-02-06,House,"House: Subcommittee recommends reporting with substitute (6-Y 2-N)",6,2,0,1,9
1820510,1378625,2024-02-07,House,"House: Continued to 2025 with substitute in Finance (12-Y 9-N)",12,9,0,1,22
1820582,1370338,2024-01-29,House,"House: Subcommittee recommends laying on the table (4-Y 2-N)",4,2,0,0,6
1820606,1379978,2024-02-08,House,"House: Subcommittee recommends laying on the table (5-Y 3-N)",5,3,0,0,8
1820629,1373376,2024-01-31,House,"House: Subcommittee recommends reporting with substitute (8-Y 0-N)",8,0,0,1,9
1820629,1375579,2024-02-02,House,"House: Reported from Courts of Justice with substitute (21-Y 0-N)",21,0,0,1,22
1820629,1380263,2024-02-08,House,"House: VOTE: Block Vote Passage (98-Y 0-N)",98,0,0,2,100
1820629,1395088,2024-02-26,Senate,"Senate: Reported from Courts of Justice (15-Y 0-N)",15,0,0,0,15
1820629,1395899,2024-02-27,Senate,"Senate: Constitutional reading dispensed (39-Y 0-N)",39,0,0,1,40
1820629,1398461,2024-02-28,Senate,"Senate: Passed Senate (39-Y 0-N)",39,0,0,1,40
1820698,1379477,2024-02-08,House,"House: Subcommittee recommends striking from docket (7-Y 0-N)",7,0,0,1,8
1820698,1380438,2024-02-08,House,"House: Stricken from docket by General Laws (20-Y 0-N)",20,0,0,2,22
1820721,1372396,2024-01-31,House,"House: Subcommittee recommends laying on the table (5-Y 3-N)",5,3,0,0,8
1820744,1377171,2024-02-06,House,"House: Subcommittee recommends reporting with substitute (7-Y 0-N)",7,0,0,1,8
1820744,1379291,2024-02-08,House,"House: Reported from Health and Human Services with substitute (22-Y 0-N)",22,0,0,0,22
1820744,1382833,2024-02-13,House,"House: VOTE: Block Vote Passage (99-Y 0-N)",99,0,0,1,100
1820744,1392187,2024-02-22,Senate,"Senate: Reported from Education and Health (15-Y 0-N)",15,0,0,0,15
1820744,1393424,2024-02-23,Senate,"Senate: Constitutional reading dispensed (38-Y 0-N)",38,0,0,2,40
1820744,1394434,2024-02-26,Senate,"Senate: Passed Senate (40-Y 0-N)",40,0,0,0,40
1820768,1375697,2024-02-05,House,"House: Subcommittee recommends reporting (8-Y 0-N)",8,0,0,1,9
1820768,1378854,2024-02-07,House,"House: Reported from Courts of Justice (22-Y 0-N)",22,0,0,0,22
1820768,1382839,2024-02-13,House,"House: VOTE: Block Vote Passage (99-Y 0-N)",99,0,0,1,100
1820768,1391079,2024-02-21,Senate,"Senate: Reported from Courts of Justice (15-Y 0-N)",15,0,0,0,15
1820768,1394101,2024-02-23,Senate,"Senate: Constitutional reading dispensed (38-Y 0-N)",38,0,0,2,40
1820768,1395336,2024-02-26,Senate,"Senate: Passed Senate (40-Y 0-N)",40,0,0,0,40
1820813,1375618,2024-02-05,House,"House: Subcommittee recommends reporting with amendments (8-Y 2-N)",8,2,0,0,10
1820813,1378610,2024-02-07,House,"House: Reported from Education with amendment(s) (22-Y 0-N)",22,0,0,0,22
1820813,1383927,2024-02-13,House,"House: VOTE: Block Vote Passage (99-Y 0-N)",99,0,0,1,100
1820813,1399566,2024-02-29,Senate,"Senate: Reported from Education and Health (14-Y 1-N)",14,1,0,0,15
1820813,1401447,2024-03-04,Senate,"Senate: Continued to 2025 in Finance and Appropriations (10-Y 5-N)",10,5,0,0,15
1820838,1371915,2024-01-30,House,"House: Subcommittee recommends reporting with substitute (8-Y 0-N)",8,0,0,1,9
1820838,1372555,2024-01-31,House,"House: Reported from Finance with substitute (22-Y 0-N)",22,0,0,0,22
1820838,1377602,2024-02-06,House,"House: VOTE: Block Vote Passage (99-Y 0-N)",99,0,0,1,100
1820838,1386248,2024-02-15,Senate,"Senate: Reported from Finance and Appropriations (15-Y 0-N)",15,0,0,0,15
1820838,1387485,2024-02-19,Senate,"Senate: Constitutional reading dispensed (38-Y 0-N)",38,0,0,2,40
1820838,1388525,2024-02-20,Senate,"Senate: Passed Senate (40-Y 0-N)",40,0,0,0,40
1820857,1377402,2024-02-06,House,"House: Subcommittee recommends reporting with amendments (5-Y 3-N)",5,3,0,1,9
1820857,1378924,2024-02-07,House,"House: Reported from Finance with amendment(s) (13-Y 8-N)",13,8,0,1,22
1820857,1383931,2024-02-13,House,"House: VOTE: Passage (66-Y 33-N)",66,33,0,1,100
1820896,1374315,2024-02-01,House,"House: Reported from Rules (18-Y 0-N)",18,0,0,0,18
1820896,1378893,2024-02-07,House,"House: VOTE: Block Vote Adoption (99-Y 0-N)",99,0,0,1,100
1820896,1395378,2024-02-26,Senate,"Senate: Reading waived (40-Y 0-N)",40,0,0,0,40
1820982,1379865,2024-02-08,House,"House: Subcommittee recommends reporting (6-Y 1-N)",6,1,0,1,8
1820982,1379866,2024-02-08,House,"House: Reported from General Laws (16-Y 4-N)",16,4,0,2,22
1820982,1383453,2024-02-13,House,"House: VOTE: Passage (59-Y 40-N)",59,40,0,1,100
1820982,1398005,2024-02-28,Senate,"Senate: Reported from General Laws and Technology (15-Y 0-N)",15,0,0,0,15
1820982,1400828,2024-03-01,Senate,"Senate: Constitutional reading dispensed (40-Y 0-N)",40,0,0,0,40
1820982,1402160,2024-03-04,Senate,"Senate: Passed Senate (29-Y 10-N)",29,10,0,1,40
1821010,1376321,2024-02-05,Senate,"Senate: Continued to 2025 in Commerce and Labor (10-Y 5-N)",10,5,0,0,15
1821038,1379051,2024-02-08,Senate,"Senate: Reported from Education and Health with substitute (15-Y 0-N)",15,0,0,0,15
1821038,1380571,2024-02-09,Senate,"Senate: Continued to 2025 in Rules (8-Y 6-N 1-A)",8,6,1,0,15
1821069,1373299,2024-01-31,Senate,"Senate: Continued to 2025 in General Laws and Technology (8-Y 6-N 1-A)",8,6,1,0,15
1821128,1376817,2024-02-06,House,"House: Subcommittee recommends reporting (5-Y 3-N)",5,3,0,0,8
1821128,1378322,2024-02-07,House,"House: Reported from Education with amendment(s) (21-Y 0-N)",21,0,0,1,22
1821128,1383350,2024-02-13,House,"House: VOTE: Block Vote Passage (99-Y 0-N)",99,0,0,1,100
1821128,1399121,2024-02-29,Senate,"Senate: Reported from Education and Health (9-Y 6-N)",9,6,0,0,15
1821128,1401008,2024-03-01,Senate,"Senate: Constitutional reading dispensed (40-Y 0-N)",40,0,0,0,40
1821128,1402784,2024-03-05,Senate,"Senate: Defeated by Senate (19-Y 21-N)",19,21,0,0,40
1821128,1402785,2024-03-05,Senate,"Senate: Reconsideration of defeated action agreed to by Senate (39-Y 1-N)",39,1,0,0,40
1821128,1405585,2024-03-07,Senate,"Senate: Passed Senate with substitute (36-Y 4-N)",36,4,0,0,40
1821128,1405586,2024-03-07,House,"House: VOTE: Adoption (99-Y 0-N)",99,0,0,1,100
1821156,1374898,2024-02-02,Senate,"Senate: Reported from Rehabilitation and Social Services (15-Y 0-N)",15,0,0,0,15
1821156,1375711,2024-02-05,Senate,"Senate: Constitutional reading dispensed (39-Y 0-N)",39,0,0,1,40
1821156,1377050,2024-02-06,Senate,"Senate: Constitutional reading dispensed (39-Y 0-N)",39,0,0,1,40
1821156,1377051,2024-02-06,Senate,"Senate: Passed Senate (39-Y 0-N)",39,0,0,1,40
1821156,1392852,2024-02-22,House,"House: Subcommittee recommends reporting with substitute (8-Y 0-N)",8,0,0,0,8
1821156,1396310,2024-02-27,House,"House: Reported from Health and Human Services with substitute (20-Y 0-N)",20,0,0,2,22
1821156,1400492,2024-03-01,House,"House: VOTE: Block Vote Passage (97-Y 0-N)",97,0,0,3,100
1821156,1402805,2024-03-05,Senate,"Senate: House substitute agreed to by Senate (40-Y 0-N)",40,0,0,0,40
1821220,1369689,2024-01-25,Senate,"Senate: Reported from Transportation with substitute (13-Y 2-N)",13,2,0,0,15
1821220,1382644,2024-02-12,Senate,"Senate: Failed to report (defeated) in Courts of Justice (6-Y 8-N)",6,8,0,0,14
1821244,1370647,2024-01-29,Senate,"Senate: Reported from Local Government with substitute (15-Y 0-N)",15,0,0,0,15
1821244,1377125,2024-02-06,Senate,"Senate: Reported from Finance and Appropriations (15-Y 0-N)",15,0,0,0,15
1821244,1378046,2024-02-07,Senate,"Senate: Constitutional reading dispensed (40-Y 0-N)",40,0,0,0,40
1821244,1380272,2024-02-08,Senate,"Senate: Constitutional reading dispensed (40-Y 0-N)",40,0,0,0,40
1821244,1380273,2024-02-08,Senate,"Senate: Passed Senate (40-Y 0-N)",40,0,0,0,40
1821244,1387084,2024-02-16,House,"House: Subcommittee recommends reporting (8-Y 0-N)",8,0,0,0,8
1821244,1387085,2024-02-16,House,"House: Reported from Counties, Cities and Towns (22-Y 0-N)",22,0,0,0,22
1821244,1390022,2024-02-21,House,"House: VOTE: Block Vote Passage (100-Y 0-N)",100,0,0,0,100
1821273,1376577,2024-02-05,House,"House: Subcommittee recommends reporting (10-Y 0-N)",10,0,0,0,10
1821273,1378858,2024-02-07,House,"House: Reported from Agriculture, Chesapeake and Natural Resources (22-Y 0-N)",22,0,0,0,22
1821273,1382848,2024-02-13,House,"House: VOTE: Defeated (48-Y 51-N)",48,51,0,1,100
1821301,1373189,2024-01-31,Senate,"Senate: Passed by indefinitely in General Laws and Technology (9-Y 6-N)",9,6,0,0,15
1821331,1376634,2024-02-05,Senate,"Senate: Reading waived (39-Y 0-N)",39,0,0,1,40
1821331,1393294,2024-02-23,House,"House: Reported from Rules (17-Y 0-N)",17,0,0,1,18
1821331,1401646,2024-02-28,House,"House: VOTE: Block Vote Adoption (99-Y 0-N)",99,0,0,1,100
1821331,1401647,2024-02-28,House,"House: VOTE: Block Vote Adoption #2 (99-Y 0-N)",99,0,0,1,100
1821360,1368879,2024-01-24,Senate,"Senate: Reported from General Laws and Technology with substitute (14-Y 1-N)",14,1,0,0,15
1821360,1376982,2024-02-06,Senate,"Senate: Continued to 2025 in Finance and Appropriations (15-Y 0-N)",15,0,0,0,15
1821391,1376638,2024-02-05,Senate,"Senate: Reading waived (39-Y 0-N)",39,0,0,1,40
1821391,1393297,2024-02-23,House,"House: Reported from Rules (17-Y 0-N)",17,0,0,1,18
1821391,1398008,2024-02-28,House,"House: VOTE: Block Vote Adoption (99-Y 0-N)",99,0,0,1,100
1821391,1398009,2024-02-28,House,"House: VOTE: Block Vote Adoption #2 (99-Y 0-N)",99,0,0,1,100
1821419,1378667,2024-02-07,Senate,"Senate: Stricken at request of Patron in General Laws and Technology (15-Y 0-N)",15,0,0,0,15
1821447,1380508,2024-02-09,Senate,"Senate: Reported from Commerce and Labor with substitute (10-Y 4-N 1-A)",10,4,1,0,15
1821447,1381008,2024-02-09,Senate,"Senate: Reading waived (39-Y 0-N)",39,0,0,1,40
1821447,1393298,2024-02-23,House,"House: Subcommittee recommends reporting with substitute (6-Y 0-N)",6,0,0,0,6
1821447,1393299,2024-02-23,House,"House: Reported from Rules with substitute (16-Y 0-N)",16,0,0,2,18
1821447,1397653,2024-02-28,House,"House: Reported from Appropriations (12-Y 10-N)",12,10,0,0,22
1821447,1401589,2024-03-04,House,"House: VOTE: Adoption (65-Y 31-N)",65,31,0,4,100
1821471,1368636,2024-01-24,Senate,"Senate: Incorporated by Courts of Justice ",15,0,0,0,15
1821858,1374300,2024-02-01,House,"House: Subcommittee recommends reporting with amendments (7-Y 0-N)",7,0,0,1,8
1821858,1377728,2024-02-06,House,"House: Reported from Labor and Commerce with amendment(s) (22-Y 0-N)",22,0,0,0,22
1821858,1382051,2024-02-12,House,"House: VOTE: Block Vote Passage (100-Y 0-N)",100,0,0,0,100
1821858,1394816,2024-02-26,Senate,"Senate: Reported from Commerce and Labor with amendment (15-Y 0-N)",15,0,0,0,15
1821858,1398647,2024-02-28,Senate,"Senate: Constitutional reading dispensed (39-Y 0-N)",39,0,0,1,40
1821858,1400051,2024-02-29,Senate,"Senate: Passed Senate with amendment (39-Y 0-N)",39,0,0,1,40
1821858,1402444,2024-03-04,House,"House: VOTE: Adoption (97-Y 0-N)",97,0,0,3,100
1821879,1371574,2024-01-30,House,"House: Subcommittee recommends reporting with substitute (5-Y 3-N)",5,3,0,0,8
1821879,1373674,2024-02-01,House,"House: Reported from Transportation with substitute (12-Y 10-N)",12,10,0,0,22
1821879,1378156,2024-02-07,House,"House: Subcommittee recommends reporting (5-Y 3-N)",5,3,0,1,9
1821879,1378788,2024-02-07,House,"House: Reported from Appropriations (13-Y 9-N)",13,9,0,0,22
1821879,1383159,2024-02-13,House,"House: VOTE: Passage (55-Y 44-N)",55,44,0,1,100
1821879,1392018,2024-02-22,Senate,"Senate: Reported from Transportation (8-Y 7-N)",8,7,0,0,15
1821879,1397866,2024-02-28,Senate,"Senate: Reported from Finance and Appropriations (10-Y 3-N)",10,3,0,0,13
1821879,1400153,2024-02-29,Senate,"Senate: Constitutional reading dispensed (39-Y 0-N)",39,0,0,1,40
1821879,1400923,2024-03-01,Senate,"Senate: Passed Senate (21-Y 19-N)",21,19,0,0,40
1821901,1377276,2024-02-05,Senate,"Senate: Continued to 2025 in Commerce and Labor (15-Y 0-N)",15,0,0,0,15
1821935,1379437,2024-02-08,House,"House: Subcommittee recommends reporting with amendments (7-Y 1-N)",7,1,0,0,8
1821935,1380415,2024-02-08,House,"House: Reported from General Laws with amendment(s) (18-Y 2-N)",18,2,0,2,22
1821935,1383881,2024-02-13,House,"House: VOTE: Passage (75-Y 20-N)",75,20,0,5,100
1821935,1398722,2024-02-28,Senate,"Senate: Reported from General Laws and Technology with substitute (12-Y 3-N)",12,3,0,0,15
1821935,1401129,2024-03-01,Senate,"Senate: Constitutional reading dispensed (40-Y 0-N)",40,0,0,0,40
1821935,1403696,2024-03-05,Senate,"Senate: Passed Senate with substitute (23-Y 17-N)",23,17,0,0,40
1821935,1404764,2024-03-06,House,"House: VOTE: Adoption (71-Y 26-N)",71,26,0,3,100
1821937,1374322,2024-02-01,House,"House: Reported from Rules (17-Y 0-N)",17,0,0,1,18
1821937,1377775,2024-02-06,House,"House: VOTE: Block Vote Adoption (98-Y 0-N)",98,0,0,2,100
1821937,1395069,2024-02-26,Senate,"Senate: Reading waived (40-Y 0-N)",40,0,0,0,40
1821941,1375653,2024-02-05,House,"House: Reported from Communications, Technology and Innovation with substitute (14-Y 8-N)",14,8,0,0,22
1821946,1373805,2024-02-01,House,"House: Subcommittee recommends reporting (8-Y 0-N)",8,0,0,0,8
1821946,1377387,2024-02-06,House,"House: Reported from Health and Human Services (22-Y 0-N)",22,0,0,0,22
1821946,1378837,2024-02-07,House,"House: Subcommittee recommends reporting (7-Y 0-N)",7,0,0,2,9
1821946,1380736,2024-02-09,House,"House: Reported from Appropriations (20-Y 0-N)",20,0,0,2,22
1821946,1383875,2024-02-13,House,"House: VOTE: Block Vote Passage (99-Y 0-N)",99,0,0,1,100
1821946,1399479,2024-02-29,Senate,"Senate: Reported from Education and Health (15-Y 0-N)",15,0,0,0,15
1821946,1401256,2024-03-01,Senate,"Senate: Constitutional reading dispensed (40-Y 0-N)",40,0,0,0,40
1821946,1402226,2024-03-04,Senate,"Senate: Passed Senate (39-Y 0-N)",39,0,0,1,40
1821952,1372789,2024-01-31,House,"House: Subcommittee recommends reporting (9-Y 1-N)",9,1,0,0,10
1821952,1378471,2024-02-07,House,"House: Reported from Agriculture, Chesapeake and Natural Resources with substitute (20-Y 2-N)",20,2,0,0,22
1821952,1383734,2024-02-13,House,"House: VOTE: Passage (96-Y 2-N)",96,2,0,2,100
1821952,1397063,2024-02-27,Senate,"Senate: Reported from Agriculture, Conservation and Natural Resources (14-Y 0-N)",14,0,0,0,14
1821952,1399499,2024-02-29,Senate,"Senate: Constitutional reading dispensed (39-Y 0-N)",39,0,0,1,40
1821952,1401223,2024-03-01,Senate,"Senate: Passed Senate (40-Y 0-N)",40,0,0,0,40
1821954,1371450,2024-01-30,House,"House: Subcommittee recommends reporting with amendments (8-Y 0-N)",8,0,0,0,8
1821954,1373692,2024-02-01,House,"House: Reported from Transportation with amendment(s) (22-Y 0-N)",22,0,0,0,22
1821954,1378896,2024-02-07,House,"House: VOTE: Block Vote Passage (100-Y 0-N)",100,0,0,0,100
1821954,1386422,2024-02-15,Senate,"Senate: Reported from Transportation (15-Y 0-N)",15,0,0,0,15
1821954,1387524,2024-02-19,Senate,"Senate: Constitutional reading dispensed (38-Y 0-N)",38,0,0,2,40
1821954,1388517,2024-02-20,Senate,"Senate: Passed Senate (40-Y 0-N)",40,0,0,0,40
1821957,1379467,2024-02-08,House,"House: Subcommittee recommends reporting with substitute (5-Y 2-N)",5,2,0,1,8
1821957,1380424,2024-02-08,House,"House: Reported from General Laws with substitute (13-Y 7-N)",13,7,0,2,22
1821957,1383537,2024-02-13,House,"House: VOTE: Passage (51-Y 48-N)",51,48,0,1,100
1821957,1398242,2024-02-28,Senate,"Senate: Reported from General Laws and Technology (9-Y 6-N)",9,6,0,0,15
1821957,1401110,2024-03-01,Senate,"Senate: Constitutional reading dispensed (40-Y 0-N)",40,0,0,0,40
1821957,1403596,2024-03-05,Senate,"Senate: Passed Senate (21-Y 19-N)",21,19,0,0,40
1821980,1374353,2024-02-01,House,"House: Subcommittee recommends reporting with substitute (8-Y 0-N)",8,0,0,0,8
1821980,1377512,2024-02-06,House,"House: Reported from General Laws with substitute (16-Y 3-N)",16,3,0,3,22
1821980,1380748,2024-02-09,House,"House: Subcommittee recommends laying on the table (6-Y 0-N)",6,0,0,3,9
1821983,1373069,2024-01-31,House,"House: Subcommittee recommends laying on the table (6-Y 4-N)",6,4,0,0,10
1821986,1372753,2024-01-31,House,"House: Subcommittee recommends reporting with substitute (8-Y 0-N)",8,0,0,0,8
1821986,1376166,2024-02-05,House,"House: Reported from Education with substitute (22-Y 0-N)",22,0,0,0,22
1821986,1380543,2024-02-09,House,"House: VOTE: Block Vote Passage (96-Y 0-N)",96,0,0,4,100
1821986,1391993,2024-02-22,Senate,"Senate: Reported from Education and Health (15-Y 0-N)",15,0,0,0,15
1821986,1393420,2024-02-23,Senate,"Senate: Constitutional reading dispensed (38-Y 0-N)",38,0,0,2,40
1821986,1395241,2024-02-26,Senate,"Senate: Passed Senate (40-Y 0-N)",40,0,0,0,40
1821989,1373108,2024-01-31,House,"House: Subcommittee recommends reporting with amendments (10-Y 0-N)",10,0,0,0,10
1821989,1378198,2024-02-07,House,"House: Reported from Agriculture, Chesapeake and Natural Resources with amendment(s) (22-Y 0-N)",22,0,0,0,22
1821989,1380572,2024-02-09,House,"House: Subcommittee recommends reporting (8-Y 0-N)",8,0,0,1,9
1821989,1380718,2024-02-09,House,"House: Reported from Appropriations (20-Y 0-N)",20,0,0,2,22
1821989,1382973,2024-02-13,House,"House: VOTE: Block Vote Passage (99-Y 0-N)",99,0,0,1,100
1821989,1396805,2024-02-27,Senate,"Senate: Reported from Agriculture, Conservation and Natural Resources (14-Y 0-N)",14,0,0,0,14
1821989,1399969,2024-02-29,Senate,"Senate: Reported from Finance and Appropriations (14-Y 0-N)",14,0,0,0,14
1821989,1401877,2024-03-04,Senate,"Senate: Constitutional reading dispensed (40-Y 0-N)",40,0,0,0,40
1821989,1403025,2024-03-05,Senate,"Senate: Passed Senate (40-Y 0-N)",40,0,0,0,40
1821991,1377378,2024-02-06,House,"House: Subcommittee recommends reporting with substitute (8-Y 0-N)",8,0,0,0,8
1821991,1378098,2024-02-07,House,"House: Reported from Education with substitute (22-Y 0-N)",22,0,0,0,22
1821991,1383117,2024-02-13,House,"House: VOTE: Block Vote Passage (99-Y 0-N)",99,0,0,1,100
1821991,1399113,2024-02-29,Senate,"Senate: Reported from Education and Health with substitute (15-Y 0-N)",15,0,0,0,15
1821991,1400944,2024-03-01,Senate,"Senate: Constitutional reading dispensed (40-Y 0-N)",40,0,0,0,40
1821991,1401605,2024-03-04,Senate,"Senate: Passed Senate with substitute (39-Y 0-N)",39,0,0,1,40
1821991,1402747,2024-03-05,House,"House: VOTE: Adoption (99-Y 0-N)",99,0,0,1,100
1822004,1369653,2024-01-25,House,"House: Subcommittee recommends striking from docket (8-Y 0-N)",8,0,0,0,8
1822015,1375628,2024-02-05,House,"House: Subcommittee recommends reporting with substitute (6-Y 4-N)",6,4,0,0,10
1822015,1377960,2024-02-07,House,"House: Reported from Education with substitute (12-Y 10-N)",12,10,0,0,22
1822015,1383469,2024-02-13,House,"House: VOTE: Passage (51-Y 48-N)",51,48,0,1,100
1822015,1399656,2024-02-29,Senate,"Senate: Reported from Education and Health with substitute (9-Y 6-N)",9,6,0,0,15
1822015,1401258,2024-03-01,Senate,"Senate: Constitutional reading dispensed (40-Y 0-N)",40,0,0,0,40
1822015,1403747,2024-03-05,Senate,"Senate: Passed Senate with substitute (21-Y 19-N)",21,19,0,0,40
1822015,1404785,2024-03-06,House,"House: VOTE: Adoption (51-Y 48-N)",51,48,0,1,100
1822025,1370757,2024-01-29,House,"House: Subcommittee recommends laying on the table (4-Y 2-N)",4,2,0,0,6
1822031,1379032,2024-02-08,House,"House: Subcommittee recommends reporting (5-Y 1-N)",5,1,1,1,8
1822031,1380570,2024-02-09,House,"House: Failed to report (defeated) in Counties, Cities and Towns (10-Y 10-N)",10,10,0,2,22
1822033,1375329,2024-02-02,House,"House: Subcommittee recommends striking from docket (5-Y 0-N)",5,0,0,4,9
1822041,1375883,2024-02-05,House,"House: Subcommittee recommends reporting with substitute (10-Y 0-N)",10,0,0,0,10
1822041,1378842,2024-02-07,House,"House: Reported from Agriculture, Chesapeake and Natural Resources with substitute (22-Y 0-N)",22,0,0,0,22
1822041,1383829,2024-02-13,House,"House: VOTE: Block Vote Passage (99-Y 0-N)",99,0,0,1,100
1822041,1388827,2024-02-20,Senate,"Senate: Reported from Agriculture, Conservation and Natural Resources with substitute (15-Y 0-N)",15,0,0,0,15
1822041,1398229,2024-02-28,Senate,"Senate: Reported from Finance and Appropriations (11-Y 4-N)",11,4,0,0,15
1822041,1399187,2024-02-29,Senate,"Senate: Constitutional reading dispensed (39-Y 0-N)",39,0,0,1,40
1822041,1402379,2024-03-04,Senate,"Senate: Passed Senate with substitute (36-Y 3-N)",36,3,0,1,40
1822041,1403247,2024-03-05,House,"House: VOTE: Adoption (100-Y 0-N)",100,0,0,0,100
1822044,1372715,2024-01-31,House,"House: Subcommittee recommends laying on the table (6-Y 4-N)",6,4,0,0,10
1822081,1371770,2024-01-30,House,"House: Subcommittee recommends reporting with substitute (8-Y 0-N)",8,0,0,0,8
1822081,1374291,2024-02-01,House,"House: Reported from General Laws with substitute (22-Y 0-N)",22,0,0,0,22
1822081,1380756,2024-02-09,House,"House: Subcommittee recommends laying on the table (4-Y 3-N)",4,3,0,2,9
1822083,1373381,2024-01-31,House,"House: Subcommittee recommends laying on the table (6-Y 2-N)",6,2,0,1,9
1822087,1373578,2024-02-01,House,"House: Subcommittee recommends reporting with substitute (6-Y 0-N)",6,0,0,0,6
1822087,1374499,2024-02-02,House,"House: Reported from Public Safety with substitute (22-Y 0-N)",22,0,0,0,22
1822087,1380638,2024-02-09,House,"House: Subcommittee recommends reporting (7-Y 0-N)",7,0,0,2,9
1822087,1380639,2024-02-09,House,"House: Reported from Appropriations (20-Y 0-N)",20,0,0,2,22
1822087,1383474,2024-02-13,House,"House: VOTE: Block Vote Passage (99-Y 0-N)",99,0,0,1,100
1822087,1395838,2024-02-27,Senate,"Senate: Constitutional reading dispensed (39-Y 0-N)",39,0,0,1,40
1822087,1395839,2024-02-27,Senate,"Senate: Reported from Finance and Appropriations (15-Y 0-N)",15,0,0,0,15
1822087,1398206,2024-02-28,Senate,"Senate: Passed Senate (39-Y 0-N)",39,0,0,1,40
1822091,1368934,2024-01-24,Senate,"Senate: Continued to 2025 in General Laws and Technology (15-Y 0-N)",15,0,0,0,15
1822093,1373172,2024-01-31,Senate,"Senate: Reported from General Laws and Technology (14-Y 0-N 1-A)",14,0,1,0,15
1822093,1377391,2024-02-06,Senate,"Senate: Read third time and passed Senate (35-Y 4-N)",35,4,0,1,40
1822093,1432162,2024-02-15,House,"House: Reported from General Laws (22-Y 0-N)",22,0,0,0,22
1822093,1432163,2024-02-20,House,"House: VOTE: Passage (79-Y 20-N)",79,20,0,1,100
1822095,1374311,2024-02-01,House,"House: Reported from Rules with amendment(s) (18-Y 0-N)",18,0,0,0,18
1822095,1377560,2024-02-06,House,"House: VOTE: Block Vote Adoption (98-Y 0-N)",98,0,0,2,100
1822095,1394492,2024-02-26,Senate,"Senate: Reading waived (40-Y 0-N)",40,0,0,0,40
1822098,1376165,2024-02-05,House,"House: Reported from Communications, Technology and Innovation with substitute (17-Y 5-N)",17,5,0,0,22
1822098,1380707,2024-02-09,House,"House: Subcommittee recommends reporting with substitute (7-Y 0-N)",7,0,0,2,9
1822098,1380708,2024-02-09,House,"House: Reported from Appropriations with substitute (12-Y 8-N)",12,8,0,2,22
1822098,1383025,2024-02-13,House,"House: VOTE: Passage (82-Y 17-N)",82,17,0,1,100
1822098,1391121,2024-02-21,Senate,"Senate: Rereferred from General Laws and Technology (9-Y 0-N)",9,0,0,0,9
1822098,1398812,2024-02-28,Senate,"Senate: Reported from Courts of Justice with substitute (15-Y 0-N)",15,0,0,0,15
1822098,1401441,2024-03-04,Senate,"Senate: Reported from Finance and Appropriations with amendments (15-Y 0-N)",15,0,0,0,15
1822098,1402547,2024-03-04,Senate,"Senate: Reported from Finance and Appropriations with amendment (15-Y 0-N)",15,0,0,0,15
1822098,1403566,2024-03-05,Senate,"Senate: Constitutional reading dispensed (39-Y 0-N)",39,0,0,1,40
1822098,1404643,2024-03-06,Senate,"Senate: Passed Senate with substitute with amendment (40-Y 0-N)",40,0,0,0,40
1822098,1405515,2024-03-07,House,"House: VOTE: REJECTED (1-Y 96-N)",1,96,0,3,100
1822098,1405516,2024-03-07,Senate,"Senate: Senate insisted on substitute with amendment (40-Y 0-N)",40,0,0,0,40
1822098,1406561,2024-03-08,Senate,"Senate: Conference report agreed to by Senate (40-Y 0-N)",40,0,0,0,40
1822098,1406562,2024-03-08,House,"House: VOTE: Adoption (89-Y 6-N)",89,6,0,5,100
1822108,1381590,2024-02-12,Senate,"Senate: Reported from Finance and Appropriations with substitute (15-Y 0-N)",15,0,0,0,15
1822108,1381591,2024-02-12,Senate,"Senate: Constitutional reading dispensed (40-Y 0-N)",40,0,0,0,40
1822108,1383883,2024-02-13,Senate,"Senate: Constitutional reading dispensed (39-Y 0-N)",39,0,0,1,40
1822108,1383884,2024-02-13,Senate,"Senate: Passed Senate (40-Y 0-N)",40,0,0,0,40
1822108,1391048,2024-02-21,House,"House: Reported from Appropriations with substitute (22-Y 0-N)",22,0,0,0,22
1822108,1394439,2024-02-26,House,"House: VOTE: Block Vote Passage (96-Y 0-N)",96,0,0,4,100
1822108,1398452,2024-02-28,Senate,"Senate: House substitute rejected by Senate (0-Y 39-N)",0,39,0,1,40
1822108,1402411,2024-03-04,Senate,"Senate: Senate acceded to request (38-Y 0-N)",38,0,0,2,40
1822114,1369848,2024-01-25,Senate,"Senate: Reported from Transportation (15-Y 0-N)",15,0,0,0,15
1822114,1370455,2024-01-29,Senate,"Senate: Constitutional reading dispensed (39-Y 0-N)",39,0,0,1,40
1822114,1372493,2024-01-31,Senate,"Senate: Read third time and passed Senate (40-Y 0-N)",40,0,0,0,40
1822114,1391448,2024-02-22,House,"House: Reported from Transportation with substitute (22-Y 0-N)",22,0,0,0,22
1822114,1395943,2024-02-27,House,"House: VOTE: Block Vote Passage (97-Y 0-N)",97,0,0,3,100
1822114,1399123,2024-02-29,Senate,"Senate: House substitute agreed to by Senate (39-Y 0-N)",39,0,0,1,40
1822118,1377534,2024-02-06,Senate,"Senate: Reported from Agriculture, Conservation and Natural Resources with substitite (8-Y 7-N)",8,7,0,0,15
1822118,1378149,2024-02-07,Senate,"Senate: Constitutional reading dispensed (40-Y 0-N)",40,0,0,0,40
1822118,1381734,2024-02-12,Senate,"Senate: Engrossment reconsidered by Senate (39-Y 0-N)",39,0,0,1,40
1822118,1381735,2024-02-12,Senate,"Senate: Constitutional reading dispensed (40-Y 0-N)",40,0,0,0,40
1822118,1381736,2024-02-12,Senate,"Senate: Defeated by Senate (20-Y 20-N)",20,20,0,0,40
1822120,1374085,2024-02-01,Senate,"Senate: Reported from Education and Health with substitute (15-Y 0-N)",15,0,0,0,15
1822120,1377215,2024-02-06,Senate,"Senate: Read third time and passed Senate (39-Y 0-N)",39,0,0,1,40
1822120,1432155,2024-02-27,House,"House: Subcommittee recommends reporting with substitute (8-Y 0-N)",8,0,0,0,8
1822120,1432156,2024-02-28,House,"House: Reported from Education with substitute (22-Y 0-N)",22,0,0,0,22
1822120,1432157,2024-03-04,House,"House: VOTE: Block Vote Passage (97-Y 0-N)",97,0,0,3,100
1822120,1432158,2024-03-05,Senate,"Senate: House substitute rejected by Senate (0-Y 40-N)",0,40,0,0,40
1822120,1432159,2024-03-07,Senate,"Senate: Senate acceded to request (40-Y 0-N)",40,0,0,0,40
1822120,1432160,2024-03-08,Senate,"Senate: Conference report agreed to by Senate (40-Y 0-N)",40,0,0,0,40
1822120,1432161,2024-03-08,House,"House: VOTE: Adoption (96-Y 0-N)",96,0,0,4,100
1822132,1369845,2024-01-26,House,"House: Stricken from docket by Counties, Cities and Towns (20-Y 0-N)",20,0,0,2,22
1822133,1374332,2024-02-01,House,"House: Reported from Rules with amendment(s) (18-Y 0-N)",18,0,0,0,18
1822133,1377583,2024-02-06,House,"House: VOTE: Block Vote Adoption (98-Y 0-N)",98,0,0,2,100
1822133,1394453,2024-02-26,Senate,"Senate: Reading waived (40-Y 0-N)",40,0,0,0,40
1822137,1378615,2024-02-07,Senate,"Senate: Continued to 2025 in Courts of Justice (15-Y 0-N)",15,0,0,0,15
1822138,1375548,2024-02-05,House,"House: Subcommittee recommends reporting with substitute (6-Y 2-N)",6,2,0,1,9
1822138,1378798,2024-02-07,House,"House: Reported from Finance with substitute (21-Y 0-N)",21,0,0,1,22
1822138,1383082,2024-02-13,House,"House: VOTE: Block Vote Passage (99-Y 0-N)",99,0,0,1,100
1822138,1390270,2024-02-21,Senate,"Senate: Reported from Finance and Appropriations with amendment (14-Y 0-N)",14,0,0,0,14
1822138,1392933,2024-02-22,Senate,"Senate: Constitutional reading dispensed (40-Y 0-N)",40,0,0,0,40
1822138,1393399,2024-02-23,Senate,"Senate: Passed Senate with amendment (39-Y 0-N)",39,0,0,1,40
1822138,1396020,2024-02-27,House,"House: VOTE: Adoption (92-Y 5-N)",92,5,0,3,100
1822142,1373114,2024-01-31,House,"House: Subcommittee recommends reporting with substitute (5-Y 3-N)",5,3,0,1,9
1822142,1375207,2024-02-02,House,"House: Reported from Appropriations with substitute (13-Y 9-N)",13,9,0,0,22
1822142,1379975,2024-02-08,House,"House: VOTE: Passage (55-Y 43-N)",55,43,0,2,100
1822142,1395802,2024-02-27,Senate,"Senate: Continued to 2025 in Finance and Appropriations (15-Y 0-N)",15,0,0,0,15
1822144,1372466,2024-01-31,Senate,"Senate: Continued to 2025 in Finance and Appropriations (15-Y 0-N)",15,0,0,0,15
1822150,1370676,2024-01-29,Senate,"Senate: Reported from Local Government (15-Y 0-N)",15,0,0,0,15
1822150,1371540,2024-01-30,Senate,"Senate: Constitutional reading dispensed (40-Y 0-N)",40,0,0,0,40
1822150,1374368,2024-02-01,Senate,"Senate: Read third time and passed Senate (40-Y 0-N)",40,0,0,0,40
1822150,1387062,2024-02-16,House,"House: Subcommittee recommends reporting (8-Y 0-N)",8,0,0,0,8
1822150,1387063,2024-02-16,House,"House: Reported from Counties, Cities and Towns (22-Y 0-N)",22,0,0,0,22
1822150,1390946,2024-02-21,House,"House: VOTE: Passage (92-Y 0-N 2-A)",92,0,2,6,100
1822151,1374570,2024-02-02,Senate,"Senate: Reported from Rehabilitation and Social Services with amendments (8-Y 7-N)",8,7,0,0,15
1822151,1378128,2024-02-07,Senate,"Senate: Reported from Finance and Appropriations (9-Y 5-N 1-A)",9,5,1,0,15
1822151,1380055,2024-02-08,Senate,"Senate: Constitutional reading dispensed (40-Y 0-N)",40,0,0,0,40
1822151,1381453,2024-02-12,Senate,"Senate: Read third time and passed Senate (21-Y 18-N)",21,18,0,1,40
1822151,1386710,2024-02-16,House,"House: Reported from Public Safety with amendment(s) (12-Y 10-N)",12,10,0,0,22
1822151,1391114,2024-02-21,House,"House: VOTE: Passage (51-Y 49-N)",51,49,0,0,100
1822151,1393997,2024-02-23,Senate,"Senate: House amendment agreed to by Senate (21-Y 17-N)",21,17,0,2,40
1822155,1373619,2024-02-01,Senate,"Senate: Reported from Education and Health with substitute (9-Y 6-N)",9,6,0,0,15
1822155,1377396,2024-02-06,Senate,"Senate: Read third time and passed Senate (23-Y 16-N)",23,16,0,1,40
1822155,1377397,2024-02-06,Senate,"Senate: Reconsideration of passage agreed to by Senate (39-Y 0-N)",39,0,0,1,40
1822155,1377398,2024-02-06,Senate,"Senate: Passed Senate (21-Y 18-N)",21,18,0,1,40
1822155,1432212,2024-02-15,House,"House: Reported from Health and Human Services (14-Y 8-N)",14,8,0,0,22
1822155,1432213,2024-02-20,House,"House: VOTE: Passage (54-Y 45-N)",54,45,0,1,100
1822161,1376687,2024-02-05,Senate,"Senate: Continued to 2025 in Commerce and Labor (14-Y 1-N)",14,1,0,0,15
1822163,1377257,2024-02-06,House,"House: Subcommittee recommends reporting with substitute (8-Y 0-N)",8,0,0,0,8
1822163,1379633,2024-02-08,House,"House: Reported from Health and Human Services with substitute (22-Y 0-N)",22,0,0,0,22
1822163,1383240,2024-02-13,House,"House: VOTE: Block Vote Passage (99-Y 0-N)",99,0,0,1,100
1822163,1398713,2024-02-28,Senate,"Senate: Reported from Courts of Justice (14-Y 0-N 1-A)",14,0,1,0,15
1822163,1400991,2024-03-01,Senate,"Senate: Constitutional reading dispensed (40-Y 0-N)",40,0,0,0,40
1822163,1402844,2024-03-05,Senate,"Senate: Passed Senate (40-Y 0-N)",40,0,0,0,40
1822163,1402845,2024-03-05,Senate,"Senate: Reconsideration of Senate passage agreed to by Senate (39-Y 0-N)",39,0,0,1,40
1822163,1404141,2024-03-06,Senate,"Senate: Passed Senate with substitute (40-Y 0-N)",40,0,0,0,40
1822163,1405599,2024-03-07,House,"House: VOTE: Adoption (98-Y 0-N)",98,0,0,2,100
1822167,1372606,2024-01-31,House,"House: Subcommittee recommends reporting with substitute (8-Y 0-N)",8,0,0,0,8
1822167,1375758,2024-02-05,House,"House: Reported from Education with substitute (22-Y 0-N)",22,0,0,0,22
1822167,1380554,2024-02-09,House,"House: VOTE: Block Vote Passage (96-Y 0-N)",96,0,0,4,100
1822167,1385483,2024-02-15,Senate,"Senate: Reported from Education and Health with substitute (15-Y 0-N)",15,0,0,0,15
1822167,1386514,2024-02-16,Senate,"Senate: Constitutional reading dispensed (38-Y 0-N)",38,0,0,2,40
1822167,1387722,2024-02-19,Senate,"Senate: Passed Senate with substitute (39-Y 0-N)",39,0,0,1,40
1822167,1390094,2024-02-21,House,"House: VOTE: REJECTED (1-Y 98-N)",1,98,0,1,100
1822167,1393693,2024-02-23,Senate,"Senate: Senate insisted on amendment (38-Y 0-N)",38,0,0,2,40
1822167,1403376,2024-03-05,House,"House: VOTE: Adoption (100-Y 0-N)",100,0,0,0,100
1822167,1404515,2024-03-06,Senate,"Senate: Conference report agreed to by Senate (40-Y 0-N)",40,0,0,0,40
1822167,1430173,2024-04-17,House,"House: VOTE: Adoption (46-Y 54-N)",46,54,0,0,100
1822172,1378460,2024-02-07,House,"House: Subcommittee recommends reporting with substitute (8-Y 0-N)",8,0,0,0,8
1822172,1379089,2024-02-08,House,"House: Reported from Health and Human Services with substitute (22-Y 0-N)",22,0,0,0,22
1822172,1380580,2024-02-09,House,"House: Subcommittee recommends reporting with amendments (7-Y 0-N)",7,0,0,2,9
1822172,1380682,2024-02-09,House,"House: Reported from Appropriations with amendment(s) (20-Y 0-N)",20,0,0,2,22
1822172,1382827,2024-02-13,House,"House: VOTE: Block Vote Passage (99-Y 0-N)",99,0,0,1,100
1822172,1399142,2024-02-29,Senate,"Senate: Reported from Education and Health with substitute (15-Y 0-N)",15,0,0,0,15
1822172,1401408,2024-03-04,Senate,"Senate: Reported from Finance and Appropriations with substitute (15-Y 0-N)",15,0,0,0,15
1822172,1402962,2024-03-05,Senate,"Senate: Constitutional reading dispensed (39-Y 0-N)",39,0,0,1,40
1822172,1405055,2024-03-07,Senate,"Senate: Passed Senate with substitute (40-Y 0-N)",40,0,0,0,40
1822172,1405722,2024-03-07,House,"House: VOTE: Adoption (99-Y 0-N)",99,0,0,1,100
1822174,1373850,2024-01-31,Senate,"Senate: Passed by indefinitely in Courts of Justice (8-Y 7-N)",8,7,0,0,15
1822177,1368866,2024-01-24,Senate,"Senate: Rereferred from Courts of Justice (15-Y 0-N)",15,0,0,0,15
1822177,1371913,2024-01-30,Senate,"Senate: Rereferred from Agriculture, Conservation and Natural Resources (15-Y 0-N)",15,0,0,0,15
1822177,1375601,2024-02-05,Senate,"Senate: Reported from Courts of Justice with amendment (14-Y 0-N)",14,0,0,0,14
1822177,1381322,2024-02-12,Senate,"Senate: Reported from Finance and Appropriations (15-Y 0-N)",15,0,0,0,15
1822177,1382223,2024-02-12,Senate,"Senate: Constitutional reading dispensed (40-Y 0-N)",40,0,0,0,40
1822177,1383886,2024-02-13,Senate,"Senate: Constitutional reading dispensed (39-Y 0-N)",39,0,0,1,40
1822177,1383887,2024-02-13,Senate,"Senate: Passed Senate (40-Y 0-N)",40,0,0,0,40
1822177,1391449,2024-02-22,House,"House: Subcommittee recommends reporting (8-Y 0-N)",8,0,0,0,8
1822177,1393744,2024-02-23,House,"House: Reported from Counties, Cities and Towns (22-Y 0-N)",22,0,0,0,22
1822177,1398464,2024-02-28,House,"House: VOTE: Block Vote Passage (97-Y 0-N)",97,0,0,3,100
1822179,1374927,2024-02-02,House,"House: Subcommittee recommends reporting (8-Y 0-N)",8,0,0,0,8
1822179,1374928,2024-02-02,House,"House: Reported from Counties, Cities and Towns (22-Y 0-N)",22,0,0,0,22
1822179,1380337,2024-02-08,House,"House: VOTE: Block Vote Passage (98-Y 0-N)",98,0,0,2,100
1822179,1394264,2024-02-26,Senate,"Senate: Reported from Local Government (15-Y 0-N)",15,0,0,0,15
1822179,1396982,2024-02-27,Senate,"Senate: Constitutional reading dispensed (39-Y 0-N)",39,0,0,1,40
1822179,1398303,2024-02-28,Senate,"Senate: Passed Senate (39-Y 0-N)",39,0,0,1,40
1822190,1373632,2024-01-31,Senate,"Senate: Reported from Courts of Justice with substitute (12-Y 3-N)",12,3,0,0,15
1822190,1378120,2024-02-07,Senate,"Senate: Reported from Finance and Appropriations (10-Y 5-N)",10,5,0,0,15
1822190,1379278,2024-02-08,Senate,"Senate: Constitutional reading dispensed (40-Y 0-N)",40,0,0,0,40
1822190,1381753,2024-02-12,Senate,"Senate: Read third time and passed Senate (20-Y 19-N)",20,19,0,1,40
1822190,1387563,2024-02-19,House,"House: Subcommittee recommends reporting with amendments (5-Y 3-N)",5,3,0,1,9
1822190,1393911,2024-02-23,House,"House: Reported from Courts of Justice with amendment(s) (11-Y 10-N)",11,10,0,1,22
1822190,1397615,2024-02-28,House,"House: Reported from Appropriations (13-Y 9-N)",13,9,0,0,22
1822190,1401868,2024-03-04,House,"House: VOTE: Passage (52-Y 43-N)",52,43,0,5,100
1822190,1402982,2024-03-05,Senate,"Senate: House amendments agreed to by Senate (21-Y 17-N)",21,17,0,2,40
1822190,1429612,2024-04-17,Senate,"Senate: Passed in enrolled form rejected (21-Y 19-N)",21,19,0,0,40
1822191,1373098,2024-01-31,House,"House: Subcommittee recommends reporting with substitute (8-Y 0-N)",8,0,0,1,9
1822191,1375100,2024-02-02,House,"House: Reported from Appropriations with substitute (22-Y 0-N)",22,0,0,0,22
1822191,1380339,2024-02-08,House,"House: VOTE: Block Vote Passage (98-Y 0-N)",98,0,0,2,100
1822191,1398237,2024-02-28,Senate,"Senate: Reported from Finance and Appropriations with substitute (14-Y 0-N)",14,0,0,0,14
1822191,1399884,2024-02-29,Senate,"Senate: Constitutional reading dispensed (39-Y 0-N)",39,0,0,1,40
1822191,1400603,2024-03-01,Senate,"Senate: Passed Senate with substitute (40-Y 0-N)",40,0,0,0,40
1822191,1401556,2024-03-04,House,"House: VOTE: REJECTED (1-Y 96-N)",1,96,0,3,100
1822191,1402907,2024-03-05,Senate,"Senate: Senate insisted on substitute (40-Y 0-N)",40,0,0,0,40
1822191,1406555,2024-03-08,Senate,"Senate: Conference report agreed to by Senate (40-Y 0-N)",40,0,0,0,40
1822191,1406556,2024-03-08,House,"House: VOTE: Adoption (93-Y 6-N)",93,6,0,1,100
1822196,1377800,2024-02-06,House,"House: Subcommittee recommends reporting with substitute (6-Y 4-N)",6,4,0,0,10
1822196,1379738,2024-02-08,House,"House: Reported from Labor and Commerce with substitute (18-Y 4-N)",18,4,0,0,22
1822196,1383793,2024-02-13,House,"House: VOTE: Passage (74-Y 24-N)",74,24,0,2,100
1822196,1394673,2024-02-26,Senate,"Senate: Reported from Commerce and Labor (9-Y 6-N)",9,6,0,0,15
1822196,1398443,2024-02-28,Senate,"Senate: Constitutional reading dispensed (39-Y 0-N)",39,0,0,1,40
1822196,1399245,2024-02-29,Senate,"Senate: Passed Senate (20-Y 18-N)",20,18,0,2,40
1822196,1429510,2024-04-17,Senate,"Senate: Senate concurred in Governor's recommendation (26-Y 14-N)",26,14,0,0,40
1822196,1430297,2024-04-17,House,"House: VOTE: Adoption (64-Y 34-N 1-A)",64,34,1,1,100
1822197,1376459,2024-02-05,Senate,"Senate: Continued to 2025 in Commerce and Labor (9-Y 6-N)",9,6,0,0,15
1822204,1377287,2024-02-06,Senate,"Senate: Reported from Privileges and Elections with amendment (14-Y 0-N)",14,0,0,0,14
1822204,1378060,2024-02-07,Senate,"Senate: Constitutional reading dispensed (40-Y 0-N)",40,0,0,0,40
1822204,1379287,2024-02-08,Senate,"Senate: Constitutional reading dispensed (40-Y 0-N)",40,0,0,0,40
1822204,1379288,2024-02-08,Senate,"Senate: Passed Senate (40-Y 0-N)",40,0,0,0,40
1822204,1386745,2024-02-16,House,"House: Reported from Privileges and Elections (21-Y 0-N)",21,0,0,1,22
1822204,1390511,2024-02-21,House,"House: VOTE: Block Vote Passage (100-Y 0-N)",100,0,0,0,100
1822208,1371969,2024-01-30,House,"House: Reported from Health and Human Services (22-Y 0-N)",22,0,0,0,22
1822208,1376323,2024-02-05,House,"House: VOTE: Block Vote Passage (98-Y 0-N)",98,0,0,2,100
1822208,1386823,2024-02-16,Senate,"Senate: Reported from Rehabilitation and Social Services (12-Y 0-N)",12,0,0,0,12
1822208,1387787,2024-02-19,Senate,"Senate: Constitutional reading dispensed (38-Y 0-N)",38,0,0,2,40
1822208,1389099,2024-02-20,Senate,"Senate: Passed Senate (40-Y 0-N)",40,0,0,0,40
1822213,1374929,2024-02-02,House,"House: Reported from Counties, Cities and Towns (21-Y 0-N)",21,0,0,1,22
1822213,1380175,2024-02-08,House,"House: VOTE: Block Vote Passage (98-Y 0-N)",98,0,0,2,100
1822213,1394626,2024-02-26,Senate,"Senate: Reported from Local Government (14-Y 0-N 1-A)",14,0,1,0,15
1822213,1395916,2024-02-27,Senate,"Senate: Constitutional reading dispensed (39-Y 0-N)",39,0,0,1,40
1822213,1398477,2024-02-28,Senate,"Senate: Passed Senate (38-Y 1-N)",38,1,0,1,40
1822214,1371616,2024-01-30,House,"House: Subcommittee failed to recommend reporting (3-Y 5-N)",3,5,0,1,9
1822217,1379458,2024-02-08,House,"House: Subcommittee recommends reporting with substitute (5-Y 3-N)",5,3,0,0,8
1822217,1380430,2024-02-08,House,"House: Reported from Labor and Commerce with substitute (12-Y 10-N)",12,10,0,0,22
1822217,1383010,2024-02-13,House,"House: VOTE: Passage (52-Y 47-N)",52,47,0,1,100
1822217,1398562,2024-02-28,Senate,"Senate: Reported from General Laws and Technology with substitute (11-Y 4-N)",11,4,0,0,15
1822217,1400674,2024-03-01,Senate,"Senate: Constitutional reading dispensed (40-Y 0-N)",40,0,0,0,40
1822217,1403098,2024-03-05,Senate,"Senate: Passed Senate with substitute (23-Y 17-N)",23,17,0,0,40
1822217,1404390,2024-03-06,House,"House: VOTE: Adoption (52-Y 47-N)",52,47,0,1,100
1822217,1430178,2024-04-17,House,"House: VOTE: Adoption (51-Y 49-N)",51,49,0,0,100
1822217,1430179,2024-04-17,Senate,"Senate: Senate concurred in Governor's recommendation (40-Y 0-N)",40,0,0,0,40
1822222,1380985,2024-02-09,House,"House: Passed by indefinitely in Privileges and Elections (14-Y 8-N)",14,8,0,0,22
1822224,1377652,2024-02-06,House,"House: Subcommittee recommends laying on the table (6-Y 2-N)",6,2,0,0,8
1822228,1379222,2024-02-08,Senate,"Senate: Reported from Education and Health with substitute (15-Y 0-N)",15,0,0,0,15
1822228,1379223,2024-02-08,Senate,"Senate: Constitutional reading dispensed (40-Y 0-N)",40,0,0,0,40
1822228,1381153,2024-02-09,Senate,"Senate: Constitutional reading dispensed (40-Y 0-N)",40,0,0,0,40
1822228,1381154,2024-02-09,Senate,"Senate: Passed Senate (40-Y 0-N)",40,0,0,0,40
1822228,1389723,2024-02-21,House,"House: Subcommittee recommends reporting (8-Y 0-N)",8,0,0,0,8
1822228,1394785,2024-02-26,House,"House: Reported from Education (21-Y 0-N)",21,0,0,1,22
1822228,1399180,2024-02-29,House,"House: VOTE: Block Vote Passage (99-Y 0-N)",99,0,0,1,100
1822230,1372033,2024-01-30,Senate,"Senate: Reported from Agriculture, Conservation and Natural Resources with amendment (15-Y 0-N)",15,0,0,0,15
1822230,1377082,2024-02-06,Senate,"Senate: Continued to 2025 in Finance and Appropriations (13-Y 2-N)",13,2,0,0,15
1822232,1377813,2024-02-06,House,"House: Subcommittee recommends reporting with amendments (8-Y 0-N)",8,0,0,1,9
1822232,1378710,2024-02-07,House,"House: Reported from Finance with amendment(s) (17-Y 1-N)",17,1,0,4,22
1822232,1378711,2024-02-07,House,"House: Reported from Finance with amendment(s) (18-Y 1-N)",18,1,0,3,22
1822232,1383832,2024-02-13,House,"House: VOTE: Passage (99-Y 0-N)",99,0,0,1,100
1822232,1396166,2024-02-27,Senate,"Senate: Passed by indefinitely in Finance and Appropriations (15-Y 0-N)",15,0,0,0,15
1822240,1376688,2024-02-05,House,"House: Subcommittee recommends reporting with amendments (5-Y 3-N)",5,3,0,1,9
1822240,1380979,2024-02-09,House,"House: Reported from Privileges and Elections with amendment(s) (12-Y 10-N)",12,10,0,0,22
1822240,1383722,2024-02-13,House,"House: VOTE: Passage (52-Y 47-N)",52,47,0,1,100
1822240,1396478,2024-02-27,Senate,"Senate: Continued to 2025 in Privileges and Elections (15-Y 0-N)",15,0,0,0,15
1822243,1378859,2024-02-07,Senate,"Senate: Reported from Courts of Justice with amendments (14-Y 1-N)",14,1,0,0,15
1822243,1379261,2024-02-08,Senate,"Senate: Constitutional reading dispensed (40-Y 0-N)",40,0,0,0,40
1822243,1381483,2024-02-12,Senate,"Senate: Read third time and passed Senate (40-Y 0-N)",40,0,0,0,40
1822243,1386574,2024-02-16,House,"House: Reported from Courts of Justice with substitute (17-Y 5-N)",17,5,0,0,22
1822243,1390935,2024-02-21,House,"House: VOTE: Passage (85-Y 14-N)",85,14,0,1,100
1822243,1394106,2024-02-23,Senate,"Senate: House substitute agreed to by Senate (39-Y 0-N)",39,0,0,1,40
1822244,1374323,2024-02-01,House,"House: Reported from Rules (18-Y 0-N)",18,0,0,0,18
1822244,1377559,2024-02-06,House,"House: VOTE: Block Vote Adoption (98-Y 0-N)",98,0,0,2,100
1822244,1395313,2024-02-26,Senate,"Senate: Reading waived (40-Y 0-N)",40,0,0,0,40
1822248,1377528,2024-02-06,House,"House: Subcommittee failed to recommend reporting (3-Y 5-N)",3,5,0,1,9
1822249,1377423,2024-02-06,House,"House: Subcommittee recommends reporting with substitute (8-Y 0-N)",8,0,0,0,8
1822249,1378242,2024-02-07,House,"House: Reported from Education with substitute (22-Y 0-N)",22,0,0,0,22
1822260,1375546,2024-02-05,House,"House: Subcommittee recommends reporting (8-Y 0-N)",8,0,0,1,9
1822260,1375661,2024-02-05,House,"House: Subcommittee recommends reporting with amendments (8-Y 0-N)",8,0,0,1,9
1822260,1378917,2024-02-07,House,"House: Reported from Finance with amendment(s) (18-Y 0-N)",18,0,0,4,22
1822260,1378918,2024-02-07,House,"House: Reported from Finance with amendment(s) (21-Y 0-N)",21,0,0,1,22
1822260,1383826,2024-02-13,House,"House: VOTE: Block Vote Passage (99-Y 0-N)",99,0,0,1,100
1822260,1396149,2024-02-27,Senate,"Senate: Constitutional reading dispensed (39-Y 0-N)",39,0,0,1,40
1822260,1396150,2024-02-27,Senate,"Senate: Reported from Finance and Appropriations (15-Y 0-N)",15,0,0,0,15
1822260,1398454,2024-02-28,Senate,"Senate: Passed Senate (39-Y 0-N)",39,0,0,1,40
1822264,1376792,2024-02-06,House,"House: Subcommittee recommends reporting with substitute (8-Y 0-N)",8,0,0,0,8
1822264,1379312,2024-02-08,House,"House: Reported from Transportation with substitute (22-Y 0-N)",22,0,0,0,22
1822264,1383147,2024-02-13,House,"House: VOTE: Block Vote Passage (99-Y 0-N)",99,0,0,1,100
1822264,1392261,2024-02-22,Senate,"Senate: Reported from Transportation (15-Y 0-N)",15,0,0,0,15
1822264,1394513,2024-02-26,Senate,"Senate: Constitutional reading dispensed (40-Y 0-N)",40,0,0,0,40
1822264,1395867,2024-02-27,Senate,"Senate: Passed Senate (39-Y 0-N)",39,0,0,1,40
1822266,1379045,2024-02-08,Senate,"Senate: Reported from Education and Health (15-Y 0-N)",15,0,0,0,15
1822266,1379454,2024-02-08,Senate,"Senate: Constitutional reading dispensed (40-Y 0-N)",40,0,0,0,40
1822266,1381147,2024-02-09,Senate,"Senate: Constitutional reading dispensed (40-Y 0-N)",40,0,0,0,40
1822266,1381148,2024-02-09,Senate,"Senate: Passed Senate (40-Y 0-N)",40,0,0,0,40
1822266,1395631,2024-02-27,House,"House: Subcommittee recommends reporting (8-Y 0-N)",8,0,0,0,8
1822266,1397270,2024-02-28,House,"House: Reported from Education (22-Y 0-N)",22,0,0,0,22
1822266,1402117,2024-03-04,House,"House: VOTE: Block Vote Passage (97-Y 0-N)",97,0,0,3,100
1822272,1378990,2024-02-07,House,"House: Subcommittee recommends reporting (5-Y 3-N)",5,3,0,0,8
1822272,1381112,2024-02-09,House,"House: Reported from Courts of Justice with substitute (12-Y 10-N)",12,10,0,0,22
1822272,1383666,2024-02-13,House,"House: VOTE: Passage (53-Y 45-N)",53,45,0,2,100
1822272,1391447,2024-02-22,Senate,"Senate: Rereferred from Education and Health (12-Y 0-N)",12,0,0,0,12
1822272,1398731,2024-02-28,Senate,"Senate: Reported from Courts of Justice (7-Y 6-N)",7,6,0,0,13
1822272,1401050,2024-03-01,Senate,"Senate: Constitutional reading dispensed (40-Y 0-N)",40,0,0,0,40
1822272,1402870,2024-03-05,Senate,"Senate: Passed Senate (21-Y 19-N)",21,19,0,0,40
1822278,1370383,2024-01-29,House,"House: Subcommittee recommends reporting (10-Y 0-N)",10,0,0,0,10
1822278,1372446,2024-01-31,House,"House: Reported from Education (22-Y 0-N)",22,0,0,0,22
1822278,1375685,2024-02-05,House,"House: Subcommittee recommends reporting with amendments (5-Y 3-N)",5,3,0,1,9
1822278,1380546,2024-02-09,House,"House: Reported from Courts of Justice with amendment(s) (16-Y 6-N)",16,6,0,0,22
1822278,1383561,2024-02-13,House,"House: VOTE: Passage (87-Y 11-N)",87,11,0,2,100
1822278,1399300,2024-02-29,Senate,"Senate: Reported from Education and Health (14-Y 1-N)",14,1,0,0,15
1822278,1401396,2024-03-04,Senate,"Senate: Reported from Finance and Appropriations with substitute (14-Y 0-N)",14,0,0,0,14
1822278,1403465,2024-03-05,Senate,"Senate: Constitutional reading dispensed (39-Y 0-N)",39,0,0,1,40
1822278,1404604,2024-03-06,Senate,"Senate: Passed Senate with substitute (39-Y 1-N)",39,1,0,0,40
1822278,1405099,2024-03-07,Senate,"Senate: Senate insisted on substitute (40-Y 0-N)",40,0,0,0,40
1822278,1405946,2024-03-07,House,"House: VOTE: REJECTED (1-Y 98-N)",1,98,0,1,100
1822278,1406670,2024-03-09,Senate,"Senate: Conference report agreed to by Senate (39-Y 1-N)",39,1,0,0,40
1822278,1406671,2024-03-09,House,"House: VOTE: Adoption (97-Y 0-N)",97,0,0,3,100
1822278,1429530,2024-04-17,Senate,"Senate: Senate concurred in Governor's recommendation (40-Y 0-N)",40,0,0,0,40
1822278,1430304,2024-04-17,House,"House: VOTE: Adoption (99-Y 1-N)",99,1,0,0,100
1822281,1380869,2024-02-09,House,"House: Passed by indefinitely in Privileges and Elections (18-Y 4-N)",18,4,0,0,22
1822282,1375919,2024-02-05,House,"House: Subcommittee recommends reporting with substitute (7-Y 1-N)",7,1,0,1,9
1822282,1381116,2024-02-09,House,"House: Reported from Courts of Justice with substitute (22-Y 0-N)",22,0,0,0,22
1822282,1382824,2024-02-13,House,"House: VOTE: Block Vote Passage (99-Y 0-N)",99,0,0,1,100
1822282,1398818,2024-02-28,Senate,"Senate: Reported from General Laws and Technology (15-Y 0-N)",15,0,0,0,15
1822282,1401200,2024-03-01,Senate,"Senate: Constitutional reading dispensed (40-Y 0-N)",40,0,0,0,40
1822282,1402243,2024-03-04,Senate,"Senate: Passed Senate (39-Y 0-N)",39,0,0,1,40
1822285,1375612,2024-02-05,Senate,"Senate: Reported from Courts of Justice with substitute (15-Y 0-N)",15,0,0,0,15
1822285,1378112,2024-02-07,Senate,"Senate: Reported from Finance and Appropriations (15-Y 0-N)",15,0,0,0,15
1822285,1380266,2024-02-08,Senate,"Senate: Constitutional reading dispensed (40-Y 0-N)",40,0,0,0,40
1822285,1381120,2024-02-09,Senate,"Senate: Constitutional reading dispensed (40-Y 0-N)",40,0,0,0,40
1822285,1381121,2024-02-09,Senate,"Senate: Passed Senate (40-Y 0-N)",40,0,0,0,40
1822285,1386698,2024-02-16,House,"House: Subcommittee recommends reporting (8-Y 0-N)",8,0,0,1,9
1822285,1394081,2024-02-23,House,"House: Reported from Courts of Justice (21-Y 0-N)",21,0,0,1,22
1822285,1397664,2024-02-28,House,"House: Reported from Appropriations (22-Y 0-N)",22,0,0,0,22
1822285,1402233,2024-03-04,House,"House: VOTE: Block Vote Passage (97-Y 0-N)",97,0,0,3,100
1822289,1375625,2024-02-05,Senate,"Senate: Stricken at request of Patron in Courts of Justice (15-Y 0-N)",15,0,0,0,15
1822291,1372035,2024-01-30,Senate,"Senate: Reported from Agriculture, Conservation and Natural Resources (15-Y 0-N)",15,0,0,0,15
1822291,1377984,2024-02-07,Senate,"Senate: Continued to 2025 in Finance and Appropriations (12-Y 3-N)",12,3,0,0,15
1822304,1371479,2024-01-30,House,"House: Subcommittee recommends striking from docket (8-Y 0-N)",8,0,0,0,8
1822306,1378831,2024-02-07,Senate,"Senate: Reported from Courts of Justice (15-Y 0-N)",15,0,0,0,15
1822306,1380093,2024-02-08,Senate,"Senate: Constitutional reading dispensed (40-Y 0-N)",40,0,0,0,40
1822306,1381198,2024-02-09,Senate,"Senate: Constitutional reading dispensed (40-Y 0-N)",40,0,0,0,40
1822306,1381199,2024-02-09,Senate,"Senate: Passed Senate (40-Y 0-N)",40,0,0,0,40
1822306,1386700,2024-02-16,House,"House: Subcommittee recommends reporting (8-Y 0-N)",8,0,0,1,9
1822306,1393730,2024-02-23,House,"House: Reported from Courts of Justice (21-Y 0-N)",21,0,0,1,22
1822306,1398474,2024-02-28,House,"House: VOTE: Block Vote Passage (97-Y 0-N)",97,0,0,3,100
1822308,1375675,2024-02-05,House,"House: Subcommittee recommends laying on the table (6-Y 2-N)",6,2,0,1,9
1822318,1378820,2024-02-07,House,"House: Tabled in Agriculture, Chesapeake and Natural Resources (12-Y 10-N)",12,10,0,0,22
1822324,1373938,2024-02-01,House,"House: Subcommittee recommends reporting (6-Y 3-N)",6,3,0,1,10
1822324,1374946,2024-02-02,House,"House: Reported from Public Safety (12-Y 10-N)",12,10,0,0,22
1822324,1380349,2024-02-08,House,"House: VOTE: Passage (51-Y 46-N)",51,46,0,3,100
1822324,1387361,2024-02-19,Senate,"Senate: Reported from Courts of Justice (7-Y 4-N)",7,4,0,0,11
1822324,1388514,2024-02-20,Senate,"Senate: Constitutional reading dispensed (39-Y 0-N)",39,0,0,1,40
1822324,1391052,2024-02-21,Senate,"Senate: Passed Senate (21-Y 19-N)",21,19,0,0,40
1822325,1379395,2024-02-08,Senate,"Senate: Passed by indefinitely in Education and Health (9-Y 5-N)",9,5,0,0,14
1822327,1373793,2024-02-01,House,"House: Subcommittee recommends striking from docket (8-Y 0-N)",8,0,0,0,8
1822333,1377401,2024-02-06,House,"House: Subcommittee recommends reporting with substitute (8-Y 0-N)",8,0,0,1,9
1822333,1378947,2024-02-07,House,"House: Reported from Finance with substitute (17-Y 1-N)",17,1,0,4,22
1822333,1378948,2024-02-07,House,"House: Reported from Finance with substitute (18-Y 1-N)",18,1,0,3,22
1822333,1383804,2024-02-13,House,"House: VOTE: Passage (99-Y 0-N)",99,0,0,1,100
1822333,1389981,2024-02-21,Senate,"Senate: Reported from Finance and Appropriations with amendments (14-Y 0-N)",14,0,0,0,14
1822333,1392805,2024-02-22,Senate,"Senate: Constitutional reading dispensed (40-Y 0-N)",40,0,0,0,40
1822333,1393708,2024-02-23,Senate,"Senate: Passed Senate with amendments (39-Y 0-N)",39,0,0,1,40
1822333,1396987,2024-02-27,House,"House: VOTE: REJECTED (2-Y 94-N)",2,94,0,4,100
1822333,1399920,2024-02-29,Senate,"Senate: Senate insisted on amendments (39-Y 0-N)",39,0,0,1,40
1822333,1404214,2024-03-06,House,"House: VOTE: Adoption (99-Y 0-N)",99,0,0,1,100
1822333,1405271,2024-03-07,Senate,"Senate: Conference report agreed to by Senate (40-Y 0-N)",40,0,0,0,40
1822341,1377836,2024-02-06,House,"House: Subcommittee recommends laying on the table (3-Y 2-N)",3,2,0,2,7
1822345,1371466,2024-01-30,House,"House: Subcommittee recommends reporting with substitute (8-Y 0-N)",8,0,0,0,8
1822345,1373669,2024-02-01,House,"House: Reported from Transportation with substitute (22-Y 0-N)",22,0,0,0,22
1822345,1378761,2024-02-07,House,"House: VOTE: Block Vote Passage (100-Y 0-N)",100,0,0,0,100
1822345,1386528,2024-02-15,Senate,"Senate: Reported from Transportation (15-Y 0-N)",15,0,0,0,15
1822345,1388097,2024-02-19,Senate,"Senate: Constitutional reading dispensed (38-Y 0-N)",38,0,0,2,40
1822345,1388583,2024-02-20,Senate,"Senate: Passed Senate (40-Y 0-N)",40,0,0,0,40
1822347,1380871,2024-02-09,House,"House: Reported from Appropriations with substitute (17-Y 3-N)",17,3,0,2,22
1822347,1383328,2024-02-13,House,"House: VOTE: Passage (59-Y 40-N)",59,40,0,1,100
1822350,1378790,2024-02-07,Senate,"Senate: Reported from General Laws and Technology with amendment (14-Y 0-N 1-A)",14,0,1,0,15
1822350,1380246,2024-02-08,Senate,"Senate: Constitutional reading dispensed (40-Y 0-N)",40,0,0,0,40
1822350,1383667,2024-02-13,Senate,"Senate: Read third time and passed Senate (39-Y 0-N)",39,0,0,1,40
1822350,1393006,2024-02-22,House,"House: Subcommittee recommends reporting (8-Y 0-N)",8,0,0,0,8
1822350,1396714,2024-02-27,House,"House: Reported from General Laws (22-Y 0-N)",22,0,0,0,22
1822350,1400490,2024-03-01,House,"House: VOTE: Block Vote Passage (97-Y 0-N)",97,0,0,3,100
1822354,1374018,2024-02-01,House,"House: Subcommittee recommends reporting with substitute (7-Y 1-N)",7,1,0,0,8
1822354,1377369,2024-02-06,House,"House: Reported from General Laws with substitute (14-Y 6-N)",14,6,0,2,22
1822354,1382320,2024-02-12,House,"House: VOTE: Passage (58-Y 40-N)",58,40,0,2,100
1822354,1398620,2024-02-28,Senate,"Senate: Reported from General Laws and Technology (9-Y 6-N)",9,6,0,0,15
1822354,1401221,2024-03-01,Senate,"Senate: Constitutional reading dispensed (40-Y 0-N)",40,0,0,0,40
1822354,1402886,2024-03-05,Senate,"Senate: Passed Senate (21-Y 18-N)",21,18,0,1,40
1822360,1376525,2024-02-05,House,"House: Subcommittee recommends reporting with substitute (5-Y 3-N)",5,3,0,1,9
1822360,1380919,2024-02-09,House,"House: Reported from Privileges and Elections with substitute (13-Y 9-N)",13,9,0,0,22
1822360,1382773,2024-02-13,House,"House: VOTE: Passage (54-Y 44-N)",54,44,0,2,100
1822360,1389549,2024-02-20,Senate,"Senate: Reported from Privileges and Elections (8-Y 7-N)",8,7,0,0,15
1822360,1392299,2024-02-22,Senate,"Senate: Constitutional reading dispensed (40-Y 0-N)",40,0,0,0,40
1822360,1393737,2024-02-23,Senate,"Senate: Passed Senate (20-Y 17-N)",20,17,0,3,40
1822360,1393738,2024-02-23,Senate,"Senate: Reconsideration of Senate passage agreed to by Senate (39-Y 0-N)",39,0,0,1,40
1822360,1393739,2024-02-23,Senate,"Senate: Passed Senate (22-Y 17-N)",22,17,0,1,40
1822363,1371911,2024-01-30,House,"House: Subcommittee recommends reporting (8-Y 0-N)",8,0,0,1,9
1822363,1372667,2024-01-31,House,"House: Reported from Finance (22-Y 0-N)",22,0,0,0,22
1822363,1377027,2024-02-06,House,"House: VOTE: Passage (99-Y 0-N)",99,0,0,1,100
1822363,1395725,2024-02-27,Senate,"Senate: Constitutional reading dispensed (39-Y 0-N)",39,0,0,1,40
1822363,1395726,2024-02-27,Senate,"Senate: Reported from Finance and Appropriations (15-Y 0-N)",15,0,0,0,15
1822363,1398152,2024-02-28,Senate,"Senate: Passed Senate (39-Y 0-N)",39,0,0,1,40
1822365,1376426,2024-02-05,Senate,"Senate: Reported from Commerce and Labor with substitute (9-Y 6-N)",9,6,0,0,15
1822365,1381325,2024-02-12,Senate,"Senate: Reported from Finance and Appropriations with substitute (15-Y 0-N)",15,0,0,0,15
1822365,1381938,2024-02-12,Senate,"Senate: Constitutional reading dispensed (40-Y 0-N)",40,0,0,0,40
1822365,1383355,2024-02-13,Senate,"Senate: Constitutional reading dispensed (40-Y 0-N)",40,0,0,0,40
1822365,1383356,2024-02-13,Senate,"Senate: Passed Senate (40-Y 0-N)",40,0,0,0,40
1822365,1389157,2024-02-20,House,"House: Reported from Labor and Commerce (22-Y 0-N)",22,0,0,0,22
1822365,1393809,2024-02-23,House,"House: VOTE: Block Vote Passage (98-Y 0-N)",98,0,0,2,100
1822365,1429489,2024-04-17,Senate,"Senate: Senate concurred in Governor's recommendation (40-Y 0-N)",40,0,0,0,40
1822365,1430296,2024-04-17,House,"House: VOTE: (97-Y 0-N)",97,0,0,3,100
1822369,1378501,2024-02-07,Senate,"Senate: Reported from Finance and Appropriations with substitute (15-Y 0-N)",15,0,0,0,15
1822369,1379347,2024-02-08,Senate,"Senate: Constitutional reading dispensed (40-Y 0-N)",40,0,0,0,40
1822369,1381196,2024-02-09,Senate,"Senate: Constitutional reading dispensed (40-Y 0-N)",40,0,0,0,40
1822369,1381197,2024-02-09,Senate,"Senate: Passed Senate (40-Y 0-N)",40,0,0,0,40
1822369,1388029,2024-02-19,House,"House: Reported from Finance (22-Y 0-N)",22,0,0,0,22
1822369,1392956,2024-02-22,House,"House: VOTE: Block Vote Passage (99-Y 0-N)",99,0,0,1,100
1822372,1374488,2024-02-02,Senate,"Senate: Reported from Rehabilitation and Social Services (14-Y 0-N)",14,0,0,0,14
1822372,1375933,2024-02-05,Senate,"Senate: Constitutional reading dispensed (39-Y 0-N)",39,0,0,1,40
1822372,1377282,2024-02-06,Senate,"Senate: Constitutional reading dispensed (39-Y 0-N)",39,0,0,1,40
1822372,1377283,2024-02-06,Senate,"Senate: Passed Senate (39-Y 0-N)",39,0,0,1,40
1822372,1389589,2024-02-20,House,"House: Subcommittee recommends reporting with substitute (7-Y 0-N)",7,0,0,1,8
1822372,1392607,2024-02-22,House,"House: Reported from General Laws with substitute (22-Y 0-N)",22,0,0,0,22
1822372,1398308,2024-02-28,House,"House: VOTE: Passage (94-Y 4-N)",94,4,0,2,100
1822372,1401118,2024-03-01,Senate,"Senate: House substitute agreed to by Senate (39-Y 0-N)",39,0,0,1,40
1822373,1370291,2024-01-29,Senate,"Senate: Incorporated by Local Government ",15,0,0,0,15
1822381,1375615,2024-02-05,Senate,"Senate: Reported from Courts of Justice with substitute (14-Y 0-N 1-A)",14,0,1,0,15
1822381,1377995,2024-02-07,Senate,"Senate: Reported from Finance and Appropriations (14-Y 0-N 1-A)",14,0,1,0,15
1822381,1380328,2024-02-08,Senate,"Senate: Constitutional reading dispensed (40-Y 0-N)",40,0,0,0,40
1822381,1381133,2024-02-09,Senate,"Senate: Amendment by Senator Obenshain rejected (19-Y 21-N)",19,21,0,0,40
1822381,1381985,2024-02-12,Senate,"Senate: Read third time and passed Senate (40-Y 0-N)",40,0,0,0,40
1822381,1386688,2024-02-16,House,"House: Reported from Courts of Justice with substitute (21-Y 1-N)",21,1,0,0,22
1822381,1391101,2024-02-21,House,"House: Reported from Appropriations (22-Y 0-N)",22,0,0,0,22
1822381,1395260,2024-02-26,House,"House: VOTE: Passage (95-Y 0-N)",95,0,0,5,100
1822381,1397904,2024-02-28,Senate,"Senate: House substitute rejected by Senate (19-Y 20-N)",19,20,0,1,40
1822381,1402515,2024-03-04,Senate,"Senate: Senate acceded to request (38-Y 0-N)",38,0,0,2,40
1822381,1404638,2024-03-06,Senate,"Senate: Conference report agreed to by Senate (40-Y 0-N)",40,0,0,0,40
1822381,1404639,2024-03-06,House,"House: VOTE: Adoption (99-Y 0-N)",99,0,0,1,100
1822386,1369694,2024-01-26,House,"House: Subcommittee recommends reporting (5-Y 3-N)",5,3,0,0,8
1822386,1369888,2024-01-26,House,"House: Reported from Counties, Cities and Towns (13-Y 7-N)",13,7,0,2,22
1822386,1373704,2024-02-01,House,"House: VOTE: Passage (61-Y 39-N)",61,39,0,0,100
1822386,1387554,2024-02-19,Senate,"Senate: Reported from Local Government (10-Y 4-N)",10,4,0,0,14
1822386,1388915,2024-02-20,Senate,"Senate: Constitutional reading dispensed (39-Y 0-N)",39,0,0,1,40
1822386,1389913,2024-02-21,Senate,"Senate: Passed Senate (28-Y 12-N)",28,12,0,0,40
1822388,1371653,2024-01-30,Senate,"Senate: Continued to 2025 in Agriculture, Conservation and Natural Resources (15-Y 0-N)",15,0,0,0,15
1822390,1370248,2024-01-29,Senate,"Senate: Continued to 2025 in Local Government (15-Y 0-N)",15,0,0,0,15
1822393,1374711,2024-02-01,Senate,"Senate: Reported from Transportation with substitute (8-Y 6-N 1-A)",8,6,1,0,15
1822393,1378533,2024-02-07,Senate,"Senate: Continued to 2025 in Finance and Appropriations (9-Y 6-N)",9,6,0,0,15
1822415,1373589,2024-02-01,House,"House: Subcommittee recommends striking from docket (8-Y 0-N)",8,0,0,0,8
1822475,1372371,2024-01-31,House,"House: Subcommittee failed to recommend reporting (4-Y 4-N)",4,4,0,2,10
1822482,1371474,2024-01-30,House,"House: Subcommittee recommends laying on the table (8-Y 0-N)",8,0,0,0,8
1822492,1379681,2024-02-08,Senate,"Senate: Reported from Local Government with substitute (9-Y 6-N)",9,6,0,0,15
1822492,1379682,2024-02-08,Senate,"Senate: Constitutional reading dispensed (40-Y 0-N)",40,0,0,0,40
1822492,1381665,2024-02-12,Senate,"Senate: Read third time and passed Senate (21-Y 18-N)",21,18,0,1,40
1822500,1373179,2024-01-31,House,"House: Subcommittee recommends reporting (7-Y 3-N)",7,3,0,0,10
1822500,1378290,2024-02-07,House,"House: Reported from Agriculture, Chesapeake and Natural Resources (14-Y 8-N)",14,8,0,0,22
1822500,1383013,2024-02-13,House,"House: VOTE: Passage (63-Y 36-N)",63,36,0,1,100
1822500,1389050,2024-02-20,Senate,"Senate: Reported from Agriculture, Conservation and Natural Resources (11-Y 2-N 2-A)",11,2,2,0,15
1822500,1392302,2024-02-22,Senate,"Senate: Constitutional reading dispensed (40-Y 0-N)",40,0,0,0,40
1822500,1394366,2024-02-26,Senate,"Senate: Passed Senate with amendment (29-Y 11-N)",29,11,0,0,40
1822500,1398001,2024-02-28,House,"House: VOTE: Adoption (63-Y 36-N)",63,36,0,1,100
1822517,1373820,2024-02-01,House,"House: Subcommittee recommends reporting with substitute (8-Y 0-N)",8,0,0,0,8
1822517,1377362,2024-02-06,House,"House: Reported from Health and Human Services with substitute (22-Y 0-N)",22,0,0,0,22
1822517,1382133,2024-02-12,House,"House: VOTE: Block Vote Passage (100-Y 0-N)",100,0,0,0,100
1822517,1399410,2024-02-29,Senate,"Senate: Reported from Education and Health (10-Y 5-N)",10,5,0,0,15
1822517,1401255,2024-03-01,Senate,"Senate: Constitutional reading dispensed (40-Y 0-N)",40,0,0,0,40
1822517,1402788,2024-03-05,Senate,"Senate: Defeated by Senate (17-Y 22-N)",17,22,0,1,40
1822525,1373158,2024-01-31,Senate,"Senate: Reported from General Laws and Technology (15-Y 0-N)",15,0,0,0,15
1822525,1377366,2024-02-06,Senate,"Senate: Read third time and passed Senate (39-Y 0-N)",39,0,0,1,40
1822525,1432061,2024-02-15,House,"House: Reported from General Laws (22-Y 0-N)",22,0,0,0,22
1822525,1432062,2024-02-20,House,"House: VOTE: Block Vote Passage (98-Y 0-N)",98,0,0,2,100
1822535,1375549,2024-02-05,House,"House: Subcommittee recommends laying on the table (5-Y 3-N)",5,3,0,1,9
1822564,1378873,2024-02-07,Senate,"Senate: Reported from Courts of Justice (15-Y 0-N)",15,0,0,0,15
1822564,1380324,2024-02-08,Senate,"Senate: Constitutional reading dispensed (40-Y 0-N)",40,0,0,0,40
1822564,1381150,2024-02-09,Senate,"Senate: Constitutional reading dispensed (40-Y 0-N)",40,0,0,0,40
1822564,1381151,2024-02-09,Senate,"Senate: Passed Senate (40-Y 0-N)",40,0,0,0,40
1822564,1386709,2024-02-16,House,"House: Reported from Courts of Justice (22-Y 0-N)",22,0,0,0,22
1822564,1390961,2024-02-21,House,"House: VOTE: Block Vote Passage (100-Y 0-N)",100,0,0,0,100
1822574,1377095,2024-02-06,House,"House: Subcommittee recommends reporting with substitute (8-Y 0-N)",8,0,0,1,9
1822574,1377667,2024-02-06,House,"House: Reported from General Laws with substitute (20-Y 0-N)",20,0,0,2,22
1822581,1376331,2024-02-05,Senate,"Senate: Reading waived (39-Y 0-N)",39,0,0,1,40
1822581,1393300,2024-02-23,House,"House: Reported from Rules (17-Y 0-N)",17,0,0,1,18
1822581,1398650,2024-02-28,House,"House: VOTE: Block Vote Adoption (99-Y 0-N)",99,0,0,1,100
1822581,1398651,2024-02-28,House,"House: VOTE: Block Vote Adoption #2 (99-Y 0-N)",99,0,0,1,100
1822590,1374908,2024-02-02,House,"House: Subcommittee recommends striking from docket (8-Y 0-N)",8,0,0,0,8
1822598,1369894,2024-01-26,Senate,"Senate: Rereferred from Rules (15-Y 0-N)",15,0,0,0,15
1822598,1382828,2024-02-12,Senate,"Senate: Reported from Courts of Justice with substitute (11-Y 0-N)",11,0,0,0,11
1822598,1383891,2024-02-13,Senate,"Senate: Constitutional reading dispensed (40-Y 0-N)",40,0,0,0,40
1822598,1383892,2024-02-13,Senate,"Senate: Passed Senate (40-Y 0-N)",40,0,0,0,40
1822598,1383893,2024-02-13,Senate,"Senate: Constitutional reading dispensed (40-Y 0-N)",40,0,0,0,40
1822598,1393281,2024-02-23,House,"House: Subcommittee recommends reporting (6-Y 0-N)",6,0,0,0,6
1822598,1393282,2024-02-23,House,"House: Reported from Rules (16-Y 0-N)",16,0,0,2,18
1822598,1397607,2024-02-28,House,"House: Tabled in Appropriations (18-Y 4-N)",18,4,0,0,22
1822607,1376569,2024-02-05,Senate,"Senate: Reported from Commerce and Labor (15-Y 0-N)",15,0,0,0,15
1822607,1378616,2024-02-07,Senate,"Senate: Constitutional reading dispensed (40-Y 0-N)",40,0,0,0,40
1822607,1380060,2024-02-08,Senate,"Senate: Constitutional reading dispensed (40-Y 0-N)",40,0,0,0,40
1822607,1380061,2024-02-08,Senate,"Senate: Passed Senate (40-Y 0-N)",40,0,0,0,40
1822607,1389138,2024-02-20,House,"House: Subcommittee recommends reporting (7-Y 0-N)",7,0,0,1,8
1822607,1392827,2024-02-22,House,"House: Reported from Labor and Commerce (22-Y 0-N)",22,0,0,0,22
1822607,1395737,2024-02-27,House,"House: VOTE: Block Vote Passage (97-Y 0-N)",97,0,0,3,100
1822615,1372447,2024-01-31,House,"House: Subcommittee recommends laying on the table (5-Y 3-N)",5,3,0,0,8
1822623,1374267,2024-02-01,House,"House: Reported from Rules with substitute (14-Y 0-N)",14,0,0,4,18
1822631,1375229,2024-02-02,House,"House: Subcommittee recommends reporting with substitute (6-Y 1-N)",6,1,1,1,9
1822631,1381106,2024-02-09,House,"House: Reported from Courts of Justice with substitute (17-Y 5-N)",17,5,0,0,22
1822631,1382830,2024-02-13,House,"House: VOTE: Passage (61-Y 35-N)",61,35,0,4,100
1822631,1394579,2024-02-26,Senate,"Senate: Reported from Courts of Justice (10-Y 4-N)",10,4,0,0,14
1822631,1399394,2024-02-29,Senate,"Senate: Reported from Finance and Appropriations with amendment (10-Y 4-N)",10,4,0,0,14
1822631,1400493,2024-02-29,Senate,"Senate: Reported from Finance and Appropriations with amendments (10-Y 4-N)",10,4,0,0,14
1822631,1402234,2024-03-04,Senate,"Senate: Constitutional reading dispensed (40-Y 0-N)",40,0,0,0,40
1822631,1403750,2024-03-05,Senate,"Senate: Passed Senate with amendments (23-Y 17-N)",23,17,0,0,40
1822631,1404781,2024-03-06,House,"House: VOTE: Adoption (65-Y 34-N)",65,34,0,1,100
1822639,1368989,2024-01-25,Senate,"Senate: Rereferred from Education and Health (14-Y 0-N)",14,0,0,0,14
1822653,1370474,2024-01-29,Senate,"Senate: Rereferred from Local Government (14-Y 0-N)",14,0,0,0,14
1822653,1376579,2024-02-05,Senate,"Senate: Reported from Commerce and Labor with substitute (10-Y 5-N)",10,5,0,0,15
1822653,1381438,2024-02-12,Senate,"Senate: Reported from Finance and Appropriations (11-Y 0-N 4-A)",11,0,4,0,15
1822653,1381439,2024-02-12,Senate,"Senate: Constitutional reading dispensed (40-Y 0-N)",40,0,0,0,40
1822653,1383538,2024-02-13,Senate,"Senate: Constitutional reading dispensed (40-Y 0-N)",40,0,0,0,40
1822653,1383539,2024-02-13,Senate,"Senate: Passed Senate (29-Y 9-N)",29,9,0,2,40
1822653,1393146,2024-02-23,House,"House: Subcommittee recommends reporting (5-Y 1-N)",5,1,0,0,6
1822653,1393274,2024-02-23,House,"House: Reported from Rules (11-Y 6-N)",11,6,0,1,18
1822653,1398414,2024-02-28,House,"House: Reported from Appropriations with amendment(s) (12-Y 10-N)",12,10,0,0,22
1822653,1401744,2024-03-04,House,"House: VOTE: Passage (57-Y 40-N)",57,40,0,3,100
1822653,1405597,2024-03-07,Senate,"Senate: House amendments rejected by Senate (0-Y 40-N)",0,40,0,0,40
1822653,1405598,2024-03-07,Senate,"Senate: Senate acceded to request (40-Y 0-N)",40,0,0,0,40
1822653,1406679,2024-03-09,Senate,"Senate: Conference report agreed to by Senate (28-Y 12-N)",28,12,0,0,40
1822653,1406680,2024-03-09,House,"House: VOTE: Adoption (56-Y 43-N)",56,43,0,1,100
1822653,1429534,2024-04-17,Senate,"Senate: Senate rejected Governor's recommendation (18-Y 22-N)",18,22,0,0,40
1822690,1375761,2024-02-05,Senate,"Senate: Stricken at request of Patron in Local Government (13-Y 0-N)",13,0,0,0,13
1822757,1375552,2024-02-05,House,"House: Subcommittee recommends laying on the table (8-Y 0-N)",8,0,0,1,9
1822790,1378972,2024-02-07,Senate,"Senate: Passed by indefinitely in Courts of Justice (9-Y 6-N)",9,6,0,0,15
1822823,1374302,2024-02-01,House,"House: Reported from Rules (16-Y 0-N)",16,0,0,2,18
1822823,1377394,2024-02-06,House,"House: VOTE: Block Vote Adoption (98-Y 0-N)",98,0,0,2,100
1822823,1394935,2024-02-26,Senate,"Senate: Reading waived (40-Y 0-N)",40,0,0,0,40
1822923,1374074,2024-02-01,Senate,"Senate: Continued to 2025 in Education and Health (15-Y 0-N)",15,0,0,0,15
1822957,1369819,2024-01-26,House,"House: Subcommittee recommends reporting (8-Y 0-N)",8,0,0,0,8
1822957,1369820,2024-01-26,House,"House: Reported from Counties, Cities and Towns (20-Y 0-N)",20,0,0,2,22
1822957,1373655,2024-02-01,House,"House: VOTE: Block Vote Passage (99-Y 0-N)",99,0,0,1,100
1822957,1387684,2024-02-19,Senate,"Senate: Reported from Local Government with substitute (14-Y 0-N)",14,0,0,0,14
1822957,1388500,2024-02-20,Senate,"Senate: Constitutional reading dispensed (39-Y 0-N)",39,0,0,1,40
1822957,1390951,2024-02-21,Senate,"Senate: Passed Senate with substitute (40-Y 0-N)",40,0,0,0,40
1822957,1394053,2024-02-23,House,"House: VOTE: Adoption (96-Y 0-N)",96,0,0,4,100
1822989,1374578,2024-02-01,Senate,"Senate: Reported from Transportation with amendments (15-Y 0-N)",15,0,0,0,15
1822989,1376626,2024-02-05,Senate,"Senate: Constitutional reading dispensed (39-Y 0-N)",39,0,0,1,40
1822989,1376971,2024-02-06,Senate,"Senate: Constitutional reading dispensed (39-Y 0-N)",39,0,0,1,40
1822989,1376972,2024-02-06,Senate,"Senate: Passed Senate (39-Y 0-N)",39,0,0,1,40
1822989,1392042,2024-02-22,House,"House: Reported from Transportation (22-Y 0-N)",22,0,0,0,22
1822989,1396913,2024-02-27,House,"House: VOTE: Block Vote Passage (97-Y 0-N)",97,0,0,3,100
1823339,1377416,2024-02-06,House,"House: Subcommittee recommends reporting with substitute (8-Y 0-N)",8,0,0,1,9
1823339,1378922,2024-02-07,House,"House: Reported from Finance with substitute (17-Y 1-N)",17,1,0,4,22
1823339,1378923,2024-02-07,House,"House: Reported from Finance with substitute (18-Y 1-N)",18,1,0,3,22
1823339,1383778,2024-02-13,House,"House: VOTE: Passage Emergency (99-Y 0-N)",99,0,0,1,100
1823339,1395611,2024-02-27,Senate,"Senate: Passed by indefinitely in Finance and Appropriations (15-Y 0-N)",15,0,0,0,15
1823673,1380976,2024-02-09,Senate,"Senate: Reported from Commerce and Labor with substitute (9-Y 6-N)",9,6,0,0,15
1823673,1380977,2024-02-09,Senate,"Senate: Constitutional reading dispensed (39-Y 0-N)",39,0,0,1,40
1823673,1383004,2024-02-13,Senate,"Senate: Read third time and passed Senate (21-Y 19-N)",21,19,0,0,40
1823673,1396089,2024-02-27,House,"House: Subcommittee recommends reporting with substitute (6-Y 4-N)",6,4,0,1,11
1823673,1396090,2024-02-27,House,"House: Reported from Labor and Commerce with substitute (11-Y 10-N)",11,10,0,1,22
1823673,1400552,2024-03-01,House,"House: VOTE: Passage (50-Y 46-N)",50,46,0,4,100
1823673,1403748,2024-03-05,Senate,"Senate: House substitute rejected by Senate (0-Y 40-N)",0,40,0,0,40
1823673,1405755,2024-03-07,Senate,"Senate: Senate acceded to request (40-Y 0-N)",40,0,0,0,40
1823673,1406453,2024-03-08,Senate,"Senate: Conference report agreed to by Senate (22-Y 18-N)",22,18,0,0,40
1823673,1406454,2024-03-08,House,"House: VOTE: Adoption (52-Y 44-N)",52,44,0,4,100
1825581,1372006,2024-01-30,Senate,"Senate: Reported from Privileges and Elections (15-Y 0-N)",15,0,0,0,15
1825581,1374394,2024-02-01,Senate,"Senate: Reading waived (40-Y 0-N)",40,0,0,0,40
1825581,1377079,2024-02-06,Senate,"Senate: Read third time and agreed to by Senate (39-Y 0-N)",39,0,0,1,40
1825581,1378692,2024-02-07,House,"House: Reported from Privileges and Elections (22-Y 0-N)",22,0,0,0,22
1825581,1380168,2024-02-08,House,"House: VOTE: Adoption (94-Y 0-N)",94,0,0,6,100
1826441,1370767,2024-01-24,House,"House: VOTE: Election (98-Y 0-N)",98,0,0,2,100
1826482,1370773,2024-01-24,House,"House: VOTE: Election (98-Y 0-N)",98,0,0,2,100
1826523,1368507,2024-01-24,Senate,"Senate: Rules suspended (40-Y 0-N)",40,0,0,0,40
1826523,1368508,2024-01-24,Senate,"Senate: Agreed to by Senate (40-Y 0-N)",40,0,0,0,40
1826523,1370732,2024-01-24,House,"House: VOTE: Adoption (97-Y 0-N)",97,0,0,3,100
1826568,1370734,2024-01-24,House,"House: VOTE: Election (98-Y 0-N)",98,0,0,2,100
1826612,1370780,2024-01-24,House,"House: VOTE: Election (98-Y 0-N)",98,0,0,2,100
1826655,1370738,2024-01-24,House,"House: VOTE: Election (98-Y 0-N)",98,0,0,2,100
1826702,1370784,2024-01-24,House,"House: VOTE: Election (97-Y 0-N)",97,0,0,3,100
1826743,1370751,2024-01-24,House,"House: VOTE: Election (97-Y 0-N)",97,0,0,3,100
1826798,1370433,2024-01-24,Senate,"Senate: Rules suspended (40-Y 0-N)",40,0,0,0,40
1826798,1370434,2024-01-24,Senate,"Senate: Election by Senate (40-Y 0-N)",40,0,0,0,40
1826837,1370425,2024-01-24,Senate,"Senate: Rules suspended (39-Y 0-N)",39,0,0,1,40
1826837,1370426,2024-01-24,Senate,"Senate: Election by Senate (40-Y 0-N)",40,0,0,0,40
1826929,1370438,2024-01-24,Senate,"Senate: Rules suspended (40-Y 0-N)",40,0,0,0,40
1826929,1370439,2024-01-24,Senate,"Senate: Election by Senate (40-Y 0-N)",40,0,0,0,40
1826980,1370429,2024-01-24,Senate,"Senate: Rules suspended (40-Y 0-N)",40,0,0,0,40
1826980,1370430,2024-01-24,Senate,"Senate: Election by Senate (40-Y 0-N)",40,0,0,0,40
1827029,1370446,2024-01-24,Senate,"Senate: Rules suspended (40-Y 0-N)",40,0,0,0,40
1827029,1370447,2024-01-24,Senate,"Senate: Election by Senate (40-Y 0-N)",40,0,0,0,40
1827122,1370452,2024-01-24,Senate,"Senate: Rules suspended (40-Y 0-N)",40,0,0,0,40
1827122,1370453,2024-01-24,Senate,"Senate: Election by Senate (40-Y 0-N)",40,0,0,0,40
1827169,1370459,2024-01-24,Senate,"Senate: Rules suspended (40-Y 0-N)",40,0,0,0,40
1827169,1370460,2024-01-24,Senate,"Senate: Election by Senate (40-Y 0-N)",40,0,0,0,40
1830566,1374876,2024-02-02,House,"House: Subcommittee recommends striking from docket (8-Y 0-N)",8,0,0,1,9
1836949,1377683,2024-02-06,Senate,"Senate: Reported from Privileges and Elections (12-Y 0-N)",12,0,0,0,12
1836949,1380230,2024-02-08,Senate,"Senate: Reading waived (40-Y 0-N)",40,0,0,0,40
1836949,1380231,2024-02-08,Senate,"Senate: Agreed to by Senate (40-Y 0-N)",40,0,0,0,40
1836949,1400338,2024-03-01,House,"House: Reported from Privileges and Elections (21-Y 0-N)",21,0,0,1,22
1836949,1404107,2024-03-06,House,"House: VOTE: Adoption (97-Y 0-N)",97,0,0,3,100
1844575,1406796,2024-03-07,House,"House: VOTE: (94-Y 0-N)",94,0,0,6,100
1852738,1400341,2024-03-01,Senate,"Senate: Reported from Rules (8-Y 7-N)",8,7,0,0,15
1852738,1404672,2024-03-06,Senate,"Senate: Engrossment reconsidered by Senate (40-Y 0-N)",40,0,0,0,40
1852738,1404673,2024-03-06,Senate,"Senate: Reading waived (36-Y 0-N)",36,0,0,4,40
1857770,1403869,2024-03-01,Senate,"Senate: Rules suspended (40-Y 0-N)",40,0,0,0,40
1858045,1406812,2024-03-08,House,"House: VOTE: (96-Y 0-N)",96,0,0,4,100
1859433,1406455,2024-03-08,Senate,"Senate: Reading waived (40-Y 0-N)",40,0,0,0,40
1859433,1406456,2024-03-08,Senate,"Senate: Agreed to by Senate (40-Y 0-N)",40,0,0,0,40
1859566,1403591,2024-03-05,House,"House: Reported from Rules (17-Y 0-N)",17,0,1,0,18
1859566,1404661,2024-03-06,House,"House: VOTE: Adoption (95-Y 0-N 4-A)",95,0,4,1,100
1859566,1406468,2024-03-08,Senate,"Senate: Reported from Rules (15-Y 0-N)",15,0,0,0,15
1859566,1406746,2024-03-09,Senate,"Senate: Reading waived (39-Y 0-N 1-A)",39,0,1,0,40
1859566,1406747,2024-03-09,Senate,"Senate: Agreed to by Senate (39-Y 0-N 1-A)",39,0,1,0,40
1860137,1406803,2024-03-07,House,"House: VOTE: Election (98-Y 0-N)",98,0,0,2,100
1860148,1406802,2024-03-07,House,"House: VOTE: Election (98-Y 0-N)",98,0,0,2,100
1860221,1405228,2024-03-07,House,"House: VOTE: Adoption (90-Y 0-N)",90,0,0,10,100
1860221,1405229,2024-03-07,House,"House: VOTE: waived (97-Y 0-N)",97,0,0,3,100
1860221,1405230,2024-03-07,Senate,"Senate: Rules suspended (40-Y 0-N)",40,0,0,0,40
1860221,1405231,2024-03-07,Senate,"Senate: Agreed to by Senate (40-Y 0-N)",40,0,0,0,40
1860242,1406805,2024-03-07,House,"House: VOTE: Election (98-Y 0-N)",98,0,0,2,100
1860253,1405181,2024-03-07,House,"House: VOTE: Election (97-Y 0-N 1-A)",97,0,1,2,100
1860282,1406797,2024-03-07,Senate,"Senate: Rules suspended (40-Y 0-N)",40,0,0,0,40
1860282,1406798,2024-03-07,Senate,"Senate: Election by Senate (40-Y 0-N)",40,0,0,0,40
1860291,1406799,2024-03-07,Senate,"Senate: Rules suspended (40-Y 0-N)",40,0,0,0,40
1860291,1406800,2024-03-07,Senate,"Senate: Election by Senate lines 4-5 (40-Y 0-N)",40,0,0,0,40
1860291,1406801,2024-03-07,Senate,"Senate: Election by Senate lines 6-7 (21-Y 0-N)",21,0,0,19,40
1860335,1406806,2024-03-07,Senate,"Senate: Rules suspended (40-Y 0-N)",40,0,0,0,40
1860335,1406807,2024-03-07,Senate,"Senate: Election by Senate (40-Y 0-N)",40,0,0,0,40
1860343,1406804,2024-03-07,House,"House: VOTE: Election (96-Y 0-N)",96,0,0,4,100
1860372,1406810,2024-03-07,Senate,"Senate: Rules suspended (40-Y 0-N)",40,0,0,0,40
1860372,1406811,2024-03-07,Senate,"Senate: Election by Senate (40-Y 0-N)",40,0,0,0,40
1860381,1406808,2024-03-07,Senate,"Senate: Rules suspended (40-Y 0-N)",40,0,0,0,40
1860381,1406809,2024-03-07,Senate,"Senate: Election by Senate (40-Y 0-N)",40,0,0,0,40
1882853,1458588,2024-04-17,Senate,"Senate: Agreed to by Senate (40-Y 0-N)",40,0,0,0,40
1882853,1458589,2024-04-17,House,"House: VOTE: Adoption (98-Y 0-N)",98,0,0,2,100
